


PokerStars Game #00327513452: Hold'em No Limit ($25/$50 USD) - 2022/04/30 08:09:49 ET
Table 'Hold'em (Min 1K Max 5K)   216' 6-max Seat #1 is the button
Seat 1: Lucifer999 ($5000 in chips) 
Seat 2: rahulh1 ($5000 in chips) 
Lucifer999: posts small blind $25
rahulh1: posts big blind $50
*** HOLE CARDS ***
Dealt to Lucifer999 [6c Qh]
Lucifer999: raises $75.00 to $125
rahulh1: folds
Uncalled bet ($75) returned to Lucifer999
Lucifer999: doesn't show hand
Lucifer999 collected $100 from pot
*** SUMMARY ***
Total pot $100.00 | Rake $0
Board []
Seat 1: Lucifer999 (button) (small blind) collected ($100)
Seat 2: rahulh1 (big blind) folded before Flop



PokerStars Game #00327513518: Hold'em No Limit ($25/$50 USD) - 2022/04/30 08:10:12 ET
Table 'Hold'em (Min 1K Max 5K)   216' 6-max Seat #2 is the button
Seat 1: Lucifer999 ($5050 in chips) 
Seat 2: rahulh1 ($4950 in chips) 
rahulh1: posts small blind $25
Lucifer999: posts big blind $50
*** HOLE CARDS ***
Dealt to Lucifer999 [5s 7c]
rahulh1: folds
Uncalled bet ($25) returned to Lucifer999
Lucifer999: doesn't show hand
Lucifer999 collected $50 from pot
*** SUMMARY ***
Total pot $50.00 | Rake $0
Board []
Seat 1: Lucifer999 (big blind) collected ($50)
Seat 2: rahulh1 (button) (small blind) folded before Flop



PokerStars Game #00327513539: Hold'em No Limit ($25/$50 USD) - 2022/04/30 08:10:19 ET
Table 'Hold'em (Min 1K Max 5K)   216' 6-max Seat #1 is the button
Seat 1: Lucifer999 ($5075 in chips) 
Seat 2: rahulh1 ($4925 in chips) 
Lucifer999: posts small blind $25
rahulh1: posts big blind $50
*** HOLE CARDS ***
Dealt to Lucifer999 [3c Th]
Lucifer999: raises $75.00 to $125
rahulh1: calls $75
*** FLOP *** [Qh Jc 2h]
rahulh1: checks
Lucifer999: bets $100
rahulh1: calls $100
*** TURN *** [Qh Jc 2h] [3h]
rahulh1: checks
Lucifer999: bets $275
rahulh1: calls $275
*** RIVER *** [Qh Jc 2h 3h] [Qc]
rahulh1: checks
Lucifer999: checks
*** SHOW DOWN ***
Lucifer999: shows [3c Th] (Two pairs, QQ33)
rahulh1: shows [8h Qs] (Three of a kind, QQQ)
rahulh1 collected $955 from pot
*** SUMMARY ***
Total pot $1000.00 | Rake $45
Board [Qh Jc 2h 3h Qc]
Seat 1: Lucifer999 (button) (small blind) showed [3c Th] and lost with Two pairs, QQ33
Seat 2: rahulh1  (big blind) showed [8h Qs] and won ($955) with Three of a kind, QQQ



PokerStars Game #00327513687: Hold'em No Limit ($25/$50 USD) - 2022/04/30 08:11:12 ET
Table 'Hold'em (Min 1K Max 5K)   216' 6-max Seat #2 is the button
Seat 1: Lucifer999 ($5000 in chips) 
Seat 2: rahulh1 ($5380 in chips) 
rahulh1: posts small blind $25
Lucifer999: posts big blind $50
*** HOLE CARDS ***
Dealt to Lucifer999 [4d Jd]
rahulh1: folds
Uncalled bet ($25) returned to Lucifer999
Lucifer999: doesn't show hand
Lucifer999 collected $50 from pot
*** SUMMARY ***
Total pot $50.00 | Rake $0
Board []
Seat 1: Lucifer999 (big blind) collected ($50)
Seat 2: rahulh1 (button) (small blind) folded before Flop



PokerStars Game #00327513710: Hold'em No Limit ($25/$50 USD) - 2022/04/30 08:11:19 ET
Table 'Hold'em (Min 1K Max 5K)   216' 6-max Seat #1 is the button
Seat 1: Lucifer999 ($5025 in chips) 
Seat 2: rahulh1 ($5355 in chips) 
Lucifer999: posts small blind $25
rahulh1: posts big blind $50
*** HOLE CARDS ***
Dealt to Lucifer999 [Ad Jh]
Lucifer999: raises $75.00 to $125
rahulh1: calls $75
*** FLOP *** [4d 8c 2c]
rahulh1: checks
Lucifer999: checks
*** TURN *** [4d 8c 2c] [3c]
rahulh1: checks
Lucifer999: checks
*** RIVER *** [4d 8c 2c 3c] [Ts]
rahulh1: checks
Lucifer999: checks
*** SHOW DOWN ***
Lucifer999: shows [Ad Jh] (High card, A)
rahulh1: doesn't show hand
Lucifer999 collected $238.75 from pot
*** SUMMARY ***
Total pot $250.00 | Rake $11.25
Board [4d 8c 2c 3c Ts]
Seat 1: Lucifer999  (button) (small blind) showed [Ad Jh] and won ($238.75) with High card, A
Seat 2: rahulh1 (big blind) mucked



PokerStars Game #00327513852: Hold'em No Limit ($25/$50 USD) - 2022/04/30 08:12:13 ET
Table 'Hold'em (Min 1K Max 5K)   216' 6-max Seat #2 is the button
Seat 1: Lucifer999 ($5138.75 in chips) 
Seat 2: rahulh1 ($5230 in chips) 
rahulh1: posts small blind $25
Lucifer999: posts big blind $50
*** HOLE CARDS ***
Dealt to Lucifer999 [6c 2s]
rahulh1: raises $50.00 to $100
Lucifer999: folds
Uncalled bet ($50) returned to rahulh1
rahulh1: doesn't show hand
rahulh1 collected $100 from pot
*** SUMMARY ***
Total pot $100.00 | Rake $0
Board []
Seat 1: Lucifer999 (big blind) folded before Flop
Seat 2: rahulh1 (button) (small blind) collected ($100)



PokerStars Game #00327513907: Hold'em No Limit ($25/$50 USD) - 2022/04/30 08:12:33 ET
Table 'Hold'em (Min 1K Max 5K)   216' 6-max Seat #1 is the button
Seat 1: Lucifer999 ($5088.75 in chips) 
Seat 2: rahulh1 ($5280 in chips) 
Lucifer999: posts small blind $25
rahulh1: posts big blind $50
*** HOLE CARDS ***
Dealt to Lucifer999 [3d Qc]
Lucifer999: raises $75.00 to $125
rahulh1: raises $100.03 to $225.03
Lucifer999: folds
Uncalled bet ($100.03) returned to rahulh1
rahulh1: doesn't show hand
rahulh1 collected $250 from pot
*** SUMMARY ***
Total pot $250.00 | Rake $0
Board []
Seat 1: Lucifer999 (button) (small blind) folded before Flop
Seat 2: rahulh1 (big blind) collected ($250)



PokerStars Game #00327513995: Hold'em No Limit ($25/$50 USD) - 2022/04/30 08:13:00 ET
Table 'Hold'em (Min 1K Max 5K)   216' 6-max Seat #2 is the button
Seat 1: Lucifer999 ($5000 in chips) 
Seat 2: rahulh1 ($5405 in chips) 
rahulh1: posts small blind $25
Lucifer999: posts big blind $50
*** HOLE CARDS ***
Dealt to Lucifer999 [9h 5d]
rahulh1: calls $25
Lucifer999: checks
*** FLOP *** [9s 8d 2s]
Lucifer999: bets $100
rahulh1: folds
Uncalled bet ($100) returned to Lucifer999
Lucifer999: doesn't show hand
Lucifer999 collected $95.5 from pot
*** SUMMARY ***
Total pot $100.00 | Rake $4.5
Board [9s 8d 2s]
Seat 1: Lucifer999 (big blind) collected ($95.5)
Seat 2: rahulh1 (button) (small blind) folded on the Flop



PokerStars Game #00327514082: Hold'em No Limit ($25/$50 USD) - 2022/04/30 08:13:29 ET
Table 'Hold'em (Min 1K Max 5K)   216' 6-max Seat #1 is the button
Seat 1: Lucifer999 ($5045.5 in chips) 
Seat 2: rahulh1 ($5355 in chips) 
Lucifer999: posts small blind $25
rahulh1: posts big blind $50
*** HOLE CARDS ***
Dealt to Lucifer999 [Ad 9d]
Lucifer999: raises $75.00 to $125
rahulh1: folds
Uncalled bet ($75) returned to Lucifer999
Lucifer999: doesn't show hand
Lucifer999 collected $100 from pot
*** SUMMARY ***
Total pot $100.00 | Rake $0
Board []
Seat 1: Lucifer999 (button) (small blind) collected ($100)
Seat 2: rahulh1 (big blind) folded before Flop



PokerStars Game #00327514144: Hold'em No Limit ($25/$50 USD) - 2022/04/30 08:13:50 ET
Table 'Hold'em (Min 1K Max 5K)   216' 6-max Seat #2 is the button
Seat 1: Lucifer999 ($5095.5 in chips) 
Seat 2: rahulh1 ($5305 in chips) 
rahulh1: posts small blind $25
Lucifer999: posts big blind $50
*** HOLE CARDS ***
Dealt to Lucifer999 [3h Kc]
rahulh1: raises $54.27 to $104.27
Lucifer999: calls $54.27
*** FLOP *** [Kh 2c 2h]
Lucifer999: checks
rahulh1: bets $50
Lucifer999: calls $50
*** TURN *** [Kh 2c 2h] [6h]
Lucifer999: checks
rahulh1: bets $50
Lucifer999: calls $50
*** RIVER *** [Kh 2c 2h 6h] [2d]
Lucifer999: checks
rahulh1: bets $94.04
Lucifer999: raises $555.96 to $650
rahulh1: folds
Uncalled bet ($555.96) returned to Lucifer999
Lucifer999: doesn't show hand
Lucifer999 collected $569.8 from pot
*** SUMMARY ***
Total pot $596.62 | Rake $26.82
Board [Kh 2c 2h 6h 2d]
Seat 1: Lucifer999 (big blind) collected ($569.8)
Seat 2: rahulh1 (button) (small blind) folded on the River



PokerStars Game #00327514332: Hold'em No Limit ($25/$50 USD) - 2022/04/30 08:14:50 ET
Table 'Hold'em (Min 1K Max 5K)   216' 6-max Seat #1 is the button
Seat 1: Lucifer999 ($5366.99 in chips) 
Seat 2: rahulh1 ($5006.69 in chips) 
Lucifer999: posts small blind $25
rahulh1: posts big blind $50
*** HOLE CARDS ***
Dealt to Lucifer999 [As 5h]
Lucifer999: raises $75.00 to $125
rahulh1: raises $116.07 to $241.07
Lucifer999: calls $116.07
*** FLOP *** [2c Kc Tc]
rahulh1: checks
Lucifer999: checks
*** TURN *** [2c Kc Tc] [9h]
rahulh1: checks
Lucifer999: checks
*** RIVER *** [2c Kc Tc 9h] [9d]
rahulh1: checks
Lucifer999: checks
*** SHOW DOWN ***
rahulh1: shows [Qh Ad] (Pair, 99)
Lucifer999: doesn't show hand
rahulh1 collected $460.45 from pot
*** SUMMARY ***
Total pot $482.14 | Rake $21.69
Board [2c Kc Tc 9h 9d]
Seat 1: Lucifer999 (button) (small blind) mucked
Seat 2: rahulh1  (big blind) showed [Qh Ad] and won ($460.45) with Pair, 99



PokerStars Game #00327514484: Hold'em No Limit ($25/$50 USD) - 2022/04/30 08:15:41 ET
Table 'Hold'em (Min 1K Max 5K)   216' 6-max Seat #2 is the button
Seat 1: Lucifer999 ($5125.92 in chips) 
Seat 2: rahulh1 ($5226.07 in chips) 
rahulh1: posts small blind $25
Lucifer999: posts big blind $50
*** HOLE CARDS ***
Dealt to Lucifer999 [Ah 6d]
rahulh1: folds
Uncalled bet ($25) returned to Lucifer999
Lucifer999: doesn't show hand
Lucifer999 collected $50 from pot
*** SUMMARY ***
Total pot $50.00 | Rake $0
Board []
Seat 1: Lucifer999 (big blind) collected ($50)
Seat 2: rahulh1 (button) (small blind) folded before Flop



PokerStars Game #00327514508: Hold'em No Limit ($25/$50 USD) - 2022/04/30 08:15:49 ET
Table 'Hold'em (Min 1K Max 5K)   216' 6-max Seat #1 is the button
Seat 1: Lucifer999 ($5150.92 in chips) 
Seat 2: rahulh1 ($5201.07 in chips) 
Lucifer999: posts small blind $25
rahulh1: posts big blind $50
*** HOLE CARDS ***
Dealt to Lucifer999 [4d 7h]
Lucifer999: calls $25
rahulh1: checks
*** FLOP *** [4c 4h Th]
rahulh1: checks
Lucifer999: checks
*** TURN *** [4c 4h Th] [8c]
rahulh1: checks
Lucifer999: bets $100
rahulh1: folds
Uncalled bet ($100) returned to Lucifer999
Lucifer999: doesn't show hand
Lucifer999 collected $95.5 from pot
*** SUMMARY ***
Total pot $100.00 | Rake $4.5
Board [4c 4h Th 8c]
Seat 1: Lucifer999 (button) (small blind) collected ($95.5)
Seat 2: rahulh1 (big blind) folded on the Turn



PokerStars Game #00327514662: Hold'em No Limit ($25/$50 USD) - 2022/04/30 08:16:42 ET
Table 'Hold'em (Min 1K Max 5K)   216' 6-max Seat #2 is the button
Seat 1: Lucifer999 ($5196.42 in chips) 
Seat 2: rahulh1 ($5151.07 in chips) 
Seat 4: Silentfade ($1000 in chips) 
rahulh1: posts small blind $25
Lucifer999: posts big blind $50
*** HOLE CARDS ***
Dealt to Lucifer999 [2h 7h]
rahulh1: raises $55.78 to $105.78
Lucifer999: calls $55.78
*** FLOP *** [As 5c Jd]
Lucifer999: checks
rahulh1: bets $101.04
Lucifer999: folds
Uncalled bet ($101.04) returned to rahulh1
rahulh1: doesn't show hand
rahulh1 collected $202.07 from pot
*** SUMMARY ***
Total pot $211.56 | Rake $9.49
Board [As 5c Jd]
Seat 1: Lucifer999 (big blind) folded on the Flop
Seat 2: rahulh1 (button) (small blind) collected ($202.07)



PokerStars Game #00327514755: Hold'em No Limit ($25/$50 USD) - 2022/04/30 08:17:15 ET
Table 'Hold'em (Min 1K Max 5K)   216' 6-max Seat #1 is the button
Seat 1: Lucifer999 ($5090.64 in chips) 
Seat 2: rahulh1 ($5247.36 in chips) 
Seat 4: Silentfade ($1000 in chips) 
rahulh1: posts small blind $25
Silentfade: posts big blind $50
*** HOLE CARDS ***
Dealt to Lucifer999 [Jd 9d]
Lucifer999: raises $100.00 to $150
rahulh1: calls $125
Silentfade: calls $100
*** FLOP *** [4s Qs 4c]
rahulh1: checks
Silentfade: checks
Lucifer999: checks
*** TURN *** [4s Qs 4c] [Qd]
rahulh1: checks
Silentfade: checks
Lucifer999: bets $200
rahulh1: folds
Silentfade: folds
Uncalled bet ($200) returned to Lucifer999
Lucifer999: doesn't show hand
Lucifer999 collected $427.5 from pot
*** SUMMARY ***
Total pot $450.00 | Rake $22.5
Board [4s Qs 4c Qd]
Seat 1: Lucifer999 (button) collected ($427.5)
Seat 2: rahulh1 (small blind) folded on the Turn
Seat 4: Silentfade (big blind) folded on the Turn



PokerStars Game #00327514912: Hold'em No Limit ($25/$50 USD) - 2022/04/30 08:18:07 ET
Table 'Hold'em (Min 1K Max 5K)   216' 6-max Seat #2 is the button
Seat 1: Lucifer999 ($5368.14 in chips) 
Seat 2: rahulh1 ($5097.36 in chips) 
Seat 4: Silentfade ($850 in chips) 
Silentfade: posts small blind $25
Lucifer999: posts big blind $50
*** HOLE CARDS ***
Dealt to Lucifer999 [Td Qh]
rahulh1: folds
Silentfade: folds
Uncalled bet ($25) returned to Lucifer999
Lucifer999: doesn't show hand
Lucifer999 collected $50 from pot
*** SUMMARY ***
Total pot $50.00 | Rake $0
Board []
Seat 1: Lucifer999 (big blind) collected ($50)
Seat 2: rahulh1 (button) folded before Flop (didn't bet)
Seat 4: Silentfade (small blind) folded before Flop



PokerStars Game #00327514933: Hold'em No Limit ($25/$50 USD) - 2022/04/30 08:18:16 ET
Table 'Hold'em (Min 1K Max 5K)   216' 6-max Seat #4 is the button
Seat 1: Lucifer999 ($5393.14 in chips) 
Seat 2: rahulh1 ($5097.36 in chips) 
Seat 4: Silentfade ($825 in chips) 
Lucifer999: posts small blind $25
rahulh1: posts big blind $50
*** HOLE CARDS ***
Dealt to Lucifer999 [9s 4h]
Silentfade: folds
Lucifer999: folds
Uncalled bet ($25) returned to rahulh1
rahulh1: doesn't show hand
rahulh1 collected $50 from pot
*** SUMMARY ***
Total pot $50.00 | Rake $0
Board []
Seat 1: Lucifer999 (small blind) folded before Flop
Seat 2: rahulh1 (big blind) collected ($50)
Seat 4: Silentfade (button) folded before Flop (didn't bet)



PokerStars Game #00327515000: Hold'em No Limit ($25/$50 USD) - 2022/04/30 08:18:39 ET
Table 'Hold'em (Min 1K Max 5K)   216' 6-max Seat #1 is the button
Seat 1: Lucifer999 ($5368.14 in chips) 
Seat 2: rahulh1 ($5122.36 in chips) 
Seat 4: Silentfade ($825 in chips) 
rahulh1: posts small blind $25
Silentfade: posts big blind $50
*** HOLE CARDS ***
Dealt to Lucifer999 [5h Tc]
Lucifer999: folds
rahulh1: raises $50.00 to $100
Silentfade: calls $50
*** FLOP *** [6h 5c Jc]
rahulh1: checks
Silentfade: bets $120
rahulh1: folds
Uncalled bet ($120) returned to Silentfade
Silentfade: doesn't show hand
Silentfade collected $190 from pot
*** SUMMARY ***
Total pot $200.00 | Rake $10
Board [6h 5c Jc]
Seat 1: Lucifer999 (button) folded before Flop (didn't bet)
Seat 2: rahulh1 (small blind) folded on the Flop
Seat 4: Silentfade (big blind) collected ($190)



PokerStars Game #00327515121: Hold'em No Limit ($25/$50 USD) - 2022/04/30 08:19:18 ET
Table 'Hold'em (Min 1K Max 5K)   216' 6-max Seat #2 is the button
Seat 1: Lucifer999 ($5368.14 in chips) 
Seat 2: rahulh1 ($5022.36 in chips) 
Seat 4: Silentfade ($915 in chips) 
Silentfade: posts small blind $25
Lucifer999: posts big blind $50
*** HOLE CARDS ***
Dealt to Lucifer999 [8h 5d]
rahulh1: folds
Silentfade: raises $100.00 to $150
Lucifer999: folds
Uncalled bet ($100) returned to Silentfade
Silentfade: doesn't show hand
Silentfade collected $100 from pot
*** SUMMARY ***
Total pot $100.00 | Rake $0
Board []
Seat 1: Lucifer999 (big blind) folded before Flop
Seat 2: rahulh1 (button) folded before Flop (didn't bet)
Seat 4: Silentfade (small blind) collected ($100)



PokerStars Game #00327515190: Hold'em No Limit ($25/$50 USD) - 2022/04/30 08:19:43 ET
Table 'Hold'em (Min 1K Max 5K)   216' 6-max Seat #4 is the button
Seat 1: Lucifer999 ($5318.14 in chips) 
Seat 2: rahulh1 ($5022.36 in chips) 
Seat 4: Silentfade ($965 in chips) 
Lucifer999: posts small blind $25
rahulh1: posts big blind $50
*** HOLE CARDS ***
Dealt to Lucifer999 [5c Tc]
Silentfade: folds
Lucifer999: folds
Uncalled bet ($25) returned to rahulh1
rahulh1: doesn't show hand
rahulh1 collected $50 from pot
*** SUMMARY ***
Total pot $50.00 | Rake $0
Board []
Seat 1: Lucifer999 (small blind) folded before Flop
Seat 2: rahulh1 (big blind) collected ($50)
Seat 4: Silentfade (button) folded before Flop (didn't bet)



PokerStars Game #00327515261: Hold'em No Limit ($25/$50 USD) - 2022/04/30 08:20:05 ET
Table 'Hold'em (Min 1K Max 5K)   216' 6-max Seat #1 is the button
Seat 1: Lucifer999 ($5293.14 in chips) 
Seat 2: rahulh1 ($5047.36 in chips) 
Seat 4: Silentfade ($965 in chips) 
rahulh1: posts small blind $25
Silentfade: posts big blind $50
*** HOLE CARDS ***
Dealt to Lucifer999 [8h 8d]
Lucifer999: folds
rahulh1: calls $25
Silentfade: checks
*** FLOP *** [Ac 3d Qc]
rahulh1: bets $50
Silentfade: calls $50
*** TURN *** [Ac 3d Qc] [4s]
rahulh1: bets $50
Silentfade: calls $50
*** RIVER *** [Ac 3d Qc 4s] [4h]
rahulh1: checks
Silentfade: bets $142.5
rahulh1: folds
Uncalled bet ($142.5) returned to Silentfade
Silentfade: doesn't show hand
Silentfade collected $285 from pot
*** SUMMARY ***
Total pot $300.00 | Rake $15
Board [Ac 3d Qc 4s 4h]
Seat 1: Lucifer999 (button) folded before Flop (didn't bet)
Seat 2: rahulh1 (small blind) folded on the River
Seat 4: Silentfade (big blind) collected ($285)



PokerStars Game #00327515445: Hold'em No Limit ($25/$50 USD) - 2022/04/30 08:21:13 ET
Table 'Hold'em (Min 1K Max 5K)   216' 6-max Seat #2 is the button
Seat 1: Lucifer999 ($5293.14 in chips) 
Seat 2: rahulh1 ($4897.36 in chips) 
Seat 4: Silentfade ($1100 in chips) 
Seat 6: Avaroni ($5000 in chips) 
Silentfade: posts small blind $25
Avaroni: posts big blind $50
*** HOLE CARDS ***
Dealt to Lucifer999 [2d Ad]
Lucifer999: folds
rahulh1: folds
Silentfade: folds
Uncalled bet ($25) returned to Avaroni
Avaroni: doesn't show hand
Avaroni collected $50 from pot
*** SUMMARY ***
Total pot $50.00 | Rake $0
Board []
Seat 1: Lucifer999 folded before Flop (didn't bet)
Seat 2: rahulh1 (button) folded before Flop (didn't bet)
Seat 4: Silentfade (small blind) folded before Flop
Seat 6: Avaroni (big blind) collected ($50)



PokerStars Game #00327515551: Hold'em No Limit ($25/$50 USD) - 2022/04/30 08:21:47 ET
Table 'Hold'em (Min 1K Max 5K)   216' 6-max Seat #4 is the button
Seat 1: Lucifer999 ($5293.14 in chips) 
Seat 2: rahulh1 ($4897.36 in chips) 
Seat 4: Silentfade ($1075 in chips) 
Seat 6: Avaroni ($5025 in chips) 
Avaroni: posts small blind $25
Lucifer999: posts big blind $50
*** HOLE CARDS ***
Dealt to Lucifer999 [7d Qs]
rahulh1: folds
Silentfade: folds
Avaroni: folds
Uncalled bet ($25) returned to Lucifer999
Lucifer999: doesn't show hand
Lucifer999 collected $50 from pot
*** SUMMARY ***
Total pot $50.00 | Rake $0
Board []
Seat 1: Lucifer999 (big blind) collected ($50)
Seat 2: rahulh1 folded before Flop (didn't bet)
Seat 4: Silentfade (button) folded before Flop (didn't bet)
Seat 6: Avaroni (small blind) folded before Flop



PokerStars Game #00327515593: Hold'em No Limit ($25/$50 USD) - 2022/04/30 08:22:03 ET
Table 'Hold'em (Min 1K Max 5K)   216' 6-max Seat #6 is the button
Seat 1: Lucifer999 ($5318.14 in chips) 
Seat 2: rahulh1 ($4897.36 in chips) 
Seat 4: Silentfade ($1075 in chips) 
Seat 6: Avaroni ($5000 in chips) 
Lucifer999: posts small blind $25
Silentfade: posts big blind $50
*** HOLE CARDS ***
Dealt to Lucifer999 [3d Ac]
Avaroni: folds
Lucifer999: folds
Uncalled bet ($25) returned to Silentfade
Silentfade: doesn't show hand
Silentfade collected $50 from pot
*** SUMMARY ***
Total pot $50.00 | Rake $0
Board []
Seat 1: Lucifer999 (small blind) folded before Flop
Seat 4: Silentfade (big blind) collected ($50)
Seat 6: Avaroni (button) folded before Flop (didn't bet)



PokerStars Game #00327515647: Hold'em No Limit ($25/$50 USD) - 2022/04/30 08:22:24 ET
Table 'Hold'em (Min 1K Max 5K)   216' 6-max Seat #1 is the button
Seat 1: Lucifer999 ($5293.14 in chips) 
Seat 2: rahulh1 ($4897.36 in chips) 
Seat 3: avi098x ($3754.02 in chips) 
Seat 4: Silentfade ($1100 in chips) 
Seat 6: Avaroni ($5000 in chips) 
Silentfade: posts small blind $25
Avaroni: posts big blind $50
*** HOLE CARDS ***
Dealt to Lucifer999 [Qd 5s]
Lucifer999: folds
Silentfade: folds
Uncalled bet ($25) returned to Avaroni
Avaroni: doesn't show hand
Avaroni collected $50 from pot
*** SUMMARY ***
Total pot $50.00 | Rake $0
Board []
Seat 1: Lucifer999 (button) folded before Flop (didn't bet)
Seat 4: Silentfade (small blind) folded before Flop
Seat 6: Avaroni (big blind) collected ($50)



PokerStars Game #00327515552: Hold'em No Limit ($10/$25 USD) - 2022/04/30 08:21:47 ET
Table 'Hold'em (Min 500Max 2500)  1282' 6-max Seat #4 is the button
Seat 1: PANCHYOU ($1220.76 in chips) 
Seat 2: kash1102 ($2465 in chips) 
Seat 3: golden585 ($5407.5 in chips) 
Seat 4: SA754 ($1217.73 in chips) 
Seat 5: Lucifer999 ($2500 in chips) 
Seat 6: No username ($1822.97 in chips) 
No username: posts small blind $10
PANCHYOU: posts big blind $25
*** HOLE CARDS ***
kash1102: folds
golden585: folds
SA754: calls $25
No username: calls $15
PANCHYOU: checks
*** FLOP *** [5d 9c Td]
No username: checks
PANCHYOU: checks
SA754: checks
*** TURN *** [5d 9c Td] [8c]
No username: bets $53.3
PANCHYOU: calls $53.3
SA754: calls $53.3
*** RIVER *** [5d 9c Td 8c] [6s]
No username: bets $220.62
PANCHYOU: folds
SA754: calls $220.62
*** SHOW DOWN ***
No username: shows [2h 7h] (Straight, T-6)
SA754: doesn't show hand
No username collected $635.65 from pot
*** SUMMARY ***
Total pot $676.14 | Rake $40.49
Board [5d 9c Td 8c 6s]
Seat 1: PANCHYOU (big blind) folded on the River
Seat 2: kash1102 folded before Flop (didn't bet)
Seat 3: golden585 folded before Flop (didn't bet)
Seat 4: SA754 (button) mucked
Seat 6: No username  (small blind) showed [2h 7h] and won ($635.65) with Straight, T-6



PokerStars Game #00327515711: Hold'em No Limit ($25/$50 USD) - 2022/04/30 08:22:45 ET
Table 'Hold'em (Min 1K Max 5K)   216' 6-max Seat #4 is the button
Seat 1: Lucifer999 ($5293.14 in chips) 
Seat 2: rahulh1 ($4897.36 in chips) 
Seat 3: avi098x ($3754.02 in chips) 
Seat 4: Silentfade ($1075 in chips) 
Seat 6: Avaroni ($5025 in chips) 
Avaroni: posts small blind $25
Lucifer999: posts big blind $50
*** HOLE CARDS ***
Dealt to Lucifer999 [Tc Js]
avi098x: raises $25.00 to $75
Silentfade: calls $125
Avaroni: folds
Lucifer999: calls $75
*** FLOP *** [Ad Ah Qc]
Lucifer999: checks
avi098x: bets $285
Silentfade: folds
Lucifer999: folds
Uncalled bet ($285) returned to avi098x
avi098x: doesn't show hand
avi098x collected $380 from pot
*** SUMMARY ***
Total pot $400.00 | Rake $20
Board [Ad Ah Qc]
Seat 1: Lucifer999 (big blind) folded on the Flop
Seat 3: avi098x collected ($380)
Seat 4: Silentfade (button) folded on the Flop
Seat 6: Avaroni (small blind) folded before Flop



PokerStars Game #00327515764: Hold'em No Limit ($10/$25 USD) - 2022/04/30 08:23:04 ET
Table 'Hold'em (Min 500Max 2500)  1282' 6-max Seat #6 is the button
Seat 1: PANCHYOU ($1142.46 in chips) 
Seat 2: kash1102 ($2465 in chips) 
Seat 3: golden585 ($5407.5 in chips) 
Seat 4: SA754 ($918.81 in chips) 
Seat 5: Lucifer999 ($2500 in chips) 
Seat 6: No username ($2159.7 in chips) 
PANCHYOU: posts small blind $10
kash1102: posts big blind $25
*** HOLE CARDS ***
golden585: folds
SA754: calls $25
No username: raises $85.00 to $110
PANCHYOU: folds
kash1102: folds
SA754: calls $85
*** FLOP *** [4s 8h 6d]
SA754: checks
No username: bets $119.81
SA754: calls $119.81
*** TURN *** [4s 8h 6d] [2c]
SA754: checks
No username: checks
*** RIVER *** [4s 8h 6d 2c] [7s]
SA754: bets $464.69
No username: folds
Uncalled bet ($464.69) returned to SA754
SA754: doesn't show hand
SA754 collected $464.69 from pot
*** SUMMARY ***
Total pot $494.62 | Rake $29.93
Board [4s 8h 6d 2c 7s]
Seat 1: PANCHYOU (small blind) folded before Flop
Seat 2: kash1102 (big blind) folded before Flop
Seat 3: golden585 folded before Flop (didn't bet)
Seat 4: SA754 collected ($464.69)
Seat 6: No username (button) folded on the River



PokerStars Game #00327515917: Hold'em No Limit ($10/$25 USD) - 2022/04/30 08:23:58 ET
Table 'Hold'em (Min 500Max 2500)  1282' 6-max Seat #1 is the button
Seat 1: PANCHYOU ($1132.46 in chips) 
Seat 2: kash1102 ($2440 in chips) 
Seat 3: golden585 ($5407.5 in chips) 
Seat 4: SA754 ($1153.69 in chips) 
Seat 5: Lucifer999 ($2500 in chips) 
Seat 6: No username ($1929.89 in chips) 
kash1102: posts small blind $10
golden585: posts big blind $25
*** HOLE CARDS ***
SA754: raises $25.00 to $50
No username: folds
PANCHYOU: folds
kash1102: folds
golden585: calls $25
*** FLOP *** [5s 9d 3s]
golden585: bets $75
SA754: calls $75
*** TURN *** [5s 9d 3s] [8s]
golden585: bets $350
SA754: calls $350
*** RIVER *** [5s 9d 3s 8s] [2s]
golden585: checks
SA754: checks
*** SHOW DOWN ***
golden585: shows [9s Ad] (Flush, 9 high)
SA754: doesn't show hand
golden585 collected $904.6 from pot
*** SUMMARY ***
Total pot $960.00 | Rake $55.4
Board [5s 9d 3s 8s 2s]
Seat 1: PANCHYOU (button) folded before Flop (didn't bet)
Seat 2: kash1102 (small blind) folded before Flop
Seat 3: golden585  (big blind) showed [9s Ad] and won ($904.6) with Flush, 9 high
Seat 4: SA754 mucked
Seat 6: No username folded before Flop (didn't bet)



PokerStars Game #00327516022: Hold'em No Limit ($10/$25 USD) - 2022/04/30 08:24:36 ET
Table 'Hold'em (Min 500Max 2500)  1282' 6-max Seat #2 is the button
Seat 1: PANCHYOU ($1132.46 in chips) 
Seat 2: kash1102 ($2430 in chips) 
Seat 3: golden585 ($5837.1 in chips) 
Seat 4: SA754 ($678.69 in chips) 
Seat 5: Lucifer999 ($2500 in chips) 
Seat 6: No username ($1929.89 in chips) 
golden585: posts small blind $10
SA754: posts big blind $25
*** HOLE CARDS ***
No username: folds
PANCHYOU: folds
kash1102: folds
golden585: folds
Uncalled bet ($15) returned to SA754
SA754: doesn't show hand
SA754 collected $20 from pot
*** SUMMARY ***
Total pot $20.00 | Rake $0
Board []
Seat 1: PANCHYOU folded before Flop (didn't bet)
Seat 2: kash1102 (button) folded before Flop (didn't bet)
Seat 3: golden585 (small blind) folded before Flop
Seat 4: SA754 (big blind) collected ($20)
Seat 6: No username folded before Flop (didn't bet)



PokerStars Game #00327515839: Hold'em No Limit ($25/$50 USD) - 2022/04/30 08:23:30 ET
Table 'Hold'em (Min 1K Max 5K)   216' 6-max Seat #6 is the button
Seat 1: Lucifer999 ($5168.14 in chips) 
Seat 2: rahulh1 ($4897.36 in chips) 
Seat 3: avi098x ($4009.02 in chips) 
Seat 4: Silentfade ($950 in chips) 
Seat 6: Avaroni ($5000 in chips) 
Lucifer999: posts small blind $25
avi098x: posts big blind $50
*** HOLE CARDS ***
Dealt to Lucifer999 [7h Kd]
Silentfade: folds
Avaroni: raises $100.00 to $150
Lucifer999: folds
avi098x: calls $100
*** FLOP *** [9d Th 5d]
avi098x: checks
Avaroni: bets $250
avi098x: calls $250
*** TURN *** [9d Th 5d] [4h]
avi098x: checks
Avaroni: bets $600
avi098x: calls $600
*** RIVER *** [9d Th 5d 4h] [5c]
avi098x: checks
Avaroni: bets $961.88
avi098x: folds
Uncalled bet ($961.88) returned to Avaroni
Avaroni: doesn't show hand
Avaroni collected $1923.75 from pot
*** SUMMARY ***
Total pot $2025.00 | Rake $101.25
Board [9d Th 5d 4h 5c]
Seat 1: Lucifer999 (small blind) folded before Flop
Seat 3: avi098x (big blind) folded on the River
Seat 4: Silentfade folded before Flop (didn't bet)
Seat 6: Avaroni (button) collected ($1923.75)



PokerStars Game #00327516080: Hold'em No Limit ($25/$50 USD) - 2022/04/30 08:24:53 ET
Table 'Hold'em (Min 1K Max 5K)   216' 6-max Seat #1 is the button
Seat 1: Lucifer999 ($5143.14 in chips) 
Seat 2: rahulh1 ($4897.36 in chips) 
Seat 3: avi098x ($3009.02 in chips) 
Seat 4: Silentfade ($950 in chips) 
Seat 5: Preet991 ($5000 in chips) 
Seat 6: Avaroni ($5923.75 in chips) 
avi098x: posts small blind $25
Silentfade: posts big blind $50
*** HOLE CARDS ***
Dealt to Lucifer999 [5c 8c]
Preet991: checks
Avaroni: folds
Lucifer999: raises $125.00 to $175
avi098x: folds
Silentfade: folds
Preet991: raises $375.00 to $550
Lucifer999: folds
Uncalled bet ($425) returned to Preet991
Preet991: doesn't show hand
Preet991 collected $425 from pot
*** SUMMARY ***
Total pot $425.00 | Rake $0
Board []
Seat 1: Lucifer999 (button) folded before Flop
Seat 3: avi098x (small blind) folded before Flop
Seat 4: Silentfade (big blind) folded before Flop
Seat 5: Preet991 collected ($425)
Seat 6: Avaroni folded before Flop (didn't bet)



PokerStars Game #00327516064: Hold'em No Limit ($10/$25 USD) - 2022/04/30 08:24:47 ET
Table 'Hold'em (Min 500Max 2500)  1282' 6-max Seat #3 is the button
Seat 1: PANCHYOU ($1132.46 in chips) 
Seat 2: kash1102 ($2430 in chips) 
Seat 3: golden585 ($5827.1 in chips) 
Seat 4: SA754 ($688.69 in chips) 
Seat 5: Lucifer999 ($2500 in chips) 
Seat 6: No username ($1929.89 in chips) 
SA754: posts small blind $10
Lucifer999: posts big blind $25
*** HOLE CARDS ***
Dealt to Lucifer999 [Kh Ts]
No username: folds
PANCHYOU: folds
kash1102: folds
golden585: folds
SA754: raises $85.00 to $110
Lucifer999: folds
Uncalled bet ($85) returned to SA754
SA754: doesn't show hand
SA754 collected $50 from pot
*** SUMMARY ***
Total pot $50.00 | Rake $0
Board []
Seat 1: PANCHYOU folded before Flop (didn't bet)
Seat 2: kash1102 folded before Flop (didn't bet)
Seat 3: golden585 (button) folded before Flop (didn't bet)
Seat 4: SA754 (small blind) collected ($50)
Seat 5: Lucifer999 (big blind) folded before Flop
Seat 6: No username folded before Flop (didn't bet)



PokerStars Game #00327516150: Hold'em No Limit ($25/$50 USD) - 2022/04/30 08:25:19 ET
Table 'Hold'em (Min 1K Max 5K)   216' 6-max Seat #4 is the button
Seat 1: Lucifer999 ($5000 in chips) 
Seat 3: avi098x ($2984.02 in chips) 
Seat 4: Silentfade ($900 in chips) 
Seat 5: Preet991 ($5250 in chips) 
Seat 6: Avaroni ($5923.75 in chips) 
Preet991: posts small blind $25
Avaroni: posts big blind $50
*** HOLE CARDS ***
Dealt to Lucifer999 [3s 8s]
Lucifer999: folds
Silentfade: folds
Preet991: calls $25
Avaroni: raises $125.00 to $175
Preet991: folds
Uncalled bet ($125) returned to Avaroni
Avaroni: doesn't show hand
Avaroni collected $100 from pot
*** SUMMARY ***
Total pot $100.00 | Rake $0
Board []
Seat 1: Lucifer999 folded before Flop (didn't bet)
Seat 4: Silentfade (button) folded before Flop (didn't bet)
Seat 5: Preet991 (small blind) folded before Flop
Seat 6: Avaroni (big blind) collected ($100)



PokerStars Game #00327516193: Hold'em No Limit ($10/$25 USD) - 2022/04/30 08:25:35 ET
Table 'Hold'em (Min 500Max 2500)  1282' 6-max Seat #4 is the button
Seat 1: PANCHYOU ($1132.46 in chips) 
Seat 2: kash1102 ($2430 in chips) 
Seat 3: golden585 ($5827.1 in chips) 
Seat 4: SA754 ($713.69 in chips) 
Seat 5: Lucifer999 ($2500 in chips) 
Seat 6: No username ($1929.89 in chips) 
Lucifer999: posts small blind $10
No username: posts big blind $25
*** HOLE CARDS ***
Dealt to Lucifer999 [Ts 6c]
kash1102: folds
golden585: folds
SA754: calls $25
Lucifer999: folds
No username: checks
*** FLOP *** [2c 8s Jd]
No username: checks
SA754: checks
*** TURN *** [2c 8s Jd] [8h]
No username: bets $42.64
SA754: folds
Uncalled bet ($42.64) returned to No username
No username: doesn't show hand
No username collected $56.85 from pot
*** SUMMARY ***
Total pot $60.00 | Rake $3.15
Board [2c 8s Jd 8h]
Seat 2: kash1102 folded before Flop (didn't bet)
Seat 3: golden585 folded before Flop (didn't bet)
Seat 4: SA754 (button) folded on the Turn
Seat 5: Lucifer999 (small blind) folded before Flop
Seat 6: No username (big blind) collected ($56.85)



PokerStars Game #00327516228: Hold'em No Limit ($25/$50 USD) - 2022/04/30 08:25:46 ET
Table 'Hold'em (Min 1K Max 5K)   216' 6-max Seat #5 is the button
Seat 1: Lucifer999 ($5000 in chips) 
Seat 2: manny007 ($1000 in chips) 
Seat 3: avi098x ($2984.02 in chips) 
Seat 4: Silentfade ($900 in chips) 
Seat 5: Preet991 ($5200 in chips) 
Seat 6: Avaroni ($5973.75 in chips) 
Avaroni: posts small blind $25
Lucifer999: posts big blind $50
*** HOLE CARDS ***
Dealt to Lucifer999 [Kh 7h]
manny007: checks
Silentfade: raises $50.00 to $100
Preet991: folds
Avaroni: calls $75
Lucifer999: folds
manny007: calls $50
*** FLOP *** [8h Jd 6s]
Avaroni: checks
manny007: checks
Silentfade: bets $332.5
Avaroni: calls $332.5
manny007: folds
*** TURN *** [8h Jd 6s] [2h]
Avaroni: checks
Silentfade: bets $467.5
Avaroni: calls $467.5
*** RIVER *** [8h Jd 6s 2h] [Ad]
*** RIVER *** [8h Jd 6s 2h] [2d]
*** SHOW DOWN ***
Silentfade: shows [Jh Ac] (Two pairs, JJ22)
Avaroni: shows [6c 6h] (Full house, 66622)
Avaroni collected $926.25 from pot
Avaroni collected $926.25 from pot
*** SUMMARY ***
Total pot $1950.00 | Rake $97.5
Board [8h Jd 6s 2h Ad]
Seat 1: Lucifer999 (big blind) folded before Flop
Seat 2: manny007 folded on the Flop
Seat 4: Silentfade showed [Jh Ac] and lost with Two pairs, JJ22
Seat 5: Preet991 (button) folded before Flop (didn't bet)
Seat 6: Avaroni  (small blind) showed [6c 6h] and won ($926.25) with Full house, 66622



PokerStars Game #00327516316: Hold'em No Limit ($10/$25 USD) - 2022/04/30 08:26:13 ET
Table 'Hold'em (Min 500Max 2500)  1282' 6-max Seat #5 is the button
Seat 1: PANCHYOU ($1132.46 in chips) 
Seat 2: kash1102 ($2430 in chips) 
Seat 3: golden585 ($5827.1 in chips) 
Seat 4: SA754 ($688.69 in chips) 
Seat 5: Lucifer999 ($2500 in chips) 
Seat 6: No username ($1961.74 in chips) 
No username: posts small blind $10
kash1102: posts big blind $25
*** HOLE CARDS ***
Dealt to Lucifer999 [Qc 7d]
golden585: folds
SA754: calls $25
Lucifer999: folds
No username: folds
kash1102: checks
*** FLOP *** [4d 2h 3h]
kash1102: checks
SA754: checks
*** TURN *** [4d 2h 3h] [3s]
kash1102: checks
SA754: checks
*** RIVER *** [4d 2h 3h 3s] [Ad]
kash1102: checks
SA754: bets $173.85
kash1102: folds
Uncalled bet ($173.85) returned to SA754
SA754: doesn't show hand
SA754 collected $56.85 from pot
*** SUMMARY ***
Total pot $60.00 | Rake $3.15
Board [4d 2h 3h 3s Ad]
Seat 2: kash1102 (big blind) folded on the River
Seat 3: golden585 folded before Flop (didn't bet)
Seat 4: SA754 collected ($56.85)
Seat 5: Lucifer999 (button) folded before Flop (didn't bet)
Seat 6: No username (small blind) folded before Flop



PokerStars Game #00327516412: Hold'em No Limit ($25/$50 USD) - 2022/04/30 08:26:46 ET
Table 'Hold'em (Min 1K Max 5K)   216' 6-max Seat #6 is the button
Seat 1: Lucifer999 ($5000 in chips) 
Seat 2: manny007 ($900 in chips) 
Seat 3: avi098x ($2984.02 in chips) 
Seat 5: Preet991 ($5200 in chips) 
Seat 6: Avaroni ($6926.25 in chips) 
Lucifer999: posts small blind $25
manny007: posts big blind $50
*** HOLE CARDS ***
Dealt to Lucifer999 [Qs 4d]
Preet991: calls $50
Avaroni: folds
Lucifer999: folds
manny007: checks
*** FLOP *** [Qc 6h 9h]
manny007: checks
Preet991: checks
*** TURN *** [Qc 6h 9h] [8h]
manny007: checks
Preet991: checks
*** RIVER *** [Qc 6h 9h 8h] [7s]
manny007: bets $118.75
Preet991: calls $118.75
*** SHOW DOWN ***
manny007: shows [Tc 3h] (Straight, T-6)
Preet991: doesn't show hand
manny007 collected $344.4 from pot
*** SUMMARY ***
Total pot $362.50 | Rake $18.1
Board [Qc 6h 9h 8h 7s]
Seat 1: Lucifer999 (small blind) folded before Flop
Seat 2: manny007  (big blind) showed [Tc 3h] and won ($344.4) with Straight, T-6
Seat 5: Preet991 mucked
Seat 6: Avaroni (button) folded before Flop (didn't bet)



PokerStars Game #00327516490: Hold'em No Limit ($25/$50 USD) - 2022/04/30 08:27:15 ET
Table 'Hold'em (Min 1K Max 5K)   216' 6-max Seat #1 is the button
Seat 1: Lucifer999 ($5000 in chips) 
Seat 3: avi098x ($2984.02 in chips) 
Seat 5: Preet991 ($5031.25 in chips) 
Seat 6: Avaroni ($6926.25 in chips) 
Preet991: posts small blind $25
Avaroni: posts big blind $50
*** HOLE CARDS ***
Dealt to Lucifer999 [Jh As]
Lucifer999: folds
Preet991: folds
Uncalled bet ($25) returned to Avaroni
Avaroni: doesn't show hand
Avaroni collected $50 from pot
*** SUMMARY ***
Total pot $50.00 | Rake $0
Board []
Seat 1: Lucifer999 (button) folded before Flop (didn't bet)
Seat 5: Preet991 (small blind) folded before Flop
Seat 6: Avaroni (big blind) collected ($50)



PokerStars Game #00327516444: Hold'em No Limit ($10/$25 USD) - 2022/04/30 08:26:58 ET
Table 'Hold'em (Min 500Max 2500)  1282' 6-max Seat #6 is the button
Seat 1: PANCHYOU ($1132.46 in chips) 
Seat 2: kash1102 ($2405 in chips) 
Seat 3: manny007 ($1075.65 in chips) 
Seat 4: SA754 ($720.54 in chips) 
Seat 5: Lucifer999 ($2500 in chips) 
Seat 6: No username ($1951.74 in chips) 
kash1102: posts small blind $10
SA754: posts big blind $25
*** HOLE CARDS ***
Dealt to Lucifer999 [4h 2h]
Lucifer999: folds
No username: raises $60.00 to $85
kash1102: folds
SA754: calls $60
*** FLOP *** [9d Ts 4d]
SA754: checks
No username: bets $84.78
SA754: folds
Uncalled bet ($84.78) returned to No username
No username: doesn't show hand
No username collected $169.55 from pot
*** SUMMARY ***
Total pot $180.00 | Rake $10.45
Board [9d Ts 4d]
Seat 2: kash1102 (small blind) folded before Flop
Seat 4: SA754 (big blind) folded on the Flop
Seat 5: Lucifer999 folded before Flop (didn't bet)
Seat 6: No username (button) collected ($169.55)



PokerStars Game #00327516546: Hold'em No Limit ($25/$50 USD) - 2022/04/30 08:27:33 ET
Table 'Hold'em (Min 1K Max 5K)   216' 6-max Seat #5 is the button
Seat 1: Lucifer999 ($5000 in chips) 
Seat 3: avi098x ($2984.02 in chips) 
Seat 5: Preet991 ($5006.25 in chips) 
Seat 6: Avaroni ($6951.25 in chips) 
Avaroni: posts small blind $25
Lucifer999: posts big blind $50
*** HOLE CARDS ***
Dealt to Lucifer999 [7s 7c]
avi098x: raises $50.00 to $100
Preet991: folds
Avaroni: folds
Lucifer999: calls $100
*** FLOP *** [Kh 9d 4c]
Lucifer999: checks
avi098x: checks
*** TURN *** [Kh 9d 4c] [8s]
Lucifer999: checks
avi098x: bets $166.25
Lucifer999: calls $166.25
*** RIVER *** [Kh 9d 4c 8s] [3d]
Lucifer999: checks
avi098x: checks
*** SHOW DOWN ***
avi098x: shows [6d Ad] (High card, A)
Lucifer999: shows [7s 7c] (Pair, 77)
Lucifer999 collected $648.4 from pot
*** SUMMARY ***
Total pot $682.50 | Rake $34.1
Board [Kh 9d 4c 8s 3d]
Seat 1: Lucifer999  (big blind) showed [7s 7c] and won ($648.4) with Pair, 77
Seat 3: avi098x showed [6d Ad] and lost with High card, A
Seat 5: Preet991 (button) folded before Flop (didn't bet)
Seat 6: Avaroni (small blind) folded before Flop



PokerStars Game #00327516558: Hold'em No Limit ($10/$25 USD) - 2022/04/30 08:27:38 ET
Table 'Hold'em (Min 500Max 2500)  1282' 6-max Seat #2 is the button
Seat 1: PANCHYOU ($1132.46 in chips) 
Seat 2: kash1102 ($2395 in chips) 
Seat 3: manny007 ($1075.65 in chips) 
Seat 4: SA754 ($635.54 in chips) 
Seat 5: Lucifer999 ($2500 in chips) 
Seat 6: No username ($2036.29 in chips) 
SA754: posts small blind $10
Lucifer999: posts big blind $25
*** HOLE CARDS ***
Dealt to Lucifer999 [6s 3d]
No username: raises $38.75 to $63.75
kash1102: folds
SA754: calls $53.75
Lucifer999: folds
*** FLOP *** [Ah Tc Js]
SA754: checks
No username: checks
*** TURN *** [Ah Tc Js] [Td]
SA754: checks
No username: checks
*** RIVER *** [Ah Tc Js Td] [3h]
SA754: bets $143.52
No username: folds
Uncalled bet ($143.52) returned to SA754
SA754: doesn't show hand
SA754 collected $143.52 from pot
*** SUMMARY ***
Total pot $152.50 | Rake $8.98
Board [Ah Tc Js Td 3h]
Seat 2: kash1102 (button) folded before Flop (didn't bet)
Seat 4: SA754 (small blind) collected ($143.52)
Seat 5: Lucifer999 (big blind) folded before Flop
Seat 6: No username folded on the River



PokerStars Game #00327516695: Hold'em No Limit ($10/$25 USD) - 2022/04/30 08:28:27 ET
Table 'Hold'em (Min 500Max 2500)  1282' 6-max Seat #4 is the button
Seat 1: PANCHYOU ($1132.46 in chips) 
Seat 2: kash1102 ($2395 in chips) 
Seat 3: manny007 ($1075.65 in chips) 
Seat 4: SA754 ($715.31 in chips) 
Seat 5: Lucifer999 ($2500 in chips) 
Seat 6: No username ($1972.54 in chips) 
Lucifer999: posts small blind $10
No username: posts big blind $25
manny007: posts big blind $25
*** HOLE CARDS ***
Dealt to Lucifer999 [Qh Ah]
kash1102: folds
manny007: checks
SA754: folds
Lucifer999: raises $85.00 to $110
No username: folds
manny007: folds
Uncalled bet ($85) returned to Lucifer999
Lucifer999: doesn't show hand
Lucifer999 collected $75 from pot
*** SUMMARY ***
Total pot $75.00 | Rake $0
Board []
Seat 2: kash1102 folded before Flop (didn't bet)
Seat 3: manny007 folded before Flop
Seat 4: SA754 (button) folded before Flop (didn't bet)
Seat 5: Lucifer999 (small blind) collected ($75)
Seat 6: No username (big blind) folded before Flop



PokerStars Game #00327516685: Hold'em No Limit ($25/$50 USD) - 2022/04/30 08:28:24 ET
Table 'Hold'em (Min 1K Max 5K)   216' 6-max Seat #6 is the button
Seat 1: Lucifer999 ($5332.15 in chips) 
Seat 3: avi098x ($2642.77 in chips) 
Seat 5: Preet991 ($5006.25 in chips) 
Seat 6: Avaroni ($6926.25 in chips) 
Lucifer999: posts small blind $25
avi098x: posts big blind $50
*** HOLE CARDS ***
Dealt to Lucifer999 [Ad 7d]
Preet991: folds
Avaroni: raises $100.00 to $150
Lucifer999: calls $125
avi098x: folds
*** FLOP *** [Qh 9d 4c]
Lucifer999: checks
Avaroni: bets $225
Lucifer999: folds
Uncalled bet ($225) returned to Avaroni
Avaroni: doesn't show hand
Avaroni collected $332.5 from pot
*** SUMMARY ***
Total pot $350.00 | Rake $17.5
Board [Qh 9d 4c]
Seat 1: Lucifer999 (small blind) folded on the Flop
Seat 3: avi098x (big blind) folded before Flop
Seat 5: Preet991 folded before Flop (didn't bet)
Seat 6: Avaroni (button) collected ($332.5)



PokerStars Game #00327516804: Hold'em No Limit ($25/$50 USD) - 2022/04/30 08:29:05 ET
Table 'Hold'em (Min 1K Max 5K)   216' 6-max Seat #1 is the button
Seat 1: Lucifer999 ($5182.15 in chips) 
Seat 3: avi098x ($2592.77 in chips) 
Seat 5: Preet991 ($5006.25 in chips) 
Seat 6: Avaroni ($7108.75 in chips) 
avi098x: posts small blind $25
Preet991: posts big blind $50
*** HOLE CARDS ***
Dealt to Lucifer999 [Td 9s]
Avaroni: folds
Lucifer999: raises $100.00 to $150
avi098x: calls $125
Preet991: folds
*** FLOP *** [Jc Qc Qh]
avi098x: checks
Lucifer999: bets $225
avi098x: calls $225
*** TURN *** [Jc Qc Qh] [7h]
avi098x: checks
Lucifer999: checks
*** RIVER *** [Jc Qc Qh 7h] [Ah]
avi098x: bets $2217.77
Lucifer999: folds
Uncalled bet ($2217.77) returned to avi098x
avi098x: doesn't show hand
avi098x collected $760 from pot
*** SUMMARY ***
Total pot $800.00 | Rake $40
Board [Jc Qc Qh 7h Ah]
Seat 1: Lucifer999 (button) folded on the River
Seat 3: avi098x (small blind) collected ($760)
Seat 5: Preet991 (big blind) folded before Flop
Seat 6: Avaroni folded before Flop (didn't bet)



PokerStars Game #00327516760: Hold'em No Limit ($10/$25 USD) - 2022/04/30 08:28:50 ET
Table 'Hold'em (Min 500Max 2500)  1282' 6-max Seat #5 is the button
Seat 1: PANCHYOU ($1132.46 in chips) 
Seat 2: kash1102 ($2395 in chips) 
Seat 3: manny007 ($1050.65 in chips) 
Seat 4: SA754 ($715.31 in chips) 
Seat 5: Lucifer999 ($2550 in chips) 
Seat 6: No username ($1947.54 in chips) 
No username: posts small blind $10
PANCHYOU: posts big blind $25
*** HOLE CARDS ***
Dealt to Lucifer999 [7d Qs]
kash1102: folds
manny007: calls $25
SA754: calls $25
Lucifer999: folds
No username: raises $42.50 to $67.5
PANCHYOU: folds
manny007: calls $42.5
SA754: calls $42.5
*** FLOP *** [Qd 5c Kd]
No username: checks
manny007: checks
SA754: checks
*** TURN *** [Qd 5c Kd] [9c]
No username: bets $106.8
manny007: calls $106.8
SA754: calls $106.8
*** RIVER *** [Qd 5c Kd 9c] [9s]
No username: bets $138.69
manny007: calls $138.69
SA754: folds
*** SHOW DOWN ***
No username: shows [7h Qh] (Two pairs, QQ99)
manny007: shows [9d Jc] (Three of a kind, 999)
manny007 collected $776.97 from pot
*** SUMMARY ***
Total pot $825.28 | Rake $48.31
Board [Qd 5c Kd 9c 9s]
Seat 1: PANCHYOU (big blind) folded before Flop
Seat 2: kash1102 folded before Flop (didn't bet)
Seat 3: manny007  showed [9d Jc] and won ($776.97) with Three of a kind, 999
Seat 4: SA754 folded on the River
Seat 5: Lucifer999 (button) folded before Flop (didn't bet)
Seat 6: No username (small blind) showed [7h Qh] and lost with Two pairs, QQ99



PokerStars Game #00327517020: Hold'em No Limit ($25/$50 USD) - 2022/04/30 08:30:22 ET
Table 'Hold'em (Min 1K Max 5K)   216' 6-max Seat #3 is the button
Seat 1: Lucifer999 ($5000 in chips) 
Seat 2: Silentfade ($1794.66 in chips) 
Seat 3: avi098x ($2977.77 in chips) 
Seat 5: Preet991 ($4956.25 in chips) 
Seat 6: Avaroni ($7108.75 in chips) 
Preet991: posts small blind $25
Avaroni: posts big blind $50
Silentfade: posts big blind $50
*** HOLE CARDS ***
Dealt to Lucifer999 [7s Qs]
Lucifer999: folds
Silentfade: checks
avi098x: raises $100.00 to $150
Preet991: folds
Avaroni: folds
Silentfade: folds
Uncalled bet ($100) returned to avi098x
avi098x: doesn't show hand
avi098x collected $175 from pot
*** SUMMARY ***
Total pot $175.00 | Rake $0
Board []
Seat 1: Lucifer999 folded before Flop (didn't bet)
Seat 2: Silentfade folded before Flop
Seat 3: avi098x (button) collected ($175)
Seat 5: Preet991 (small blind) folded before Flop
Seat 6: Avaroni (big blind) folded before Flop



PokerStars Game #00327517099: Hold'em No Limit ($25/$50 USD) - 2022/04/30 08:30:58 ET
Table 'Hold'em (Min 1K Max 5K)   216' 6-max Seat #5 is the button
Seat 1: Lucifer999 ($5000 in chips) 
Seat 2: Silentfade ($1744.66 in chips) 
Seat 3: avi098x ($3102.77 in chips) 
Seat 5: Preet991 ($4931.25 in chips) 
Seat 6: Avaroni ($7058.75 in chips) 
Avaroni: posts small blind $25
Lucifer999: posts big blind $50
*** HOLE CARDS ***
Dealt to Lucifer999 [5c Td]
Silentfade: folds
Preet991: folds
Avaroni: raises $100.00 to $150
Lucifer999: folds
Uncalled bet ($100) returned to Avaroni
Avaroni: doesn't show hand
Avaroni collected $100 from pot
*** SUMMARY ***
Total pot $100.00 | Rake $0
Board []
Seat 1: Lucifer999 (big blind) folded before Flop
Seat 2: Silentfade folded before Flop (didn't bet)
Seat 5: Preet991 (button) folded before Flop (didn't bet)
Seat 6: Avaroni (small blind) collected ($100)



PokerStars Game #00327517028: Hold'em No Limit ($10/$25 USD) - 2022/04/30 08:30:23 ET
Table 'Hold'em (Min 500Max 2500)  1282' 6-max Seat #6 is the button
Seat 1: PANCHYOU ($1107.46 in chips) 
Seat 2: kash1102 ($2395 in chips) 
Seat 3: manny007 ($1514.63 in chips) 
Seat 4: SA754 ($541.01 in chips) 
Seat 5: Lucifer999 ($2550 in chips) 
Seat 6: No username ($1634.55 in chips) 
PANCHYOU: posts small blind $10
kash1102: posts big blind $25
*** HOLE CARDS ***
Dealt to Lucifer999 [Kh 7c]
manny007: folds
SA754: calls $25
Lucifer999: folds
No username: folds
PANCHYOU: folds
kash1102: checks
*** FLOP *** [3d 6h 9c]
kash1102: checks
SA754: checks
*** TURN *** [3d 6h 9c] [6s]
kash1102: checks
SA754: checks
*** RIVER *** [3d 6h 9c 6s] [Js]
kash1102: bets $25
SA754: raises $106.85 to $131.85
kash1102: folds
Uncalled bet ($106.85) returned to SA754
SA754: doesn't show hand
SA754 collected $103.23 from pot
*** SUMMARY ***
Total pot $110.00 | Rake $6.77
Board [3d 6h 9c 6s Js]
Seat 1: PANCHYOU (small blind) folded before Flop
Seat 2: kash1102 (big blind) folded on the River
Seat 3: manny007 folded before Flop (didn't bet)
Seat 4: SA754 collected ($103.23)
Seat 5: Lucifer999 folded before Flop (didn't bet)
Seat 6: No username (button) folded before Flop (didn't bet)



PokerStars Game #00327517147: Hold'em No Limit ($25/$50 USD) - 2022/04/30 08:31:16 ET
Table 'Hold'em (Min 1K Max 5K)   216' 6-max Seat #6 is the button
Seat 1: Lucifer999 ($5000 in chips) 
Seat 5: Preet991 ($4931.25 in chips) 
Seat 6: Avaroni ($7108.75 in chips) 
Lucifer999: posts small blind $25
Preet991: posts big blind $50
*** HOLE CARDS ***
Dealt to Lucifer999 [5h Jh]
Avaroni: raises $100.00 to $150
Lucifer999: folds
Preet991: folds
Uncalled bet ($100) returned to Avaroni
Avaroni: doesn't show hand
Avaroni collected $125 from pot
*** SUMMARY ***
Total pot $125.00 | Rake $0
Board []
Seat 1: Lucifer999 (small blind) folded before Flop
Seat 5: Preet991 (big blind) folded before Flop
Seat 6: Avaroni (button) collected ($125)



PokerStars Game #00327517208: Hold'em No Limit ($25/$50 USD) - 2022/04/30 08:31:42 ET
Table 'Hold'em (Min 1K Max 5K)   216' 6-max Seat #1 is the button
Seat 1: Lucifer999 ($5000 in chips) 
Seat 5: Preet991 ($4881.25 in chips) 
Seat 6: Avaroni ($7183.75 in chips) 
Preet991: posts small blind $25
Avaroni: posts big blind $50
*** HOLE CARDS ***
Dealt to Lucifer999 [3h 5h]
Lucifer999: folds
Preet991: raises $100.00 to $150
Avaroni: calls $100
*** FLOP *** [4d 9c 4c]
Preet991: bets $285
Avaroni: calls $285
*** TURN *** [4d 9c 4c] [Kd]
Preet991: bets $826.5
Avaroni: folds
Uncalled bet ($826.5) returned to Preet991
Preet991: doesn't show hand
Preet991 collected $826.5 from pot
*** SUMMARY ***
Total pot $870.00 | Rake $43.5
Board [4d 9c 4c Kd]
Seat 1: Lucifer999 (button) folded before Flop (didn't bet)
Seat 5: Preet991 (small blind) collected ($826.5)
Seat 6: Avaroni (big blind) folded on the Turn



PokerStars Game #00327517194: Hold'em No Limit ($10/$25 USD) - 2022/04/30 08:31:34 ET
Table 'Hold'em (Min 500Max 2500)  1282' 6-max Seat #1 is the button
Seat 1: PANCHYOU ($1097.46 in chips) 
Seat 2: kash1102 ($2345 in chips) 
Seat 3: manny007 ($1514.63 in chips) 
Seat 4: SA754 ($594.24 in chips) 
Seat 5: Lucifer999 ($2550 in chips) 
Seat 6: No username ($1634.55 in chips) 
kash1102: posts small blind $10
manny007: posts big blind $25
*** HOLE CARDS ***
Dealt to Lucifer999 [2h 4s]
SA754: calls $25
Lucifer999: folds
No username: raises $85.00 to $110
PANCHYOU: folds
kash1102: folds
manny007: folds
SA754: calls $85
*** FLOP *** [9s Kc 8s]
SA754: checks
No username: bets $119.81
SA754: raises $364.43 to $484.24
No username: calls $364.43
*** TURN *** [9s Kc 8s] [7s]
*** RIVER *** [9s Kc 8s 7s] [4c]
*** SHOW DOWN ***
SA754: shows [5c Kd] (Pair, KK)
No username: shows [6d 8d] (Pair, 88)
SA754 collected $1154.28 from pot
*** SUMMARY ***
Total pot $1223.48 | Rake $69.2
Board [9s Kc 8s 7s 4c]
Seat 1: PANCHYOU (button) folded before Flop (didn't bet)
Seat 2: kash1102 (small blind) folded before Flop
Seat 3: manny007 (big blind) folded before Flop
Seat 4: SA754  showed [5c Kd] and won ($1154.28) with Pair, KK
Seat 5: Lucifer999 folded before Flop (didn't bet)
Seat 6: No username showed [6d 8d] and lost with Pair, 88



PokerStars Game #00327517287: Hold'em No Limit ($25/$50 USD) - 2022/04/30 08:32:16 ET
Table 'Hold'em (Min 1K Max 5K)   216' 6-max Seat #5 is the button
Seat 1: Lucifer999 ($5000 in chips) 
Seat 5: Preet991 ($5272.75 in chips) 
Seat 6: Avaroni ($6748.75 in chips) 
Avaroni: posts small blind $25
Lucifer999: posts big blind $50
*** HOLE CARDS ***
Dealt to Lucifer999 [Qh 9h]
Preet991: folds
Avaroni: raises $100.00 to $150
Lucifer999: calls $100
*** FLOP *** [3d Ah 2d]
Avaroni: bets $175
Lucifer999: calls $175
*** TURN *** [3d Ah 2d] [2h]
Avaroni: checks
Lucifer999: bets $300
Avaroni: folds
Uncalled bet ($300) returned to Lucifer999
Lucifer999: doesn't show hand
Lucifer999 collected $617.5 from pot
*** SUMMARY ***
Total pot $650.00 | Rake $32.5
Board [3d Ah 2d 2h]
Seat 1: Lucifer999 (big blind) collected ($617.5)
Seat 5: Preet991 (button) folded before Flop (didn't bet)
Seat 6: Avaroni (small blind) folded on the Turn



PokerStars Game #00327517306: Hold'em No Limit ($10/$25 USD) - 2022/04/30 08:32:23 ET
Table 'Hold'em (Min 500Max 2500)  1282' 6-max Seat #2 is the button
Seat 1: PANCHYOU ($1097.46 in chips) 
Seat 2: kash1102 ($2335 in chips) 
Seat 3: manny007 ($1489.63 in chips) 
Seat 4: SA754 ($1154.28 in chips) 
Seat 5: Lucifer999 ($2550 in chips) 
Seat 6: No username ($1040.31 in chips) 
manny007: posts small blind $10
SA754: posts big blind $25
*** HOLE CARDS ***
Dealt to Lucifer999 [5h Jd]
Lucifer999: folds
No username: folds
PANCHYOU: folds
kash1102: folds
manny007: raises $50.00 to $75
SA754: folds
Uncalled bet ($50) returned to manny007
manny007: doesn't show hand
manny007 collected $50 from pot
*** SUMMARY ***
Total pot $50.00 | Rake $0
Board []
Seat 1: PANCHYOU folded before Flop (didn't bet)
Seat 2: kash1102 (button) folded before Flop (didn't bet)
Seat 3: manny007 (small blind) collected ($50)
Seat 4: SA754 (big blind) folded before Flop
Seat 5: Lucifer999 folded before Flop (didn't bet)
Seat 6: No username folded before Flop (didn't bet)



PokerStars Game #00327517383: Hold'em No Limit ($25/$50 USD) - 2022/04/30 08:32:55 ET
Table 'Hold'em (Min 1K Max 5K)   216' 6-max Seat #6 is the button
Seat 1: Lucifer999 ($5292.5 in chips) 
Seat 5: Preet991 ($5272.75 in chips) 
Seat 6: Avaroni ($6423.75 in chips) 
Lucifer999: posts small blind $25
Preet991: posts big blind $50
*** HOLE CARDS ***
Dealt to Lucifer999 [2h 9s]
Avaroni: folds
Lucifer999: folds
Uncalled bet ($25) returned to Preet991
Preet991: doesn't show hand
Preet991 collected $50 from pot
*** SUMMARY ***
Total pot $50.00 | Rake $0
Board []
Seat 1: Lucifer999 (small blind) folded before Flop
Seat 5: Preet991 (big blind) collected ($50)
Seat 6: Avaroni (button) folded before Flop (didn't bet)



PokerStars Game #00327517437: Hold'em No Limit ($25/$50 USD) - 2022/04/30 08:33:16 ET
Table 'Hold'em (Min 1K Max 5K)   216' 6-max Seat #1 is the button
Seat 1: Lucifer999 ($5267.5 in chips) 
Seat 5: Preet991 ($5297.75 in chips) 
Seat 6: Avaroni ($6423.75 in chips) 
Preet991: posts small blind $25
Avaroni: posts big blind $50
*** HOLE CARDS ***
Dealt to Lucifer999 [Kh 7d]
Lucifer999: folds
Preet991: folds
Uncalled bet ($25) returned to Avaroni
Avaroni: doesn't show hand
Avaroni collected $50 from pot
*** SUMMARY ***
Total pot $50.00 | Rake $0
Board []
Seat 1: Lucifer999 (button) folded before Flop (didn't bet)
Seat 5: Preet991 (small blind) folded before Flop
Seat 6: Avaroni (big blind) collected ($50)



PokerStars Game #00327517409: Hold'em No Limit ($10/$25 USD) - 2022/04/30 08:33:01 ET
Table 'Hold'em (Min 500Max 2500)  1282' 6-max Seat #3 is the button
Seat 1: PANCHYOU ($1097.46 in chips) 
Seat 2: kash1102 ($2335 in chips) 
Seat 3: manny007 ($1514.63 in chips) 
Seat 4: SA754 ($1129.28 in chips) 
Seat 5: Lucifer999 ($2550 in chips) 
Seat 6: No username ($1040.31 in chips) 
SA754: posts small blind $10
Lucifer999: posts big blind $25
*** HOLE CARDS ***
Dealt to Lucifer999 [4c 8h]
No username: folds
PANCHYOU: folds
kash1102: folds
manny007: folds
SA754: calls $15
Lucifer999: checks
*** FLOP *** [Ts Td Ah]
SA754: checks
Lucifer999: bets $25
SA754: calls $25
*** TURN *** [Ts Td Ah] [Kc]
SA754: checks
Lucifer999: checks
*** RIVER *** [Ts Td Ah Kc] [Kh]
SA754: bets $206.35
Lucifer999: folds
Uncalled bet ($206.35) returned to SA754
SA754: doesn't show hand
SA754 collected $93.75 from pot
*** SUMMARY ***
Total pot $100.00 | Rake $6.25
Board [Ts Td Ah Kc Kh]
Seat 1: PANCHYOU folded before Flop (didn't bet)
Seat 2: kash1102 folded before Flop (didn't bet)
Seat 3: manny007 (button) folded before Flop (didn't bet)
Seat 4: SA754 (small blind) collected ($93.75)
Seat 5: Lucifer999 (big blind) folded on the River
Seat 6: No username folded before Flop (didn't bet)



PokerStars Game #00327517549: Hold'em No Limit ($25/$50 USD) - 2022/04/30 08:34:06 ET
Table 'Hold'em (Min 1K Max 5K)   216' 6-max Seat #6 is the button
Seat 1: Lucifer999 ($5267.5 in chips) 
Seat 5: Preet991 ($5272.75 in chips) 
Seat 6: Avaroni ($6448.75 in chips) 
Avaroni: posts small blind $25
Lucifer999: posts big blind $50
*** HOLE CARDS ***
Dealt to Lucifer999 [Ah As]
Avaroni: raises $50.00 to $100
Lucifer999: raises $250.00 to $350
Avaroni: folds
Uncalled bet ($250) returned to Lucifer999
Lucifer999: doesn't show hand
Lucifer999 collected $200 from pot
*** SUMMARY ***
Total pot $200.00 | Rake $0
Board []
Seat 1: Lucifer999 (big blind) collected ($200)
Seat 6: Avaroni (button) (small blind) folded before Flop



PokerStars Game #00327517587: Hold'em No Limit ($25/$50 USD) - 2022/04/30 08:34:26 ET
Table 'Hold'em (Min 1K Max 5K)   216' 6-max Seat #1 is the button
Seat 1: Lucifer999 ($5367.5 in chips) 
Seat 5: Preet991 ($5272.75 in chips) 
Seat 6: Avaroni ($6348.75 in chips) 
Preet991: posts small blind $25
Avaroni: posts big blind $50
*** HOLE CARDS ***
Dealt to Lucifer999 [Ts 2s]
Lucifer999: folds
Preet991: calls $25
Avaroni: raises $125.00 to $175
Preet991: calls $125
*** FLOP *** [4d 6h 8c]
Preet991: checks
Avaroni: checks
*** TURN *** [4d 6h 8c] [5d]
Preet991: checks
Avaroni: checks
*** RIVER *** [4d 6h 8c 5d] [2h]
Preet991: bets $332.5
Avaroni: folds
Uncalled bet ($332.5) returned to Preet991
Preet991: doesn't show hand
Preet991 collected $332.5 from pot
*** SUMMARY ***
Total pot $350.00 | Rake $17.5
Board [4d 6h 8c 5d 2h]
Seat 1: Lucifer999 (button) folded before Flop (didn't bet)
Seat 5: Preet991 (small blind) collected ($332.5)
Seat 6: Avaroni (big blind) folded on the River



PokerStars Game #00327517566: Hold'em No Limit ($10/$25 USD) - 2022/04/30 08:34:17 ET
Table 'Hold'em (Min 500Max 2500)  1282' 6-max Seat #4 is the button
Seat 1: PANCHYOU ($1097.46 in chips) 
Seat 2: kash1102 ($2335 in chips) 
Seat 3: manny007 ($1514.63 in chips) 
Seat 4: SA754 ($1173.03 in chips) 
Seat 5: Lucifer999 ($2500 in chips) 
Seat 6: No username ($2500 in chips) 
Lucifer999: posts small blind $10
No username: posts big blind $25
*** HOLE CARDS ***
Dealt to Lucifer999 [9c 6s]
PANCHYOU: calls $25
manny007: raises $47.61 to $72.61
SA754: calls $72.61
Lucifer999: folds
No username: calls $47.61
PANCHYOU: calls $47.61
*** FLOP *** [4d 2d Kc]
No username: checks
PANCHYOU: checks
manny007: bets $171.85
SA754: calls $171.85
No username: folds
PANCHYOU: calls $171.85
*** TURN *** [4d 2d Kc] [2c]
PANCHYOU: checks
manny007: bets $255.95
SA754: folds
PANCHYOU: folds
Uncalled bet ($255.95) returned to manny007
manny007: doesn't show hand
manny007 collected $768.21 from pot
*** SUMMARY ***
Total pot $815.99 | Rake $47.78
Board [4d 2d Kc 2c]
Seat 1: PANCHYOU folded on the Turn
Seat 3: manny007 collected ($768.21)
Seat 4: SA754 (button) folded on the Turn
Seat 5: Lucifer999 (small blind) folded before Flop
Seat 6: No username (big blind) folded on the Flop



PokerStars Game #00327517695: Hold'em No Limit ($25/$50 USD) - 2022/04/30 08:35:09 ET
Table 'Hold'em (Min 1K Max 5K)   216' 6-max Seat #5 is the button
Seat 1: Lucifer999 ($5367.5 in chips) 
Seat 5: Preet991 ($5430.25 in chips) 
Seat 6: Avaroni ($6173.75 in chips) 
Avaroni: posts small blind $25
Lucifer999: posts big blind $50
*** HOLE CARDS ***
Dealt to Lucifer999 [4h Jh]
Preet991: raises $150.00 to $200
Avaroni: folds
Lucifer999: folds
Uncalled bet ($150) returned to Preet991
Preet991: doesn't show hand
Preet991 collected $125 from pot
*** SUMMARY ***
Total pot $125.00 | Rake $0
Board []
Seat 1: Lucifer999 (big blind) folded before Flop
Seat 5: Preet991 (button) collected ($125)
Seat 6: Avaroni (small blind) folded before Flop



PokerStars Game #00327517827: Hold'em No Limit ($50/$100 USD) - 2022/04/30 08:35:59 ET
Table 'Hold'em (Min 25KMax 10K)    69' 6-max Seat #1 is the button
Seat 1: Lucifer999 ($10000 in chips) 
Seat 4: vinuth ($10000 in chips) 
Lucifer999: posts small blind $50
vinuth: posts big blind $100
*** HOLE CARDS ***
Dealt to Lucifer999 [Td Jd]
Lucifer999: raises $150.00 to $250
vinuth: folds
Uncalled bet ($150) returned to Lucifer999
Lucifer999: doesn't show hand
Lucifer999 collected $200 from pot
*** SUMMARY ***
Total pot $200.00 | Rake $0
Board []
Seat 1: Lucifer999 (button) (small blind) collected ($200)
Seat 4: vinuth (big blind) folded before Flop



PokerStars Game #00327517759: Hold'em No Limit ($25/$50 USD) - 2022/04/30 08:35:34 ET
Table 'Hold'em (Min 1K Max 5K)   216' 6-max Seat #6 is the button
Seat 1: Lucifer999 ($5317.5 in chips) 
Seat 5: Preet991 ($5505.25 in chips) 
Seat 6: Avaroni ($6148.75 in chips) 
Lucifer999: posts small blind $25
Preet991: posts big blind $50
*** HOLE CARDS ***
Dealt to Lucifer999 [Ah Ac]
Avaroni: folds
Lucifer999: raises $125.00 to $175
Preet991: raises $350.00 to $525
Lucifer999: raises $875.00 to $1400
Preet991: raises $4105.25 to $5505.25
Lucifer999: calls $3917.5
Uncalled bet ($187.75) returned to Preet991
*** FLOP *** [5d 8h 2d]
*** FLOP *** [4c 8s Ts]
*** TURN *** [5d 8h 2d] [Kd]
*** TURN *** [5d 8h 2d] [2s]
*** RIVER *** [5d 8h 2d Kd] [Qh]
*** RIVER *** [5d 8h 2d Kd] [2c]
*** SHOW DOWN ***
Lucifer999: shows [Ah Ac] (Two pairs, AA22)
Preet991: shows [Qs Qd] (Two pairs, QQ22)
Preet991 collected $5173 from pot
Lucifer999 collected $5173 from pot
*** SUMMARY ***
Total pot $10635.00 | Rake $289
Board [5d 8h 2d Kd Qh]
Seat 1: Lucifer999  (small blind) showed [Ah Ac] and won ($5173) with Two pairs, AA22
Seat 5: Preet991  (big blind) showed [Qs Qd] and won ($5173) with Two pairs, QQ22
Seat 6: Avaroni (button) folded before Flop (didn't bet)



PokerStars Game #00327517881: Hold'em No Limit ($50/$100 USD) - 2022/04/30 08:36:21 ET
Table 'Hold'em (Min 25KMax 10K)    69' 6-max Seat #4 is the button
Seat 1: Lucifer999 ($10100 in chips) 
Seat 4: vinuth ($9900 in chips) 
vinuth: posts small blind $50
Lucifer999: posts big blind $100
*** HOLE CARDS ***
Dealt to Lucifer999 [Ad 6d]
vinuth: folds
Uncalled bet ($50) returned to Lucifer999
Lucifer999: doesn't show hand
Lucifer999 collected $100 from pot
*** SUMMARY ***
Total pot $100.00 | Rake $0
Board []
Seat 1: Lucifer999 (big blind) collected ($100)
Seat 4: vinuth (button) (small blind) folded before Flop



PokerStars Game #00327517747: Hold'em No Limit ($10/$25 USD) - 2022/04/30 08:35:30 ET
Table 'Hold'em (Min 500Max 2500)  1282' 6-max Seat #5 is the button
Seat 1: PANCHYOU ($853 in chips) 
Seat 2: kash1102 ($2335 in chips) 
Seat 3: manny007 ($2038.38 in chips) 
Seat 4: SA754 ($928.57 in chips) 
Seat 5: Lucifer999 ($2500 in chips) 
Seat 6: No username ($2427.39 in chips) 
No username: posts small blind $10
PANCHYOU: posts big blind $25
*** HOLE CARDS ***
Dealt to Lucifer999 [5h 8h]
kash1102: folds
manny007: folds
SA754: raises $25.00 to $50
Lucifer999: folds
No username: calls $40
PANCHYOU: folds
*** FLOP *** [Ad Ac Kc]
No username: checks
SA754: bets $117.44
No username: calls $117.44
*** TURN *** [Ad Ac Kc] [6d]
No username: checks
SA754: checks
*** RIVER *** [Ad Ac Kc 6d] [5d]
No username: bets $169.02
SA754: folds
Uncalled bet ($169.02) returned to No username
No username: doesn't show hand
No username collected $338.04 from pot
*** SUMMARY ***
Total pot $359.88 | Rake $21.84
Board [Ad Ac Kc 6d 5d]
Seat 1: PANCHYOU (big blind) folded before Flop
Seat 2: kash1102 folded before Flop (didn't bet)
Seat 3: manny007 folded before Flop (didn't bet)
Seat 4: SA754 folded on the River
Seat 5: Lucifer999 (button) folded before Flop (didn't bet)
Seat 6: No username (small blind) collected ($338.04)



PokerStars Game #00327517942: Hold'em No Limit ($10/$25 USD) - 2022/04/30 08:36:40 ET
Table 'Hold'em (Min 500Max 2500) 1001' 6-max Seat #3 is the button
Seat 1: kash1102 ($2079.7 in chips) 
Seat 2: RKumarR ($4296.45 in chips) 
Seat 3: BattiGull ($2355 in chips) 
Seat 4: teamwork575 ($2139.09 in chips) 
Seat 5: Lucifer999 ($2500 in chips) 
Seat 6: spidy02 ($2782.97 in chips) 
teamwork575: posts small blind $10
Lucifer999: posts big blind $25
*** HOLE CARDS ***
Dealt to Lucifer999 [9c Kh]
spidy02: folds
kash1102: folds
RKumarR: folds
BattiGull: folds
teamwork575: folds
Uncalled bet ($15) returned to Lucifer999
Lucifer999: doesn't show hand
Lucifer999 collected $20 from pot
*** SUMMARY ***
Total pot $20.00 | Rake $0
Board []
Seat 1: kash1102 folded before Flop (didn't bet)
Seat 2: RKumarR folded before Flop (didn't bet)
Seat 3: BattiGull (button) folded before Flop (didn't bet)
Seat 4: teamwork575 (small blind) folded before Flop
Seat 5: Lucifer999 (big blind) collected ($20)
Seat 6: spidy02 folded before Flop (didn't bet)



PokerStars Game #00327517900: Hold'em No Limit ($50/$100 USD) - 2022/04/30 08:36:28 ET
Table 'Hold'em (Min 25KMax 10K)    69' 6-max Seat #1 is the button
Seat 1: Lucifer999 ($10150 in chips) 
Seat 4: vinuth ($9850 in chips) 
Lucifer999: posts small blind $50
vinuth: posts big blind $100
*** HOLE CARDS ***
Dealt to Lucifer999 [6c 7d]
Lucifer999: calls $50
vinuth: raises $250.00 to $350
Lucifer999: calls $250
*** FLOP *** [2d 9h Ac]
vinuth: bets $336.35
Lucifer999: folds
Uncalled bet ($336.35) returned to vinuth
vinuth: doesn't show hand
vinuth collected $672.7 from pot
*** SUMMARY ***
Total pot $700.00 | Rake $27.3
Board [2d 9h Ac]
Seat 1: Lucifer999 (button) (small blind) folded on the Flop
Seat 4: vinuth (big blind) collected ($672.7)



PokerStars Game #00327517891: Hold'em No Limit ($25/$50 USD) - 2022/04/30 08:36:25 ET
Table 'Hold'em (Min 1K Max 5K)   216' 6-max Seat #1 is the button
Seat 1: Lucifer999 ($5173 in chips) 
Seat 5: Preet991 ($5360.75 in chips) 
Seat 6: Avaroni ($6148.75 in chips) 
Preet991: posts small blind $25
Avaroni: posts big blind $50
*** HOLE CARDS ***
Dealt to Lucifer999 [3c Ts]
Lucifer999: folds
Preet991: raises $100.00 to $150
Avaroni: calls $100
*** FLOP *** [Ac Qh As]
Preet991: checks
Avaroni: checks
*** TURN *** [Ac Qh As] [4s]
Preet991: bets $142.5
Avaroni: folds
Uncalled bet ($142.5) returned to Preet991
Preet991: doesn't show hand
Preet991 collected $285 from pot
*** SUMMARY ***
Total pot $300.00 | Rake $15
Board [Ac Qh As 4s]
Seat 1: Lucifer999 (button) folded before Flop (didn't bet)
Seat 5: Preet991 (small blind) collected ($285)
Seat 6: Avaroni (big blind) folded on the Turn



PokerStars Game #00327517985: Hold'em No Limit ($10/$25 USD) - 2022/04/30 08:36:57 ET
Table 'Hold'em (Min 500Max 2500) 1001' 6-max Seat #4 is the button
Seat 1: kash1102 ($2079.7 in chips) 
Seat 2: RKumarR ($4296.45 in chips) 
Seat 3: BattiGull ($2355 in chips) 
Seat 4: teamwork575 ($2129.09 in chips) 
Seat 5: Lucifer999 ($2510 in chips) 
Seat 6: spidy02 ($2782.97 in chips) 
Lucifer999: posts small blind $10
spidy02: posts big blind $25
*** HOLE CARDS ***
Dealt to Lucifer999 [7c Ac]
kash1102: folds
RKumarR: folds
BattiGull: folds
teamwork575: folds
Lucifer999: raises $55.00 to $80
spidy02: folds
Uncalled bet ($55) returned to Lucifer999
Lucifer999: doesn't show hand
Lucifer999 collected $50 from pot
*** SUMMARY ***
Total pot $50.00 | Rake $0
Board []
Seat 1: kash1102 folded before Flop (didn't bet)
Seat 2: RKumarR folded before Flop (didn't bet)
Seat 3: BattiGull folded before Flop (didn't bet)
Seat 4: teamwork575 (button) folded before Flop (didn't bet)
Seat 5: Lucifer999 (small blind) collected ($50)
Seat 6: spidy02 (big blind) folded before Flop



PokerStars Game #00327518023: Hold'em No Limit ($50/$100 USD) - 2022/04/30 08:37:12 ET
Table 'Hold'em (Min 25KMax 10K)    69' 6-max Seat #4 is the button
Seat 1: Lucifer999 ($10000 in chips) 
Seat 2: P0stman ($10000 in chips) 
Seat 4: vinuth ($10172.7 in chips) 
Lucifer999: posts small blind $50
P0stman: posts big blind $100
*** HOLE CARDS ***
Dealt to Lucifer999 [7h Td]
vinuth: raises $200.00 to $300
Lucifer999: folds
P0stman: folds
Uncalled bet ($200) returned to vinuth
vinuth: doesn't show hand
vinuth collected $250 from pot
*** SUMMARY ***
Total pot $250.00 | Rake $0
Board []
Seat 1: Lucifer999 (small blind) folded before Flop
Seat 2: P0stman (big blind) folded before Flop
Seat 4: vinuth (button) collected ($250)



PokerStars Game #00327517941: Hold'em No Limit ($10/$25 USD) - 2022/04/30 08:36:40 ET
Table 'Hold'em (Min 500Max 2500)  1282' 6-max Seat #6 is the button
Seat 1: PANCHYOU ($828 in chips) 
Seat 2: kash1102 ($2335 in chips) 
Seat 3: manny007 ($2038.38 in chips) 
Seat 4: SA754 ($761.13 in chips) 
Seat 5: Lucifer999 ($2500 in chips) 
Seat 6: No username ($2597.99 in chips) 
PANCHYOU: posts small blind $10
kash1102: posts big blind $25
*** HOLE CARDS ***
Dealt to Lucifer999 [Kc 5c]
manny007: folds
SA754: calls $25
Lucifer999: folds
No username: raises $85.00 to $110
PANCHYOU: folds
kash1102: raises $185.00 to $295
SA754: folds
No username: calls $185
*** FLOP *** [As 6h 9h]
kash1102: bets $318.6
No username: calls $318.6
*** TURN *** [As 6h 9h] [6c]
kash1102: bets $893.21
No username: folds
Uncalled bet ($893.21) returned to kash1102
kash1102: doesn't show hand
kash1102 collected $1190.95 from pot
*** SUMMARY ***
Total pot $1262.20 | Rake $71.25
Board [As 6h 9h 6c]
Seat 1: PANCHYOU (small blind) folded before Flop
Seat 2: kash1102 (big blind) collected ($1190.95)
Seat 3: manny007 folded before Flop (didn't bet)
Seat 4: SA754 folded before Flop
Seat 5: Lucifer999 folded before Flop (didn't bet)
Seat 6: No username (button) folded on the Turn



PokerStars Game #00327518025: Hold'em No Limit ($25/$50 USD) - 2022/04/30 08:37:13 ET
Table 'Hold'em (Min 1K Max 5K)   216' 6-max Seat #5 is the button
Seat 1: Lucifer999 ($5173 in chips) 
Seat 5: Preet991 ($5495.75 in chips) 
Seat 6: Avaroni ($5998.75 in chips) 
Avaroni: posts small blind $25
Lucifer999: posts big blind $50
*** HOLE CARDS ***
Dealt to Lucifer999 [7h Ks]
Preet991: calls $50
Avaroni: folds
Lucifer999: checks
*** FLOP *** [9s 6c 9d]
Lucifer999: checks
Preet991: checks
*** TURN *** [9s 6c 9d] [9c]
Lucifer999: checks
Preet991: checks
*** RIVER *** [9s 6c 9d 9c] [2d]
Lucifer999: checks
Preet991: bets $75
Lucifer999: folds
Uncalled bet ($75) returned to Preet991
Preet991: doesn't show hand
Preet991 collected $118.75 from pot
*** SUMMARY ***
Total pot $125.00 | Rake $6.25
Board [9s 6c 9d 9c 2d]
Seat 1: Lucifer999 (big blind) folded on the River
Seat 5: Preet991 (button) collected ($118.75)
Seat 6: Avaroni (small blind) folded before Flop



PokerStars Game #00327518137: Hold'em No Limit ($10/$25 USD) - 2022/04/30 08:37:51 ET
Table 'Hold'em (Min 500Max 2500)  1282' 6-max Seat #1 is the button
Seat 1: PANCHYOU ($818 in chips) 
Seat 2: kash1102 ($2912.35 in chips) 
Seat 3: manny007 ($2038.38 in chips) 
Seat 4: sCRYOU ($510 in chips) 
Seat 5: Lucifer999 ($2500 in chips) 
Seat 6: No username ($1984.39 in chips) 
kash1102: posts small blind $10
manny007: posts big blind $25
*** HOLE CARDS ***
Dealt to Lucifer999 [9h 3d]
Lucifer999: folds
No username: folds
PANCHYOU: folds
kash1102: folds
Uncalled bet ($15) returned to manny007
manny007: doesn't show hand
manny007 collected $20 from pot
*** SUMMARY ***
Total pot $20.00 | Rake $0
Board []
Seat 1: PANCHYOU (button) folded before Flop (didn't bet)
Seat 2: kash1102 (small blind) folded before Flop
Seat 3: manny007 (big blind) collected ($20)
Seat 5: Lucifer999 folded before Flop (didn't bet)
Seat 6: No username folded before Flop (didn't bet)



PokerStars Game #00327518088: Hold'em No Limit ($10/$25 USD) - 2022/04/30 08:37:37 ET
Table 'Hold'em (Min 500Max 2500) 1001' 6-max Seat #5 is the button
Seat 1: kash1102 ($2079.7 in chips) 
Seat 2: RKumarR ($4296.45 in chips) 
Seat 3: BattiGull ($2355 in chips) 
Seat 4: teamwork575 ($2129.09 in chips) 
Seat 5: Lucifer999 ($2535 in chips) 
Seat 6: spidy02 ($2757.97 in chips) 
spidy02: posts small blind $10
kash1102: posts big blind $25
*** HOLE CARDS ***
Dealt to Lucifer999 [Js 4h]
RKumarR: raises $55.00 to $80
BattiGull: folds
teamwork575: folds
Lucifer999: folds
spidy02: folds
kash1102: folds
Uncalled bet ($55) returned to RKumarR
RKumarR: doesn't show hand
RKumarR collected $60 from pot
*** SUMMARY ***
Total pot $60.00 | Rake $0
Board []
Seat 1: kash1102 (big blind) folded before Flop
Seat 2: RKumarR collected ($60)
Seat 3: BattiGull folded before Flop (didn't bet)
Seat 4: teamwork575 folded before Flop (didn't bet)
Seat 5: Lucifer999 (button) folded before Flop (didn't bet)
Seat 6: spidy02 (small blind) folded before Flop



PokerStars Game #00327518186: Hold'em No Limit ($25/$50 USD) - 2022/04/30 08:38:10 ET
Table 'Hold'em (Min 1K Max 5K)   216' 6-max Seat #6 is the button
Seat 1: Lucifer999 ($5123 in chips) 
Seat 5: Preet991 ($5564.5 in chips) 
Seat 6: Avaroni ($5973.75 in chips) 
Lucifer999: posts small blind $25
Preet991: posts big blind $50
*** HOLE CARDS ***
Dealt to Lucifer999 [8h 4h]
Avaroni: folds
Lucifer999: folds
Uncalled bet ($25) returned to Preet991
Preet991: doesn't show hand
Preet991 collected $50 from pot
*** SUMMARY ***
Total pot $50.00 | Rake $0
Board []
Seat 1: Lucifer999 (small blind) folded before Flop
Seat 5: Preet991 (big blind) collected ($50)
Seat 6: Avaroni (button) folded before Flop (didn't bet)



PokerStars Game #00327518092: Hold'em No Limit ($50/$100 USD) - 2022/04/30 08:37:37 ET
Table 'Hold'em (Min 25KMax 10K)    69' 6-max Seat #1 is the button
Seat 1: Lucifer999 ($10000 in chips) 
Seat 2: P0stman ($10000 in chips) 
Seat 4: vinuth ($10322.7 in chips) 
P0stman: posts small blind $50
vinuth: posts big blind $100
*** HOLE CARDS ***
Dealt to Lucifer999 [8c Kc]
Lucifer999: raises $200.00 to $300
P0stman: folds
vinuth: calls $200
*** FLOP *** [8s 3s 9h]
vinuth: checks
Lucifer999: bets $450
vinuth: calls $450
*** TURN *** [8s 3s 9h] [9c]
vinuth: checks
Lucifer999: checks
*** RIVER *** [8s 3s 9h 9c] [Qh]
vinuth: bets $790.9
Lucifer999: calls $790.9
*** SHOW DOWN ***
vinuth: shows [7h 6s] (Pair, 99)
Lucifer999: shows [8c Kc] (Two pairs, 9988)
Lucifer999 collected $2994.04 from pot
*** SUMMARY ***
Total pot $3131.80 | Rake $137.76
Board [8s 3s 9h 9c Qh]
Seat 1: Lucifer999  (button) showed [8c Kc] and won ($2994.04) with Two pairs, 9988
Seat 2: P0stman (small blind) folded before Flop
Seat 4: vinuth (big blind) showed [7h 6s] and lost with Pair, 99



PokerStars Game #00327518207: Hold'em No Limit ($10/$25 USD) - 2022/04/30 08:38:17 ET
Table 'Hold'em (Min 500Max 2500) 1001' 6-max Seat #6 is the button
Seat 1: kash1102 ($2054.7 in chips) 
Seat 2: RKumarR ($4331.45 in chips) 
Seat 3: BattiGull ($2355 in chips) 
Seat 4: teamwork575 ($2129.09 in chips) 
Seat 5: Lucifer999 ($2535 in chips) 
Seat 6: spidy02 ($2747.97 in chips) 
kash1102: posts small blind $10
RKumarR: posts big blind $25
*** HOLE CARDS ***
Dealt to Lucifer999 [Qs 7h]
BattiGull: folds
teamwork575: folds
Lucifer999: folds
spidy02: folds
kash1102: folds
Uncalled bet ($15) returned to RKumarR
RKumarR: doesn't show hand
RKumarR collected $20 from pot
*** SUMMARY ***
Total pot $20.00 | Rake $0
Board []
Seat 1: kash1102 (small blind) folded before Flop
Seat 2: RKumarR (big blind) collected ($20)
Seat 3: BattiGull folded before Flop (didn't bet)
Seat 4: teamwork575 folded before Flop (didn't bet)
Seat 5: Lucifer999 folded before Flop (didn't bet)
Seat 6: spidy02 (button) folded before Flop (didn't bet)



PokerStars Game #00327518191: Hold'em No Limit ($10/$25 USD) - 2022/04/30 08:38:12 ET
Table 'Hold'em (Min 500Max 2500)  1282' 6-max Seat #2 is the button
Seat 1: PANCHYOU ($818 in chips) 
Seat 2: kash1102 ($2902.35 in chips) 
Seat 3: manny007 ($2048.38 in chips) 
Seat 4: sCRYOU ($510 in chips) 
Seat 5: Lucifer999 ($2500 in chips) 
Seat 6: No username ($1984.39 in chips) 
manny007: posts small blind $10
sCRYOU: posts big blind $25
*** HOLE CARDS ***
Dealt to Lucifer999 [5s 9d]
Lucifer999: folds
No username: folds
PANCHYOU: folds
kash1102: folds
manny007: calls $15
sCRYOU: raises $45.00 to $70
manny007: calls $45
*** FLOP *** [Kh 4s Ks]
manny007: checks
sCRYOU: bets $89.24
manny007: calls $89.24
*** TURN *** [Kh 4s Ks] [7h]
manny007: checks
sCRYOU: checks
*** RIVER *** [Kh 4s Ks 7h] [6d]
manny007: checks
sCRYOU: checks
*** SHOW DOWN ***
sCRYOU: shows [Th Ad] (Pair, KK)
manny007: shows [Ah 4d] (Two pairs, KK44)
manny007 collected $298.79 from pot
*** SUMMARY ***
Total pot $318.48 | Rake $19.69
Board [Kh 4s Ks 7h 6d]
Seat 1: PANCHYOU folded before Flop (didn't bet)
Seat 2: kash1102 (button) folded before Flop (didn't bet)
Seat 3: manny007  (small blind) showed [Ah 4d] and won ($298.79) with Two pairs, KK44
Seat 4: sCRYOU (big blind) showed [Th Ad] and lost with Pair, KK
Seat 5: Lucifer999 folded before Flop (didn't bet)
Seat 6: No username folded before Flop (didn't bet)



PokerStars Game #00327518251: Hold'em No Limit ($25/$50 USD) - 2022/04/30 08:38:31 ET
Table 'Hold'em (Min 1K Max 5K)   216' 6-max Seat #1 is the button
Seat 1: Lucifer999 ($5098 in chips) 
Seat 5: Preet991 ($5589.5 in chips) 
Seat 6: Avaroni ($5973.75 in chips) 
Preet991: posts small blind $25
Avaroni: posts big blind $50
*** HOLE CARDS ***
Dealt to Lucifer999 [4c 4s]
Lucifer999: folds
Preet991: calls $25
Avaroni: raises $125.00 to $175
Preet991: folds
Uncalled bet ($125) returned to Avaroni
Avaroni: doesn't show hand
Avaroni collected $100 from pot
*** SUMMARY ***
Total pot $100.00 | Rake $0
Board []
Seat 1: Lucifer999 (button) folded before Flop (didn't bet)
Seat 5: Preet991 (small blind) folded before Flop
Seat 6: Avaroni (big blind) collected ($100)



PokerStars Game #00327518265: Hold'em No Limit ($50/$100 USD) - 2022/04/30 08:38:37 ET
Table 'Hold'em (Min 25KMax 10K)    69' 6-max Seat #2 is the button
Seat 1: Lucifer999 ($11453.14 in chips) 
Seat 2: P0stman ($10000 in chips) 
Seat 4: vinuth ($8781.8 in chips) 
vinuth: posts small blind $50
Lucifer999: posts big blind $100
*** HOLE CARDS ***
Dealt to Lucifer999 [Kc Th]
P0stman: raises $200.00 to $300
vinuth: raises $600.00 to $900
Lucifer999: folds
P0stman: calls $600
*** FLOP *** [3h 5c Tc]
vinuth: bets $1816.4
P0stman: folds
Uncalled bet ($1816.4) returned to vinuth
vinuth: doesn't show hand
vinuth collected $1816.4 from pot
*** SUMMARY ***
Total pot $1900.00 | Rake $83.6
Board [3h 5c Tc]
Seat 1: Lucifer999 (big blind) folded before Flop
Seat 2: P0stman (button) folded on the Flop
Seat 4: vinuth (small blind) collected ($1816.4)



PokerStars Game #00327518276: Hold'em No Limit ($10/$25 USD) - 2022/04/30 08:38:41 ET
Table 'Hold'em (Min 500Max 2500) 1001' 6-max Seat #1 is the button
Seat 1: kash1102 ($2044.7 in chips) 
Seat 2: RKumarR ($4341.45 in chips) 
Seat 3: BattiGull ($2355 in chips) 
Seat 4: teamwork575 ($2129.09 in chips) 
Seat 5: Lucifer999 ($2535 in chips) 
Seat 6: spidy02 ($2747.97 in chips) 
RKumarR: posts small blind $10
BattiGull: posts big blind $25
*** HOLE CARDS ***
Dealt to Lucifer999 [5d 8h]
teamwork575: folds
Lucifer999: folds
spidy02: folds
kash1102: folds
RKumarR: folds
Uncalled bet ($15) returned to BattiGull
BattiGull: doesn't show hand
BattiGull collected $20 from pot
*** SUMMARY ***
Total pot $20.00 | Rake $0
Board []
Seat 1: kash1102 (button) folded before Flop (didn't bet)
Seat 2: RKumarR (small blind) folded before Flop
Seat 3: BattiGull (big blind) collected ($20)
Seat 4: teamwork575 folded before Flop (didn't bet)
Seat 5: Lucifer999 folded before Flop (didn't bet)
Seat 6: spidy02 folded before Flop (didn't bet)



PokerStars Game #00327518330: Hold'em No Limit ($25/$50 USD) - 2022/04/30 08:39:02 ET
Table 'Hold'em (Min 1K Max 5K)   216' 6-max Seat #5 is the button
Seat 1: Lucifer999 ($5098 in chips) 
Seat 5: Preet991 ($5539.5 in chips) 
Seat 6: Avaroni ($6023.75 in chips) 
Avaroni: posts small blind $25
Lucifer999: posts big blind $50
*** HOLE CARDS ***
Dealt to Lucifer999 [9d Qc]
Preet991: folds
Avaroni: raises $100.00 to $150
Lucifer999: calls $100
*** FLOP *** [Kc Js Ac]
Avaroni: checks
Lucifer999: checks
*** TURN *** [Kc Js Ac] [2c]
Avaroni: checks
Lucifer999: bets $150
Avaroni: calls $150
*** RIVER *** [Kc Js Ac 2c] [3s]
Avaroni: checks
Lucifer999: checks
*** SHOW DOWN ***
Lucifer999: shows [9d Qc] (High card, A)
Avaroni: shows [Ts Kh] (Pair, KK)
Avaroni collected $570 from pot
*** SUMMARY ***
Total pot $600.00 | Rake $30
Board [Kc Js Ac 2c 3s]
Seat 1: Lucifer999 (big blind) showed [9d Qc] and lost with High card, A
Seat 5: Preet991 (button) folded before Flop (didn't bet)
Seat 6: Avaroni  (small blind) showed [Ts Kh] and won ($570) with Pair, KK



PokerStars Game #00327518363: Hold'em No Limit ($50/$100 USD) - 2022/04/30 08:39:17 ET
Table 'Hold'em (Min 25KMax 10K)    69' 6-max Seat #4 is the button
Seat 1: Lucifer999 ($11353.14 in chips) 
Seat 2: P0stman ($10000 in chips) 
Seat 4: vinuth ($9698.2 in chips) 
Lucifer999: posts small blind $50
P0stman: posts big blind $100
*** HOLE CARDS ***
Dealt to Lucifer999 [Ad Jd]
vinuth: folds
Lucifer999: raises $200.00 to $300
P0stman: calls $200
*** FLOP *** [9c Th 6h]
Lucifer999: checks
P0stman: bets $350
Lucifer999: folds
Uncalled bet ($350) returned to P0stman
P0stman: doesn't show hand
P0stman collected $573.6 from pot
*** SUMMARY ***
Total pot $600.00 | Rake $26.4
Board [9c Th 6h]
Seat 1: Lucifer999 (small blind) folded on the Flop
Seat 2: P0stman (big blind) collected ($573.6)
Seat 4: vinuth (button) folded before Flop (didn't bet)



PokerStars Game #00327518367: Hold'em No Limit ($10/$25 USD) - 2022/04/30 08:39:19 ET
Table 'Hold'em (Min 500Max 2500) 1001' 6-max Seat #2 is the button
Seat 1: kash1102 ($2044.7 in chips) 
Seat 2: RKumarR ($4331.45 in chips) 
Seat 3: BattiGull ($2365 in chips) 
Seat 4: teamwork575 ($2129.09 in chips) 
Seat 5: Lucifer999 ($2535 in chips) 
Seat 6: spidy02 ($2747.97 in chips) 
BattiGull: posts small blind $10
teamwork575: posts big blind $25
*** HOLE CARDS ***
Dealt to Lucifer999 [2s 7d]
Lucifer999: folds
kash1102: folds
RKumarR: raises $55.00 to $80
BattiGull: folds
teamwork575: folds
Uncalled bet ($55) returned to RKumarR
RKumarR: doesn't show hand
RKumarR collected $60 from pot
*** SUMMARY ***
Total pot $60.00 | Rake $0
Board []
Seat 1: kash1102 folded before Flop (didn't bet)
Seat 2: RKumarR (button) collected ($60)
Seat 3: BattiGull (small blind) folded before Flop
Seat 4: teamwork575 (big blind) folded before Flop
Seat 5: Lucifer999 folded before Flop (didn't bet)



PokerStars Game #00327518428: Hold'em No Limit ($25/$50 USD) - 2022/04/30 08:39:46 ET
Table 'Hold'em (Min 1K Max 5K)   216' 6-max Seat #1 is the button
Seat 1: Lucifer999 ($5000 in chips) 
Seat 6: Avaroni ($6293.75 in chips) 
Lucifer999: posts small blind $25
Avaroni: posts big blind $50
*** HOLE CARDS ***
Dealt to Lucifer999 [Th 2h]
Lucifer999: raises $50.00 to $100
Avaroni: folds
Uncalled bet ($50) returned to Lucifer999
Lucifer999: doesn't show hand
Lucifer999 collected $100 from pot
*** SUMMARY ***
Total pot $100.00 | Rake $0
Board []
Seat 1: Lucifer999 (button) (small blind) collected ($100)
Seat 6: Avaroni (big blind) folded before Flop



PokerStars Game #00327518319: Hold'em No Limit ($10/$25 USD) - 2022/04/30 08:39:00 ET
Table 'Hold'em (Min 500Max 2500)  1282' 6-max Seat #3 is the button
Seat 1: PANCHYOU ($818 in chips) 
Seat 2: kash1102 ($2902.35 in chips) 
Seat 3: manny007 ($2187.93 in chips) 
Seat 4: sCRYOU ($350.76 in chips) 
Seat 5: Lucifer999 ($2500 in chips) 
Seat 6: No username ($1984.39 in chips) 
sCRYOU: posts small blind $10
Lucifer999: posts big blind $25
*** HOLE CARDS ***
Dealt to Lucifer999 [5c Jc]
No username: raises $60.00 to $85
PANCHYOU: folds
kash1102: folds
manny007: calls $85
sCRYOU: folds
Lucifer999: folds
*** FLOP *** [Qc 7h 3s]
No username: bets $65.02
manny007: calls $65.02
*** TURN *** [Qc 7h 3s] [Jd]
No username: checks
manny007: checks
*** RIVER *** [Qc 7h 3s Jd] [Th]
No username: bets $314.46
manny007: folds
Uncalled bet ($314.46) returned to No username
No username: doesn't show hand
No username collected $314.46 from pot
*** SUMMARY ***
Total pot $335.04 | Rake $20.58
Board [Qc 7h 3s Jd Th]
Seat 1: PANCHYOU folded before Flop (didn't bet)
Seat 2: kash1102 folded before Flop (didn't bet)
Seat 3: manny007 (button) folded on the River
Seat 4: sCRYOU (small blind) folded before Flop
Seat 5: Lucifer999 (big blind) folded before Flop
Seat 6: No username collected ($314.46)



PokerStars Game #00327518438: Hold'em No Limit ($50/$100 USD) - 2022/04/30 08:39:50 ET
Table 'Hold'em (Min 25KMax 10K)    69' 6-max Seat #1 is the button
Seat 1: Lucifer999 ($11053.14 in chips) 
Seat 2: P0stman ($10273.6 in chips) 
Seat 4: vinuth ($9698.2 in chips) 
P0stman: posts small blind $50
vinuth: posts big blind $100
*** HOLE CARDS ***
Dealt to Lucifer999 [4c Tc]
Lucifer999: folds
P0stman: folds
Uncalled bet ($50) returned to vinuth
vinuth: doesn't show hand
vinuth collected $100 from pot
*** SUMMARY ***
Total pot $100.00 | Rake $0
Board []
Seat 1: Lucifer999 (button) folded before Flop (didn't bet)
Seat 2: P0stman (small blind) folded before Flop
Seat 4: vinuth (big blind) collected ($100)



PokerStars Game #00327518465: Hold'em No Limit ($25/$50 USD) - 2022/04/30 08:39:59 ET
Table 'Hold'em (Min 1K Max 5K)   216' 6-max Seat #6 is the button
Seat 1: Lucifer999 ($5050 in chips) 
Seat 6: Avaroni ($6243.75 in chips) 
Avaroni: posts small blind $25
Lucifer999: posts big blind $50
*** HOLE CARDS ***
Dealt to Lucifer999 [9d 6h]
Avaroni: raises $50.00 to $100
Lucifer999: calls $50
*** FLOP *** [Qh 4h 6s]
Lucifer999: checks
Avaroni: bets $150
Lucifer999: calls $150
*** TURN *** [Qh 4h 6s] [7h]
Lucifer999: checks
Avaroni: checks
*** RIVER *** [Qh 4h 6s 7h] [As]
Lucifer999: checks
Avaroni: checks
*** SHOW DOWN ***
Avaroni: shows [Kc 7s] (Pair, 77)
Lucifer999: doesn't show hand
Avaroni collected $477.5 from pot
*** SUMMARY ***
Total pot $500.00 | Rake $22.5
Board [Qh 4h 6s 7h As]
Seat 1: Lucifer999 (big blind) mucked
Seat 6: Avaroni  (button) (small blind) showed [Kc 7s] and won ($477.5) with Pair, 77



PokerStars Game #00327518490: Hold'em No Limit ($10/$25 USD) - 2022/04/30 08:40:10 ET
Table 'Hold'em (Min 500Max 2500)  1282' 6-max Seat #4 is the button
Seat 1: PANCHYOU ($818 in chips) 
Seat 2: kash1102 ($2902.35 in chips) 
Seat 3: manny007 ($2037.91 in chips) 
Seat 4: sCRYOU ($340.76 in chips) 
Seat 5: Lucifer999 ($2500 in chips) 
Seat 6: No username ($2148.83 in chips) 
Lucifer999: posts small blind $10
No username: posts big blind $25
*** HOLE CARDS ***
Dealt to Lucifer999 [6s 5h]
PANCHYOU: raises $55.00 to $80
kash1102: folds
manny007: folds
sCRYOU: folds
Lucifer999: folds
No username: folds
Uncalled bet ($55) returned to PANCHYOU
PANCHYOU: doesn't show hand
PANCHYOU collected $60 from pot
*** SUMMARY ***
Total pot $60.00 | Rake $0
Board []
Seat 1: PANCHYOU collected ($60)
Seat 2: kash1102 folded before Flop (didn't bet)
Seat 3: manny007 folded before Flop (didn't bet)
Seat 4: sCRYOU (button) folded before Flop (didn't bet)
Seat 5: Lucifer999 (small blind) folded before Flop
Seat 6: No username (big blind) folded before Flop



PokerStars Game #00327518498: Hold'em No Limit ($50/$100 USD) - 2022/04/30 08:40:11 ET
Table 'Hold'em (Min 25KMax 10K)    69' 6-max Seat #2 is the button
Seat 1: Lucifer999 ($11053.14 in chips) 
Seat 2: P0stman ($10223.6 in chips) 
Seat 4: vinuth ($9748.2 in chips) 
vinuth: posts small blind $50
Lucifer999: posts big blind $100
*** HOLE CARDS ***
Dealt to Lucifer999 [7d Qh]
P0stman: raises $200.00 to $300
vinuth: raises $600.00 to $900
Lucifer999: folds
P0stman: folds
Uncalled bet ($600) returned to vinuth
vinuth: doesn't show hand
vinuth collected $700 from pot
*** SUMMARY ***
Total pot $700.00 | Rake $0
Board []
Seat 1: Lucifer999 (big blind) folded before Flop
Seat 2: P0stman (button) folded before Flop
Seat 4: vinuth (small blind) collected ($700)



PokerStars Game #00327518459: Hold'em No Limit ($10/$25 USD) - 2022/04/30 08:39:57 ET
Table 'Hold'em (Min 500Max 2500) 1001' 6-max Seat #3 is the button
Seat 1: kash1102 ($2044.7 in chips) 
Seat 2: RKumarR ($4366.45 in chips) 
Seat 3: BattiGull ($2355 in chips) 
Seat 4: teamwork575 ($2104.09 in chips) 
Seat 5: Lucifer999 ($2535 in chips) 
Seat 6: spidy02 ($2747.97 in chips) 
teamwork575: posts small blind $10
Lucifer999: posts big blind $25
*** HOLE CARDS ***
Dealt to Lucifer999 [Td 7s]
spidy02: folds
kash1102: folds
RKumarR: raises $55.00 to $80
BattiGull: folds
teamwork575: calls $70
Lucifer999: folds
*** FLOP *** [4c 5c Ad]
teamwork575: checks
RKumarR: bets $80
teamwork575: raises $220.00 to $300
RKumarR: folds
Uncalled bet ($220) returned to teamwork575
teamwork575: doesn't show hand
teamwork575 collected $323.89 from pot
*** SUMMARY ***
Total pot $345.00 | Rake $21.11
Board [4c 5c Ad]
Seat 1: kash1102 folded before Flop (didn't bet)
Seat 2: RKumarR folded on the Flop
Seat 3: BattiGull (button) folded before Flop (didn't bet)
Seat 4: teamwork575 (small blind) collected ($323.89)
Seat 5: Lucifer999 (big blind) folded before Flop
Seat 6: spidy02 folded before Flop (didn't bet)



PokerStars Game #00327518564: Hold'em No Limit ($25/$50 USD) - 2022/04/30 08:40:39 ET
Table 'Hold'em (Min 1K Max 5K)   216' 6-max Seat #1 is the button
Seat 1: Lucifer999 ($5000 in chips) 
Seat 6: Avaroni ($6471.25 in chips) 
Lucifer999: posts small blind $25
Avaroni: posts big blind $50
*** HOLE CARDS ***
Dealt to Lucifer999 [6h 4s]
Lucifer999: raises $50.00 to $100
Avaroni: raises $250.00 to $350
Lucifer999: folds
Uncalled bet ($250) returned to Avaroni
Avaroni: doesn't show hand
Avaroni collected $200 from pot
*** SUMMARY ***
Total pot $200.00 | Rake $0
Board []
Seat 1: Lucifer999 (button) (small blind) folded before Flop
Seat 6: Avaroni (big blind) collected ($200)



PokerStars Game #00327518581: Hold'em No Limit ($50/$100 USD) - 2022/04/30 08:40:45 ET
Table 'Hold'em (Min 25KMax 10K)    69' 6-max Seat #4 is the button
Seat 1: Lucifer999 ($10953.14 in chips) 
Seat 2: P0stman ($10000 in chips) 
Seat 4: vinuth ($10148.2 in chips) 
Lucifer999: posts small blind $50
P0stman: posts big blind $100
*** HOLE CARDS ***
Dealt to Lucifer999 [5d Qc]
vinuth: folds
Lucifer999: raises $100.00 to $200
P0stman: calls $100
*** FLOP *** [3c Kh 4h]
Lucifer999: bets $300
P0stman: folds
Uncalled bet ($300) returned to Lucifer999
Lucifer999: doesn't show hand
Lucifer999 collected $382.4 from pot
*** SUMMARY ***
Total pot $400.00 | Rake $17.6
Board [3c Kh 4h]
Seat 1: Lucifer999 (small blind) collected ($382.4)
Seat 2: P0stman (big blind) folded on the Flop
Seat 4: vinuth (button) folded before Flop (didn't bet)



PokerStars Game #00327518625: Hold'em No Limit ($25/$50 USD) - 2022/04/30 08:41:02 ET
Table 'Hold'em (Min 1K Max 5K)   216' 6-max Seat #6 is the button
Seat 1: Lucifer999 ($5000 in chips) 
Seat 6: Avaroni ($6571.25 in chips) 
Avaroni: posts small blind $25
Lucifer999: posts big blind $50
*** HOLE CARDS ***
Dealt to Lucifer999 [Kh Jh]
Avaroni: raises $50.00 to $100
Lucifer999: raises $250.00 to $350
Avaroni: folds
Uncalled bet ($250) returned to Lucifer999
Lucifer999: doesn't show hand
Lucifer999 collected $200 from pot
*** SUMMARY ***
Total pot $200.00 | Rake $0
Board []
Seat 1: Lucifer999 (big blind) collected ($200)
Seat 6: Avaroni (button) (small blind) folded before Flop



PokerStars Game #00327518658: Hold'em No Limit ($50/$100 USD) - 2022/04/30 08:41:13 ET
Table 'Hold'em (Min 25KMax 10K)    69' 6-max Seat #1 is the button
Seat 1: Lucifer999 ($11135.54 in chips) 
Seat 2: P0stman ($10000 in chips) 
Seat 4: vinuth ($10148.2 in chips) 
P0stman: posts small blind $50
vinuth: posts big blind $100
*** HOLE CARDS ***
Dealt to Lucifer999 [Qd 2c]
Lucifer999: folds
P0stman: folds
Uncalled bet ($50) returned to vinuth
vinuth: doesn't show hand
vinuth collected $100 from pot
*** SUMMARY ***
Total pot $100.00 | Rake $0
Board []
Seat 1: Lucifer999 (button) folded before Flop (didn't bet)
Seat 2: P0stman (small blind) folded before Flop
Seat 4: vinuth (big blind) collected ($100)



PokerStars Game #00327518565: Hold'em No Limit ($10/$25 USD) - 2022/04/30 08:40:39 ET
Table 'Hold'em (Min 500Max 2500)  1282' 6-max Seat #5 is the button
Seat 1: PANCHYOU ($853 in chips) 
Seat 2: kash1102 ($2902.35 in chips) 
Seat 3: manny007 ($2037.91 in chips) 
Seat 4: sCRYOU ($340.76 in chips) 
Seat 5: Lucifer999 ($2500 in chips) 
Seat 6: No username ($2123.83 in chips) 
No username: posts small blind $10
PANCHYOU: posts big blind $25
*** HOLE CARDS ***
Dealt to Lucifer999 [Ah Tc]
kash1102: folds
manny007: folds
sCRYOU: folds
Lucifer999: folds
No username: calls $15
PANCHYOU: checks
*** FLOP *** [Kh Js 9h]
No username: checks
PANCHYOU: bets $45
No username: folds
Uncalled bet ($45) returned to PANCHYOU
PANCHYOU: doesn't show hand
PANCHYOU collected $47.38 from pot
*** SUMMARY ***
Total pot $50.00 | Rake $2.62
Board [Kh Js 9h]
Seat 1: PANCHYOU (big blind) collected ($47.38)
Seat 2: kash1102 folded before Flop (didn't bet)
Seat 3: manny007 folded before Flop (didn't bet)
Seat 4: sCRYOU folded before Flop (didn't bet)
Seat 5: Lucifer999 (button) folded before Flop (didn't bet)
Seat 6: No username (small blind) folded on the Flop



PokerStars Game #00327518698: Hold'em No Limit ($10/$25 USD) - 2022/04/30 08:41:34 ET
Table 'Hold'em (Min 500Max 2500)  1282' 6-max Seat #6 is the button
Seat 1: PANCHYOU ($875.38 in chips) 
Seat 2: kash1102 ($2902.35 in chips) 
Seat 3: manny007 ($2037.91 in chips) 
Seat 4: sCRYOU ($340.76 in chips) 
Seat 5: Lucifer999 ($2500 in chips) 
Seat 6: No username ($2098.83 in chips) 
PANCHYOU: posts small blind $10
kash1102: posts big blind $25
*** HOLE CARDS ***
Dealt to Lucifer999 [8h 5c]
manny007: folds
sCRYOU: folds
Lucifer999: folds
No username: folds
PANCHYOU: folds
Uncalled bet ($15) returned to kash1102
kash1102: doesn't show hand
kash1102 collected $20 from pot
*** SUMMARY ***
Total pot $20.00 | Rake $0
Board []
Seat 1: PANCHYOU (small blind) folded before Flop
Seat 2: kash1102 (big blind) collected ($20)
Seat 3: manny007 folded before Flop (didn't bet)
Seat 4: sCRYOU folded before Flop (didn't bet)
Seat 5: Lucifer999 folded before Flop (didn't bet)
Seat 6: No username (button) folded before Flop (didn't bet)



PokerStars Game #00327518623: Hold'em No Limit ($10/$25 USD) - 2022/04/30 08:41:00 ET
Table 'Hold'em (Min 500Max 2500) 1001' 6-max Seat #4 is the button
Seat 1: kash1102 ($2044.7 in chips) 
Seat 2: RKumarR ($4206.45 in chips) 
Seat 3: BattiGull ($2355 in chips) 
Seat 4: teamwork575 ($2500 in chips) 
Seat 5: Lucifer999 ($2510 in chips) 
Seat 6: spidy02 ($2747.97 in chips) 
Lucifer999: posts small blind $10
spidy02: posts big blind $25
*** HOLE CARDS ***
Dealt to Lucifer999 [Ad Jd]
kash1102: folds
RKumarR: folds
BattiGull: raises $50.00 to $75
teamwork575: folds
Lucifer999: raises $275.00 to $350
spidy02: folds
BattiGull: calls $275
*** FLOP *** [4s 6s 4d]
Lucifer999: bets $340
BattiGull: calls $340
*** TURN *** [4s 6s 4d] [5h]
Lucifer999: checks
BattiGull: bets $1665
Lucifer999: folds
Uncalled bet ($1665) returned to BattiGull
BattiGull: doesn't show hand
BattiGull collected $1326.24 from pot
*** SUMMARY ***
Total pot $1405.00 | Rake $78.76
Board [4s 6s 4d 5h]
Seat 1: kash1102 folded before Flop (didn't bet)
Seat 2: RKumarR folded before Flop (didn't bet)
Seat 3: BattiGull collected ($1326.24)
Seat 4: teamwork575 (button) folded before Flop (didn't bet)
Seat 5: Lucifer999 (small blind) folded on the Turn
Seat 6: spidy02 (big blind) folded before Flop



PokerStars Game #00327518695: Hold'em No Limit ($50/$100 USD) - 2022/04/30 08:41:31 ET
Table 'Hold'em (Min 25KMax 10K)    69' 6-max Seat #2 is the button
Seat 1: Lucifer999 ($11135.54 in chips) 
Seat 2: P0stman ($10000 in chips) 
Seat 4: vinuth ($10198.2 in chips) 
vinuth: posts small blind $50
Lucifer999: posts big blind $100
*** HOLE CARDS ***
Dealt to Lucifer999 [Kc Tc]
P0stman: folds
vinuth: calls $50
Lucifer999: raises $250.00 to $350
vinuth: calls $250
*** FLOP *** [2c Qc Ad]
vinuth: bets $398.04
Lucifer999: calls $398.04
*** TURN *** [2c Qc Ad] [8h]
vinuth: checks
Lucifer999: bets $900
vinuth: folds
Uncalled bet ($900) returned to Lucifer999
Lucifer999: doesn't show hand
Lucifer999 collected $1430.26 from pot
*** SUMMARY ***
Total pot $1496.08 | Rake $65.82
Board [2c Qc Ad 8h]
Seat 1: Lucifer999 (big blind) collected ($1430.26)
Seat 2: P0stman (button) folded before Flop (didn't bet)
Seat 4: vinuth (small blind) folded on the Turn



PokerStars Game #00327518762: Hold'em No Limit ($10/$25 USD) - 2022/04/30 08:41:57 ET
Table 'Hold'em (Min 500Max 2500)  1282' 6-max Seat #1 is the button
Seat 1: PANCHYOU ($865.38 in chips) 
Seat 2: kash1102 ($2912.35 in chips) 
Seat 3: manny007 ($2037.91 in chips) 
Seat 4: sCRYOU ($340.76 in chips) 
Seat 5: Lucifer999 ($2500 in chips) 
Seat 6: No username ($2098.83 in chips) 
kash1102: posts small blind $10
manny007: posts big blind $25
*** HOLE CARDS ***
Dealt to Lucifer999 [Ac 5h]
sCRYOU: calls $25
Lucifer999: folds
No username: folds
PANCHYOU: folds
kash1102: folds
manny007: raises $60.00 to $85
sCRYOU: calls $60
*** FLOP *** [9d 8d 2d]
manny007: bets $169.55
sCRYOU: raises $86.21 to $255.76
manny007: calls $86.21
*** TURN *** [9d 8d 2d] [Kc]
*** RIVER *** [9d 8d 2d Kc] [8s]
*** SHOW DOWN ***
manny007: shows [Js 9c] (Two pairs, 9988)
sCRYOU: shows [8c Tc] (Three of a kind, 888)
sCRYOU collected $650.25 from pot
*** SUMMARY ***
Total pot $691.52 | Rake $41.27
Board [9d 8d 2d Kc 8s]
Seat 1: PANCHYOU (button) folded before Flop (didn't bet)
Seat 2: kash1102 (small blind) folded before Flop
Seat 3: manny007 (big blind) showed [Js 9c] and lost with Two pairs, 9988
Seat 4: sCRYOU  showed [8c Tc] and won ($650.25) with Three of a kind, 888
Seat 5: Lucifer999 folded before Flop (didn't bet)
Seat 6: No username folded before Flop (didn't bet)



PokerStars Game #00327518781: Hold'em No Limit ($10/$25 USD) - 2022/04/30 08:42:06 ET
Table 'Hold'em (Min 500Max 2500) 1001' 6-max Seat #5 is the button
Seat 1: kash1102 ($2044.7 in chips) 
Seat 2: RKumarR ($4206.45 in chips) 
Seat 3: BattiGull ($5491.24 in chips) 
Seat 4: teamwork575 ($2500 in chips) 
Seat 5: Lucifer999 ($2500 in chips) 
Seat 6: spidy02 ($2722.97 in chips) 
spidy02: posts small blind $10
kash1102: posts big blind $25
*** HOLE CARDS ***
Dealt to Lucifer999 [8h Td]
RKumarR: folds
teamwork575: raises $50.00 to $75
Lucifer999: folds
spidy02: folds
kash1102: folds
Uncalled bet ($50) returned to teamwork575
teamwork575: doesn't show hand
teamwork575 collected $60 from pot
*** SUMMARY ***
Total pot $60.00 | Rake $0
Board []
Seat 1: kash1102 (big blind) folded before Flop
Seat 2: RKumarR folded before Flop (didn't bet)
Seat 4: teamwork575 collected ($60)
Seat 5: Lucifer999 (button) folded before Flop (didn't bet)
Seat 6: spidy02 (small blind) folded before Flop



PokerStars Game #00327518812: Hold'em No Limit ($25/$50 USD) - 2022/04/30 08:42:21 ET
Table 'Hold'em (Min 1K Max 5K)   216' 6-max Seat #1 is the button
Seat 1: Lucifer999 ($5100 in chips) 
Seat 2: rahulh1 ($4900 in chips) 
Lucifer999: posts small blind $25
rahulh1: posts big blind $50
*** HOLE CARDS ***
Dealt to Lucifer999 [6c 2c]
Lucifer999: calls $25
rahulh1: checks
*** FLOP *** [7h 8h 3c]
rahulh1: bets $50
Lucifer999: folds
Uncalled bet ($50) returned to rahulh1
rahulh1: doesn't show hand
rahulh1 collected $95.5 from pot
*** SUMMARY ***
Total pot $100.00 | Rake $4.5
Board [7h 8h 3c]
Seat 1: Lucifer999 (button) (small blind) folded on the Flop
Seat 2: rahulh1 (big blind) collected ($95.5)



PokerStars Game #00327518831: Hold'em No Limit ($50/$100 USD) - 2022/04/30 08:42:28 ET
Table 'Hold'em (Min 25KMax 10K)    69' 6-max Seat #4 is the button
Seat 1: Lucifer999 ($11817.76 in chips) 
Seat 2: P0stman ($10000 in chips) 
Seat 4: vinuth ($9450.16 in chips) 
Seat 6: ksingla ($10000 in chips) 
Lucifer999: posts small blind $50
P0stman: posts big blind $100
*** HOLE CARDS ***
Dealt to Lucifer999 [5d 6h]
vinuth: raises $200.00 to $300
Lucifer999: folds
P0stman: folds
Uncalled bet ($200) returned to vinuth
vinuth: doesn't show hand
vinuth collected $250 from pot
*** SUMMARY ***
Total pot $250.00 | Rake $0
Board []
Seat 1: Lucifer999 (small blind) folded before Flop
Seat 2: P0stman (big blind) folded before Flop
Seat 4: vinuth (button) collected ($250)



PokerStars Game #00327518880: Hold'em No Limit ($25/$50 USD) - 2022/04/30 08:42:46 ET
Table 'Hold'em (Min 1K Max 5K)   216' 6-max Seat #2 is the button
Seat 1: Lucifer999 ($5050 in chips) 
Seat 2: rahulh1 ($4945.5 in chips) 
rahulh1: posts small blind $25
Lucifer999: posts big blind $50
*** HOLE CARDS ***
Dealt to Lucifer999 [Ts 2h]
rahulh1: folds
Uncalled bet ($25) returned to Lucifer999
Lucifer999: doesn't show hand
Lucifer999 collected $50 from pot
*** SUMMARY ***
Total pot $50.00 | Rake $0
Board []
Seat 1: Lucifer999 (big blind) collected ($50)
Seat 2: rahulh1 (button) (small blind) folded before Flop



PokerStars Game #00327518895: Hold'em No Limit ($50/$100 USD) - 2022/04/30 08:42:52 ET
Table 'Hold'em (Min 25KMax 10K)    69' 6-max Seat #1 is the button
Seat 1: Lucifer999 ($11767.76 in chips) 
Seat 2: P0stman ($10000 in chips) 
Seat 4: vinuth ($9600.16 in chips) 
Seat 6: ksingla ($10000 in chips) 
P0stman: posts small blind $50
ksingla: posts big blind $100
*** HOLE CARDS ***
Dealt to Lucifer999 [6h Qh]
Lucifer999: raises $200.00 to $300
P0stman: folds
ksingla: folds
Uncalled bet ($200) returned to Lucifer999
Lucifer999: doesn't show hand
Lucifer999 collected $250 from pot
*** SUMMARY ***
Total pot $250.00 | Rake $0
Board []
Seat 1: Lucifer999 (button) collected ($250)
Seat 2: P0stman (small blind) folded before Flop
Seat 6: ksingla (big blind) folded before Flop



PokerStars Game #00327518874: Hold'em No Limit ($10/$25 USD) - 2022/04/30 08:42:43 ET
Table 'Hold'em (Min 500Max 2500) 1001' 6-max Seat #6 is the button
Seat 1: kash1102 ($2019.7 in chips) 
Seat 2: RKumarR ($4206.45 in chips) 
Seat 3: Avaroni ($2500 in chips) 
Seat 4: teamwork575 ($2535 in chips) 
Seat 5: Lucifer999 ($2500 in chips) 
Seat 6: spidy02 ($2712.97 in chips) 
kash1102: posts small blind $10
RKumarR: posts big blind $25
*** HOLE CARDS ***
Dealt to Lucifer999 [8c 6c]
teamwork575: raises $50.00 to $75
Lucifer999: folds
spidy02: raises $185.00 to $260
kash1102: folds
RKumarR: folds
teamwork575: folds
Uncalled bet ($185) returned to spidy02
spidy02: doesn't show hand
spidy02 collected $185 from pot
*** SUMMARY ***
Total pot $185.00 | Rake $0
Board []
Seat 1: kash1102 (small blind) folded before Flop
Seat 2: RKumarR (big blind) folded before Flop
Seat 4: teamwork575 folded before Flop
Seat 5: Lucifer999 folded before Flop (didn't bet)
Seat 6: spidy02 (button) collected ($185)



PokerStars Game #00327518843: Hold'em No Limit ($10/$25 USD) - 2022/04/30 08:42:32 ET
Table 'Hold'em (Min 500Max 2500)  1282' 6-max Seat #2 is the button
Seat 1: PANCHYOU ($865.38 in chips) 
Seat 2: kash1102 ($2902.35 in chips) 
Seat 3: manny007 ($1697.15 in chips) 
Seat 4: sCRYOU ($650.25 in chips) 
Seat 5: Lucifer999 ($2500 in chips) 
Seat 6: No username ($2098.83 in chips) 
manny007: posts small blind $10
sCRYOU: posts big blind $25
*** HOLE CARDS ***
Dealt to Lucifer999 [As Kh]
Lucifer999: folds
No username: raises $38.75 to $63.75
PANCHYOU: folds
kash1102: folds
manny007: folds
sCRYOU: calls $38.75
*** FLOP *** [5c Th Qc]
sCRYOU: checks
No username: checks
*** TURN *** [5c Th Qc] [7h]
sCRYOU: bets $64.66
No username: calls $64.66
*** RIVER *** [5c Th Qc 7h] [Js]
sCRYOU: bets $123.76
No username: calls $123.76
*** SHOW DOWN ***
sCRYOU: shows [Ts Jc] (Two pairs, JJTT)
No username: doesn't show hand
sCRYOU collected $482.36 from pot
*** SUMMARY ***
Total pot $514.34 | Rake $31.98
Board [5c Th Qc 7h Js]
Seat 1: PANCHYOU folded before Flop (didn't bet)
Seat 2: kash1102 (button) folded before Flop (didn't bet)
Seat 3: manny007 (small blind) folded before Flop
Seat 4: sCRYOU  (big blind) showed [Ts Jc] and won ($482.36) with Two pairs, JJTT
Seat 5: Lucifer999 folded before Flop (didn't bet)
Seat 6: No username mucked



PokerStars Game #00327518902: Hold'em No Limit ($25/$50 USD) - 2022/04/30 08:42:53 ET
Table 'Hold'em (Min 1K Max 5K)   216' 6-max Seat #1 is the button
Seat 1: Lucifer999 ($5075 in chips) 
Seat 2: rahulh1 ($4920.5 in chips) 
Lucifer999: posts small blind $25
rahulh1: posts big blind $50
*** HOLE CARDS ***
Dealt to Lucifer999 [5h Ac]
Lucifer999: calls $25
rahulh1: raises $68.05 to $118.05
Lucifer999: calls $68.05
*** FLOP *** [Qd Td Ad]
rahulh1: bets $83.67
Lucifer999: calls $83.67
*** TURN *** [Qd Td Ad] [9c]
rahulh1: bets $152.37
Lucifer999: calls $152.37
*** RIVER *** [Qd Td Ad 9c] [8d]
rahulh1: checks
Lucifer999: checks
*** SHOW DOWN ***
rahulh1: shows [9s Qh] (Two pairs, QQ99)
Lucifer999: doesn't show hand
rahulh1 collected $676.32 from pot
*** SUMMARY ***
Total pot $708.18 | Rake $31.86
Board [Qd Td Ad 9c 8d]
Seat 1: Lucifer999 (button) (small blind) mucked
Seat 2: rahulh1  (big blind) showed [9s Qh] and won ($676.32) with Two pairs, QQ99



PokerStars Game #00327518979: Hold'em No Limit ($10/$25 USD) - 2022/04/30 08:43:24 ET
Table 'Hold'em (Min 500Max 2500)  1282' 6-max Seat #3 is the button
Seat 1: PANCHYOU ($865.38 in chips) 
Seat 2: kash1102 ($2902.35 in chips) 
Seat 3: manny007 ($1687.15 in chips) 
Seat 4: sCRYOU ($880.44 in chips) 
Seat 5: Lucifer999 ($2500 in chips) 
Seat 6: No username ($1846.66 in chips) 
sCRYOU: posts small blind $10
Lucifer999: posts big blind $25
*** HOLE CARDS ***
Dealt to Lucifer999 [4h Ks]
No username: folds
PANCHYOU: folds
kash1102: folds
manny007: raises $25.00 to $50
sCRYOU: folds
Lucifer999: folds
Uncalled bet ($25) returned to manny007
manny007: doesn't show hand
manny007 collected $60 from pot
*** SUMMARY ***
Total pot $60.00 | Rake $0
Board []
Seat 1: PANCHYOU folded before Flop (didn't bet)
Seat 2: kash1102 folded before Flop (didn't bet)
Seat 3: manny007 (button) collected ($60)
Seat 4: sCRYOU (small blind) folded before Flop
Seat 5: Lucifer999 (big blind) folded before Flop
Seat 6: No username folded before Flop (didn't bet)



PokerStars Game #00327519036: Hold'em No Limit ($25/$50 USD) - 2022/04/30 08:43:44 ET
Table 'Hold'em (Min 1K Max 5K)   216' 6-max Seat #2 is the button
Seat 1: Lucifer999 ($5000 in chips) 
Seat 2: rahulh1 ($5242.73 in chips) 
rahulh1: posts small blind $25
Lucifer999: posts big blind $50
*** HOLE CARDS ***
Dealt to Lucifer999 [As Ac]
rahulh1: folds
Uncalled bet ($25) returned to Lucifer999
Lucifer999: doesn't show hand
Lucifer999 collected $50 from pot
*** SUMMARY ***
Total pot $50.00 | Rake $0
Board []
Seat 1: Lucifer999 (big blind) collected ($50)
Seat 2: rahulh1 (button) (small blind) folded before Flop



PokerStars Game #00327518965: Hold'em No Limit ($50/$100 USD) - 2022/04/30 08:43:17 ET
Table 'Hold'em (Min 25KMax 10K)    69' 6-max Seat #2 is the button
Seat 1: Lucifer999 ($11917.76 in chips) 
Seat 2: P0stman ($10000 in chips) 
Seat 4: vinuth ($9600.16 in chips) 
Seat 6: ksingla ($9900 in chips) 
ksingla: posts small blind $50
Lucifer999: posts big blind $100
*** HOLE CARDS ***
Dealt to Lucifer999 [7c 4c]
P0stman: raises $200.00 to $300
ksingla: folds
Lucifer999: calls $200
*** FLOP *** [9c Th 8c]
Lucifer999: checks
P0stman: checks
*** TURN *** [9c Th 8c] [5d]
Lucifer999: bets $450
P0stman: calls $450
*** RIVER *** [9c Th 8c 5d] [Qs]
Lucifer999: checks
P0stman: checks
*** SHOW DOWN ***
Lucifer999: shows [7c 4c] (High card, Q)
P0stman: shows [6d Td] (Pair, TT)
P0stman collected $1481.8 from pot
*** SUMMARY ***
Total pot $1550.00 | Rake $68.2
Board [9c Th 8c 5d Qs]
Seat 1: Lucifer999 (big blind) showed [7c 4c] and lost with High card, Q
Seat 2: P0stman  (button) showed [6d Td] and won ($1481.8) with Pair, TT
Seat 6: ksingla (small blind) folded before Flop



PokerStars Game #00327518968: Hold'em No Limit ($10/$25 USD) - 2022/04/30 08:43:20 ET
Table 'Hold'em (Min 500Max 2500) 1001' 6-max Seat #1 is the button
Seat 1: kash1102 ($2009.7 in chips) 
Seat 2: RKumarR ($4181.45 in chips) 
Seat 3: Avaroni ($2500 in chips) 
Seat 4: teamwork575 ($2460 in chips) 
Seat 5: Lucifer999 ($2500 in chips) 
Seat 6: spidy02 ($2822.97 in chips) 
RKumarR: posts small blind $10
Avaroni: posts big blind $25
*** HOLE CARDS ***
Dealt to Lucifer999 [6c 2h]
teamwork575: folds
Lucifer999: folds
spidy02: folds
kash1102: folds
RKumarR: raises $55.00 to $80
Avaroni: folds
Uncalled bet ($55) returned to RKumarR
RKumarR: doesn't show hand
RKumarR collected $50 from pot
*** SUMMARY ***
Total pot $50.00 | Rake $0
Board []
Seat 1: kash1102 (button) folded before Flop (didn't bet)
Seat 2: RKumarR (small blind) collected ($50)
Seat 3: Avaroni (big blind) folded before Flop
Seat 4: teamwork575 folded before Flop (didn't bet)
Seat 5: Lucifer999 folded before Flop (didn't bet)
Seat 6: spidy02 folded before Flop (didn't bet)



PokerStars Game #00327519044: Hold'em No Limit ($10/$25 USD) - 2022/04/30 08:43:48 ET
Table 'Hold'em (Min 500Max 2500)  1282' 6-max Seat #4 is the button
Seat 1: PANCHYOU ($865.38 in chips) 
Seat 2: kash1102 ($2902.35 in chips) 
Seat 3: manny007 ($1722.15 in chips) 
Seat 4: sCRYOU ($870.44 in chips) 
Seat 5: Lucifer999 ($2500 in chips) 
Seat 6: No username ($1846.66 in chips) 
Lucifer999: posts small blind $10
No username: posts big blind $25
*** HOLE CARDS ***
Dealt to Lucifer999 [8s 3c]
PANCHYOU: folds
kash1102: folds
manny007: folds
sCRYOU: raises $45.00 to $70
Lucifer999: folds
No username: folds
Uncalled bet ($45) returned to sCRYOU
sCRYOU: doesn't show hand
sCRYOU collected $60 from pot
*** SUMMARY ***
Total pot $60.00 | Rake $0
Board []
Seat 1: PANCHYOU folded before Flop (didn't bet)
Seat 2: kash1102 folded before Flop (didn't bet)
Seat 3: manny007 folded before Flop (didn't bet)
Seat 4: sCRYOU (button) collected ($60)
Seat 5: Lucifer999 (small blind) folded before Flop
Seat 6: No username (big blind) folded before Flop



PokerStars Game #00327519095: Hold'em No Limit ($50/$100 USD) - 2022/04/30 08:44:06 ET
Table 'Hold'em (Min 25KMax 10K)    69' 6-max Seat #6 is the button
Seat 1: Lucifer999 ($11167.76 in chips) 
Seat 2: P0stman ($10731.8 in chips) 
Seat 4: vinuth ($9600.16 in chips) 
Seat 6: ksingla ($9850 in chips) 
Lucifer999: posts small blind $50
P0stman: posts big blind $100
*** HOLE CARDS ***
Dealt to Lucifer999 [Qc 8d]
ksingla: folds
Lucifer999: raises $200.00 to $300
P0stman: folds
Uncalled bet ($200) returned to Lucifer999
Lucifer999: doesn't show hand
Lucifer999 collected $200 from pot
*** SUMMARY ***
Total pot $200.00 | Rake $0
Board []
Seat 1: Lucifer999 (small blind) collected ($200)
Seat 2: P0stman (big blind) folded before Flop
Seat 6: ksingla (button) folded before Flop (didn't bet)



PokerStars Game #00327519108: Hold'em No Limit ($10/$25 USD) - 2022/04/30 08:44:13 ET
Table 'Hold'em (Min 500Max 2500)  1282' 6-max Seat #5 is the button
Seat 1: PANCHYOU ($865.38 in chips) 
Seat 2: kash1102 ($2902.35 in chips) 
Seat 3: manny007 ($1722.15 in chips) 
Seat 4: sCRYOU ($905.44 in chips) 
Seat 5: Lucifer999 ($2500 in chips) 
Seat 6: No username ($1821.66 in chips) 
No username: posts small blind $10
PANCHYOU: posts big blind $25
*** HOLE CARDS ***
Dealt to Lucifer999 [3c 6h]
kash1102: folds
manny007: folds
sCRYOU: folds
Lucifer999: folds
No username: raises $1796.66 to $1821.66
PANCHYOU: folds
Uncalled bet ($1796.66) returned to No username
No username: doesn't show hand
No username collected $50 from pot
*** SUMMARY ***
Total pot $50.00 | Rake $0
Board []
Seat 1: PANCHYOU (big blind) folded before Flop
Seat 2: kash1102 folded before Flop (didn't bet)
Seat 3: manny007 folded before Flop (didn't bet)
Seat 4: sCRYOU folded before Flop (didn't bet)
Seat 5: Lucifer999 (button) folded before Flop (didn't bet)
Seat 6: No username (small blind) collected ($50)



PokerStars Game #00327519149: Hold'em No Limit ($50/$100 USD) - 2022/04/30 08:44:31 ET
Table 'Hold'em (Min 25KMax 10K)    69' 6-max Seat #2 is the button
Seat 1: Lucifer999 ($11267.76 in chips) 
Seat 2: P0stman ($10631.8 in chips) 
Seat 4: vinuth ($9600.16 in chips) 
P0stman: posts small blind $50
Lucifer999: posts big blind $100
*** HOLE CARDS ***
Dealt to Lucifer999 [Kd Ts]
P0stman: raises $100.00 to $200
Lucifer999: raises $500.00 to $700
P0stman: folds
Uncalled bet ($500) returned to Lucifer999
Lucifer999: doesn't show hand
Lucifer999 collected $400 from pot
*** SUMMARY ***
Total pot $400.00 | Rake $0
Board []
Seat 1: Lucifer999 (big blind) collected ($400)
Seat 2: P0stman (button) (small blind) folded before Flop



PokerStars Game #00327519057: Hold'em No Limit ($25/$50 USD) - 2022/04/30 08:43:51 ET
Table 'Hold'em (Min 1K Max 5K)   216' 6-max Seat #1 is the button
Seat 1: Lucifer999 ($5025 in chips) 
Seat 2: rahulh1 ($5217.73 in chips) 
Lucifer999: posts small blind $25
rahulh1: posts big blind $50
*** HOLE CARDS ***
Dealt to Lucifer999 [6d Kd]
Lucifer999: raises $100.00 to $150
rahulh1: calls $100
*** FLOP *** [7s 9c 9d]
rahulh1: checks
Lucifer999: checks
*** TURN *** [7s 9c 9d] [Qs]
rahulh1: checks
Lucifer999: checks
*** RIVER *** [7s 9c 9d Qs] [9h]
rahulh1: checks
Lucifer999: checks
*** SHOW DOWN ***
Lucifer999: shows [6d Kd] (Three of a kind, 999)
rahulh1: doesn't show hand
Lucifer999 collected $286.5 from pot
*** SUMMARY ***
Total pot $300.00 | Rake $13.5
Board [7s 9c 9d Qs 9h]
Seat 1: Lucifer999  (button) (small blind) showed [6d Kd] and won ($286.5) with Three of a kind, 999
Seat 2: rahulh1 (big blind) mucked



PokerStars Game #00327519198: Hold'em No Limit ($50/$100 USD) - 2022/04/30 08:44:52 ET
Table 'Hold'em (Min 25KMax 10K)    69' 6-max Seat #1 is the button
Seat 1: Lucifer999 ($11467.76 in chips) 
Seat 2: P0stman ($10431.8 in chips) 
Seat 4: vinuth ($9600.16 in chips) 
Lucifer999: posts small blind $50
P0stman: posts big blind $100
*** HOLE CARDS ***
Dealt to Lucifer999 [4h 4c]
Lucifer999: raises $100.00 to $200
P0stman: folds
Uncalled bet ($100) returned to Lucifer999
Lucifer999: doesn't show hand
Lucifer999 collected $200 from pot
*** SUMMARY ***
Total pot $200.00 | Rake $0
Board []
Seat 1: Lucifer999 (button) (small blind) collected ($200)
Seat 2: P0stman (big blind) folded before Flop



PokerStars Game #00327519215: Hold'em No Limit ($25/$50 USD) - 2022/04/30 08:44:58 ET
Table 'Hold'em (Min 1K Max 5K)   216' 6-max Seat #2 is the button
Seat 1: Lucifer999 ($5161.5 in chips) 
Seat 2: rahulh1 ($5067.73 in chips) 
rahulh1: posts small blind $25
Lucifer999: posts big blind $50
*** HOLE CARDS ***
Dealt to Lucifer999 [3d Qd]
rahulh1: folds
Uncalled bet ($25) returned to Lucifer999
Lucifer999: doesn't show hand
Lucifer999 collected $50 from pot
*** SUMMARY ***
Total pot $50.00 | Rake $0
Board []
Seat 1: Lucifer999 (big blind) collected ($50)
Seat 2: rahulh1 (button) (small blind) folded before Flop



PokerStars Game #00327519231: Hold'em No Limit ($50/$100 USD) - 2022/04/30 08:45:05 ET
Table 'Hold'em (Min 25KMax 10K)    69' 6-max Seat #2 is the button
Seat 1: Lucifer999 ($11567.76 in chips) 
Seat 2: P0stman ($10331.8 in chips) 
Seat 4: vinuth ($9600.16 in chips) 
P0stman: posts small blind $50
Lucifer999: posts big blind $100
*** HOLE CARDS ***
Dealt to Lucifer999 [5s 8h]
P0stman: raises $100.00 to $200
Lucifer999: folds
Uncalled bet ($100) returned to P0stman
P0stman: doesn't show hand
P0stman collected $200 from pot
*** SUMMARY ***
Total pot $200.00 | Rake $0
Board []
Seat 1: Lucifer999 (big blind) folded before Flop
Seat 2: P0stman (button) (small blind) collected ($200)



PokerStars Game #00327519177: Hold'em No Limit ($10/$25 USD) - 2022/04/30 08:44:43 ET
Table 'Hold'em (Min 500Max 2500)  1282' 6-max Seat #6 is the button
Seat 1: PANCHYOU ($840.38 in chips) 
Seat 2: kash1102 ($2902.35 in chips) 
Seat 3: manny007 ($1722.15 in chips) 
Seat 4: sCRYOU ($905.44 in chips) 
Seat 5: Lucifer999 ($2500 in chips) 
Seat 6: No username ($1846.66 in chips) 
PANCHYOU: posts small blind $10
kash1102: posts big blind $25
*** HOLE CARDS ***
Dealt to Lucifer999 [2h Jc]
manny007: calls $25
sCRYOU: folds
Lucifer999: folds
No username: folds
PANCHYOU: folds
kash1102: checks
*** FLOP *** [6c Td Ad]
kash1102: checks
manny007: checks
*** TURN *** [6c Td Ad] [Js]
kash1102: checks
manny007: checks
*** RIVER *** [6c Td Ad Js] [Ks]
kash1102: checks
manny007: bets $56.85
kash1102: folds
Uncalled bet ($56.85) returned to manny007
manny007: doesn't show hand
manny007 collected $56.85 from pot
*** SUMMARY ***
Total pot $60.00 | Rake $3.15
Board [6c Td Ad Js Ks]
Seat 1: PANCHYOU (small blind) folded before Flop
Seat 2: kash1102 (big blind) folded on the River
Seat 3: manny007 collected ($56.85)
Seat 4: sCRYOU folded before Flop (didn't bet)
Seat 5: Lucifer999 folded before Flop (didn't bet)
Seat 6: No username (button) folded before Flop (didn't bet)



PokerStars Game #00327519234: Hold'em No Limit ($25/$50 USD) - 2022/04/30 08:45:06 ET
Table 'Hold'em (Min 1K Max 5K)   216' 6-max Seat #1 is the button
Seat 1: Lucifer999 ($5186.5 in chips) 
Seat 2: rahulh1 ($5042.73 in chips) 
Lucifer999: posts small blind $25
rahulh1: posts big blind $50
*** HOLE CARDS ***
Dealt to Lucifer999 [8s 5c]
Lucifer999: raises $100.00 to $150
rahulh1: calls $100
*** FLOP *** [Ks 6s 9c]
rahulh1: checks
Lucifer999: bets $150
rahulh1: calls $150
*** TURN *** [Ks 6s 9c] [Qs]
rahulh1: checks
Lucifer999: checks
*** RIVER *** [Ks 6s 9c Qs] [Jh]
rahulh1: checks
Lucifer999: bets $350
rahulh1: folds
Uncalled bet ($350) returned to Lucifer999
Lucifer999: doesn't show hand
Lucifer999 collected $573 from pot
*** SUMMARY ***
Total pot $600.00 | Rake $27
Board [Ks 6s 9c Qs Jh]
Seat 1: Lucifer999 (button) (small blind) collected ($573)
Seat 2: rahulh1 (big blind) folded on the River



PokerStars Game #00327519100: Hold'em No Limit ($10/$25 USD) - 2022/04/30 08:44:09 ET
Table 'Hold'em (Min 500Max 2500) 1001' 6-max Seat #2 is the button
Seat 1: kash1102 ($2009.7 in chips) 
Seat 2: RKumarR ($4206.45 in chips) 
Seat 3: Avaroni ($2500 in chips) 
Seat 4: teamwork575 ($2460 in chips) 
Seat 5: Lucifer999 ($2500 in chips) 
Seat 6: spidy02 ($2822.97 in chips) 
Avaroni: posts small blind $10
teamwork575: posts big blind $25
*** HOLE CARDS ***
Dealt to Lucifer999 [7d 8h]
Lucifer999: folds
spidy02: folds
kash1102: folds
RKumarR: raises $55.00 to $80
Avaroni: folds
teamwork575: calls $55
*** FLOP *** [Ts 8d Kd]
teamwork575: checks
RKumarR: checks
*** TURN *** [Ts 8d Kd] [4d]
teamwork575: checks
RKumarR: bets $140
teamwork575: folds
Uncalled bet ($140) returned to RKumarR
RKumarR: doesn't show hand
RKumarR collected $160.08 from pot
*** SUMMARY ***
Total pot $170.00 | Rake $9.92
Board [Ts 8d Kd 4d]
Seat 1: kash1102 folded before Flop (didn't bet)
Seat 2: RKumarR (button) collected ($160.08)
Seat 3: Avaroni (small blind) folded before Flop
Seat 4: teamwork575 (big blind) folded on the Turn
Seat 5: Lucifer999 folded before Flop (didn't bet)
Seat 6: spidy02 folded before Flop (didn't bet)



PokerStars Game #00327519372: Hold'em No Limit ($25/$50 USD) - 2022/04/30 08:46:00 ET
Table 'Hold'em (Min 1K Max 5K)   216' 6-max Seat #2 is the button
Seat 1: Lucifer999 ($5459.5 in chips) 
Seat 2: rahulh1 ($4742.73 in chips) 
rahulh1: posts small blind $25
Lucifer999: posts big blind $50
*** HOLE CARDS ***
Dealt to Lucifer999 [Kd 3d]
rahulh1: calls $25
Lucifer999: raises $125.00 to $175
rahulh1: folds
Uncalled bet ($125) returned to Lucifer999
Lucifer999: doesn't show hand
Lucifer999 collected $100 from pot
*** SUMMARY ***
Total pot $100.00 | Rake $0
Board []
Seat 1: Lucifer999 (big blind) collected ($100)
Seat 2: rahulh1 (button) (small blind) folded before Flop



PokerStars Game #00327519299: Hold'em No Limit ($10/$25 USD) - 2022/04/30 08:45:33 ET
Table 'Hold'em (Min 500Max 2500)  1282' 6-max Seat #1 is the button
Seat 1: PANCHYOU ($830.38 in chips) 
Seat 2: kash1102 ($2877.35 in chips) 
Seat 3: manny007 ($1754 in chips) 
Seat 4: sCRYOU ($905.44 in chips) 
Seat 5: Lucifer999 ($2500 in chips) 
Seat 6: No username ($1846.66 in chips) 
kash1102: posts small blind $10
manny007: posts big blind $25
*** HOLE CARDS ***
Dealt to Lucifer999 [5d 5c]
sCRYOU: calls $25
Lucifer999: raises $85.00 to $110
No username: folds
PANCHYOU: folds
kash1102: folds
manny007: folds
sCRYOU: calls $85
*** FLOP *** [Js 2c 4c]
sCRYOU: checks
Lucifer999: checks
*** TURN *** [Js 2c 4c] [Qd]
sCRYOU: checks
Lucifer999: checks
*** RIVER *** [Js 2c 4c Qd] [2s]
sCRYOU: checks
Lucifer999: bets $180
sCRYOU: folds
Uncalled bet ($180) returned to Lucifer999
Lucifer999: doesn't show hand
Lucifer999 collected $239.62 from pot
*** SUMMARY ***
Total pot $255.00 | Rake $15.38
Board [Js 2c 4c Qd 2s]
Seat 1: PANCHYOU (button) folded before Flop (didn't bet)
Seat 2: kash1102 (small blind) folded before Flop
Seat 3: manny007 (big blind) folded before Flop
Seat 4: sCRYOU folded on the River
Seat 5: Lucifer999 collected ($239.62)
Seat 6: No username folded before Flop (didn't bet)



PokerStars Game #00327519462: Hold'em No Limit ($10/$25 USD) - 2022/04/30 08:46:40 ET
Table 'Hold'em (Min 500Max 2500)  1282' 6-max Seat #2 is the button
Seat 1: PANCHYOU ($830.38 in chips) 
Seat 2: kash1102 ($2867.35 in chips) 
Seat 3: manny007 ($1729 in chips) 
Seat 4: sCRYOU ($795.44 in chips) 
Seat 5: Lucifer999 ($2629.62 in chips) 
Seat 6: No username ($1846.66 in chips) 
manny007: posts small blind $10
sCRYOU: posts big blind $25
*** HOLE CARDS ***
Dealt to Lucifer999 [4s Ks]
Lucifer999: folds
No username: folds
PANCHYOU: folds
kash1102: raises $50.00 to $75
manny007: folds
sCRYOU: folds
Uncalled bet ($50) returned to kash1102
kash1102: doesn't show hand
kash1102 collected $60 from pot
*** SUMMARY ***
Total pot $60.00 | Rake $0
Board []
Seat 1: PANCHYOU folded before Flop (didn't bet)
Seat 2: kash1102 (button) collected ($60)
Seat 3: manny007 (small blind) folded before Flop
Seat 4: sCRYOU (big blind) folded before Flop
Seat 5: Lucifer999 folded before Flop (didn't bet)
Seat 6: No username folded before Flop (didn't bet)



PokerStars Game #00327519432: Hold'em No Limit ($25/$50 USD) - 2022/04/30 08:46:28 ET
Table 'Hold'em (Min 1K Max 5K)   216' 6-max Seat #1 is the button
Seat 1: Lucifer999 ($5509.5 in chips) 
Seat 2: rahulh1 ($4692.73 in chips) 
Lucifer999: posts small blind $25
rahulh1: posts big blind $50
*** HOLE CARDS ***
Dealt to Lucifer999 [2s Ks]
Lucifer999: calls $25
rahulh1: checks
*** FLOP *** [Kh 8c Js]
rahulh1: bets $50
Lucifer999: calls $50
*** TURN *** [Kh 8c Js] [9d]
rahulh1: bets $50
Lucifer999: calls $50
*** RIVER *** [Kh 8c Js 9d] [4s]
rahulh1: checks
Lucifer999: bets $275
rahulh1: folds
Uncalled bet ($275) returned to Lucifer999
Lucifer999: doesn't show hand
Lucifer999 collected $286.5 from pot
*** SUMMARY ***
Total pot $300.00 | Rake $13.5
Board [Kh 8c Js 9d 4s]
Seat 1: Lucifer999 (button) (small blind) collected ($286.5)
Seat 2: rahulh1 (big blind) folded on the River



PokerStars Game #00327519387: Hold'em No Limit ($10/$25 USD) - 2022/04/30 08:46:09 ET
Table 'Hold'em (Min 500Max 2500) 1001' 6-max Seat #3 is the button
Seat 1: kash1102 ($2009.7 in chips) 
Seat 2: RKumarR ($4286.53 in chips) 
Seat 3: Avaroni ($2500 in chips) 
Seat 4: teamwork575 ($2380 in chips) 
Seat 5: Lucifer999 ($2500 in chips) 
Seat 6: spidy02 ($2822.97 in chips) 
teamwork575: posts small blind $10
Lucifer999: posts big blind $25
*** HOLE CARDS ***
Dealt to Lucifer999 [Jd 9c]
spidy02: folds
kash1102: folds
RKumarR: folds
Avaroni: folds
teamwork575: raises $50.00 to $75
Lucifer999: calls $50
*** FLOP *** [5c 7h Jc]
teamwork575: bets $125
Lucifer999: calls $125
*** TURN *** [5c 7h Jc] [4c]
teamwork575: checks
Lucifer999: checks
*** RIVER *** [5c 7h Jc 4c] [Qs]
teamwork575: bets $275
Lucifer999: calls $275
*** SHOW DOWN ***
teamwork575: shows [Kc 8c] (Flush, K high)
Lucifer999: doesn't show hand
teamwork575 collected $895.13 from pot
*** SUMMARY ***
Total pot $950.00 | Rake $54.87
Board [5c 7h Jc 4c Qs]
Seat 1: kash1102 folded before Flop (didn't bet)
Seat 2: RKumarR folded before Flop (didn't bet)
Seat 3: Avaroni (button) folded before Flop (didn't bet)
Seat 4: teamwork575  (small blind) showed [Kc 8c] and won ($895.13) with Flush, K high
Seat 5: Lucifer999 (big blind) mucked
Seat 6: spidy02 folded before Flop (didn't bet)



PokerStars Game #00327519574: Hold'em No Limit ($25/$50 USD) - 2022/04/30 08:47:25 ET
Table 'Hold'em (Min 1K Max 5K)   216' 6-max Seat #2 is the button
Seat 1: Lucifer999 ($5646 in chips) 
Seat 2: rahulh1 ($4542.73 in chips) 
Seat 6: Pablit0 ($4768.43 in chips) 
rahulh1: posts small blind $25
Lucifer999: posts big blind $50
*** HOLE CARDS ***
Dealt to Lucifer999 [2s 6d]
rahulh1: calls $25
Lucifer999: checks
*** FLOP *** [Ac As 4d]
Lucifer999: bets $50
rahulh1: folds
Uncalled bet ($50) returned to Lucifer999
Lucifer999: doesn't show hand
Lucifer999 collected $95.5 from pot
*** SUMMARY ***
Total pot $100.00 | Rake $4.5
Board [Ac As 4d]
Seat 1: Lucifer999 (big blind) collected ($95.5)
Seat 2: rahulh1 (button) (small blind) folded on the Flop



PokerStars Game #00327519602: Hold'em No Limit ($10/$25 USD) - 2022/04/30 08:47:37 ET
Table 'Hold'em (Min 500Max 2500) 1001' 6-max Seat #4 is the button
Seat 1: kash1102 ($2009.7 in chips) 
Seat 2: RKumarR ($4286.53 in chips) 
Seat 3: Avaroni ($2500 in chips) 
Seat 4: teamwork575 ($2800.13 in chips) 
Seat 5: Lucifer999 ($2500 in chips) 
Seat 6: spidy02 ($2822.97 in chips) 
Lucifer999: posts small blind $10
spidy02: posts big blind $25
*** HOLE CARDS ***
Dealt to Lucifer999 [Td 5s]
kash1102: folds
RKumarR: folds
teamwork575: raises $50.00 to $75
Lucifer999: folds
spidy02: folds
Uncalled bet ($50) returned to teamwork575
teamwork575: doesn't show hand
teamwork575 collected $60 from pot
*** SUMMARY ***
Total pot $60.00 | Rake $0
Board []
Seat 1: kash1102 folded before Flop (didn't bet)
Seat 2: RKumarR folded before Flop (didn't bet)
Seat 4: teamwork575 (button) collected ($60)
Seat 5: Lucifer999 (small blind) folded before Flop
Seat 6: spidy02 (big blind) folded before Flop



PokerStars Game #00327519650: Hold'em No Limit ($25/$50 USD) - 2022/04/30 08:47:55 ET
Table 'Hold'em (Min 1K Max 5K)   216' 6-max Seat #1 is the button
Seat 1: Lucifer999 ($5691.5 in chips) 
Seat 2: rahulh1 ($4492.73 in chips) 
Seat 6: Pablit0 ($4768.43 in chips) 
rahulh1: posts small blind $25
Pablit0: posts big blind $50
*** HOLE CARDS ***
Dealt to Lucifer999 [Ah 6h]
Lucifer999: raises $100.00 to $150
rahulh1: folds
Pablit0: folds
Uncalled bet ($100) returned to Lucifer999
Lucifer999: doesn't show hand
Lucifer999 collected $125 from pot
*** SUMMARY ***
Total pot $125.00 | Rake $0
Board []
Seat 1: Lucifer999 (button) collected ($125)
Seat 2: rahulh1 (small blind) folded before Flop
Seat 6: Pablit0 (big blind) folded before Flop



PokerStars Game #00327519541: Hold'em No Limit ($10/$25 USD) - 2022/04/30 08:47:12 ET
Table 'Hold'em (Min 500Max 2500)  1282' 6-max Seat #3 is the button
Seat 1: PANCHYOU ($830.38 in chips) 
Seat 2: kash1102 ($2902.35 in chips) 
Seat 3: manny007 ($1719 in chips) 
Seat 4: sCRYOU ($770.44 in chips) 
Seat 5: Lucifer999 ($2629.62 in chips) 
Seat 6: No username ($1846.66 in chips) 
sCRYOU: posts small blind $10
Lucifer999: posts big blind $25
*** HOLE CARDS ***
Dealt to Lucifer999 [2d Ad]
No username: folds
PANCHYOU: folds
kash1102: raises $50.00 to $75
manny007: calls $75
sCRYOU: folds
Lucifer999: calls $50
*** FLOP *** [4h Jc 5d]
Lucifer999: checks
kash1102: bets $110.34
manny007: calls $110.34
Lucifer999: calls $110.34
*** TURN *** [4h Jc 5d] [Qc]
Lucifer999: checks
kash1102: bets $531.31
manny007: folds
Lucifer999: folds
Uncalled bet ($531.31) returned to kash1102
kash1102: doesn't show hand
kash1102 collected $531.31 from pot
*** SUMMARY ***
Total pot $566.02 | Rake $34.71
Board [4h Jc 5d Qc]
Seat 1: PANCHYOU folded before Flop (didn't bet)
Seat 2: kash1102 collected ($531.31)
Seat 3: manny007 (button) folded on the Turn
Seat 4: sCRYOU (small blind) folded before Flop
Seat 5: Lucifer999 (big blind) folded on the Turn
Seat 6: No username folded before Flop (didn't bet)



PokerStars Game #00327519682: Hold'em No Limit ($10/$25 USD) - 2022/04/30 08:48:08 ET
Table 'Hold'em (Min 500Max 2500) 1001' 6-max Seat #5 is the button
Seat 1: kash1102 ($2009.7 in chips) 
Seat 2: RKumarR ($4286.53 in chips) 
Seat 4: teamwork575 ($2835.13 in chips) 
Seat 5: Lucifer999 ($2500 in chips) 
Seat 6: spidy02 ($2797.97 in chips) 
spidy02: posts small blind $10
kash1102: posts big blind $25
*** HOLE CARDS ***
Dealt to Lucifer999 [Qc 8s]
RKumarR: raises $55.00 to $80
teamwork575: folds
Lucifer999: folds
spidy02: folds
kash1102: calls $55
*** FLOP *** [3h 3s 9d]
kash1102: checks
RKumarR: bets $80.04
kash1102: folds
Uncalled bet ($80.04) returned to RKumarR
RKumarR: doesn't show hand
RKumarR collected $160.08 from pot
*** SUMMARY ***
Total pot $170.00 | Rake $9.92
Board [3h 3s 9d]
Seat 1: kash1102 (big blind) folded on the Flop
Seat 2: RKumarR collected ($160.08)
Seat 4: teamwork575 folded before Flop (didn't bet)
Seat 5: Lucifer999 (button) folded before Flop (didn't bet)
Seat 6: spidy02 (small blind) folded before Flop



PokerStars Game #00327519764: Hold'em No Limit ($10/$25 USD) - 2022/04/30 08:48:41 ET
Table 'Hold'em (Min 500Max 2500)  1282' 6-max Seat #4 is the button
Seat 1: PANCHYOU ($830.38 in chips) 
Seat 2: kash1102 ($3248.32 in chips) 
Seat 3: manny007 ($1533.66 in chips) 
Seat 4: sCRYOU ($760.44 in chips) 
Seat 5: Lucifer999 ($2500 in chips) 
Seat 6: No username ($1846.66 in chips) 
Lucifer999: posts small blind $10
No username: posts big blind $25
*** HOLE CARDS ***
Dealt to Lucifer999 [9s Tc]
PANCHYOU: folds
kash1102: folds
manny007: folds
sCRYOU: folds
Lucifer999: folds
Uncalled bet ($15) returned to No username
No username: doesn't show hand
No username collected $20 from pot
*** SUMMARY ***
Total pot $20.00 | Rake $0
Board []
Seat 1: PANCHYOU folded before Flop (didn't bet)
Seat 2: kash1102 folded before Flop (didn't bet)
Seat 3: manny007 folded before Flop (didn't bet)
Seat 4: sCRYOU (button) folded before Flop (didn't bet)
Seat 5: Lucifer999 (small blind) folded before Flop
Seat 6: No username (big blind) collected ($20)



PokerStars Game #00327519708: Hold'em No Limit ($25/$50 USD) - 2022/04/30 08:48:18 ET
Table 'Hold'em (Min 1K Max 5K)   216' 6-max Seat #2 is the button
Seat 1: Lucifer999 ($5766.5 in chips) 
Seat 2: rahulh1 ($4467.73 in chips) 
Seat 6: Pablit0 ($4718.43 in chips) 
Pablit0: posts small blind $25
Lucifer999: posts big blind $50
*** HOLE CARDS ***
Dealt to Lucifer999 [Ts 8d]
rahulh1: folds
Pablit0: raises $75.00 to $125
Lucifer999: calls $75
*** FLOP *** [8h Qd 3d]
Pablit0: bets $125
Lucifer999: calls $125
*** TURN *** [8h Qd 3d] [Td]
Pablit0: bets $200
Lucifer999: raises $350.00 to $550
Pablit0: calls $350
*** RIVER *** [8h Qd 3d Td] [Tc]
Pablit0: checks
Lucifer999: bets $1500
Pablit0: folds
Uncalled bet ($1500) returned to Lucifer999
Lucifer999: doesn't show hand
Lucifer999 collected $1520 from pot
*** SUMMARY ***
Total pot $1600.00 | Rake $80
Board [8h Qd 3d Td Tc]
Seat 1: Lucifer999 (big blind) collected ($1520)
Seat 2: rahulh1 (button) folded before Flop (didn't bet)
Seat 6: Pablit0 (small blind) folded on the River



PokerStars Game #00327519815: Hold'em No Limit ($10/$25 USD) - 2022/04/30 08:49:05 ET
Table 'Hold'em (Min 500Max 2500) 1001' 6-max Seat #1 is the button
Seat 1: kash1102 ($1929.7 in chips) 
Seat 2: RKumarR ($4366.61 in chips) 
Seat 4: teamwork575 ($2835.13 in chips) 
Seat 5: Lucifer999 ($2500 in chips) 
Seat 6: spidy02 ($2787.97 in chips) 
RKumarR: posts small blind $10
teamwork575: posts big blind $25
*** HOLE CARDS ***
Dealt to Lucifer999 [2h Kc]
Lucifer999: raises $55.00 to $80
kash1102: folds
RKumarR: folds
teamwork575: folds
Uncalled bet ($55) returned to Lucifer999
Lucifer999: doesn't show hand
Lucifer999 collected $60 from pot
*** SUMMARY ***
Total pot $60.00 | Rake $0
Board []
Seat 1: kash1102 (button) folded before Flop (didn't bet)
Seat 2: RKumarR (small blind) folded before Flop
Seat 4: teamwork575 (big blind) folded before Flop
Seat 5: Lucifer999 collected ($60)



PokerStars Game #00327519851: Hold'em No Limit ($25/$50 USD) - 2022/04/30 08:49:20 ET
Table 'Hold'em (Min 1K Max 5K)   216' 6-max Seat #6 is the button
Seat 1: Lucifer999 ($6486.5 in chips) 
Seat 2: rahulh1 ($4467.73 in chips) 
Seat 6: Pablit0 ($3918.43 in chips) 
Lucifer999: posts small blind $25
rahulh1: posts big blind $50
*** HOLE CARDS ***
Dealt to Lucifer999 [5h 5d]
Pablit0: calls $50
Lucifer999: raises $175.00 to $225
rahulh1: calls $175
Pablit0: calls $175
*** FLOP *** [3d 8d 4h]
Lucifer999: bets $450
rahulh1: folds
Pablit0: folds
Uncalled bet ($450) returned to Lucifer999
Lucifer999: doesn't show hand
Lucifer999 collected $641.25 from pot
*** SUMMARY ***
Total pot $675.00 | Rake $33.75
Board [3d 8d 4h]
Seat 1: Lucifer999 (small blind) collected ($641.25)
Seat 2: rahulh1 (big blind) folded on the Flop
Seat 6: Pablit0 (button) folded on the Flop



PokerStars Game #00327519884: Hold'em No Limit ($10/$25 USD) - 2022/04/30 08:49:37 ET
Table 'Hold'em (Min 500Max 2500) 1001' 6-max Seat #2 is the button
Seat 1: kash1102 ($1929.7 in chips) 
Seat 2: RKumarR ($4356.61 in chips) 
Seat 4: teamwork575 ($2810.13 in chips) 
Seat 5: Lucifer999 ($2535 in chips) 
Seat 6: spidy02 ($2787.97 in chips) 
teamwork575: posts small blind $10
Lucifer999: posts big blind $25
*** HOLE CARDS ***
Dealt to Lucifer999 [4d 3c]
spidy02: folds
kash1102: raises $50.00 to $75
RKumarR: folds
teamwork575: folds
Lucifer999: folds
Uncalled bet ($50) returned to kash1102
kash1102: doesn't show hand
kash1102 collected $60 from pot
*** SUMMARY ***
Total pot $60.00 | Rake $0
Board []
Seat 1: kash1102 collected ($60)
Seat 2: RKumarR (button) folded before Flop (didn't bet)
Seat 4: teamwork575 (small blind) folded before Flop
Seat 5: Lucifer999 (big blind) folded before Flop
Seat 6: spidy02 folded before Flop (didn't bet)



PokerStars Game #00327519825: Hold'em No Limit ($10/$25 USD) - 2022/04/30 08:49:08 ET
Table 'Hold'em (Min 500Max 2500)  1282' 6-max Seat #5 is the button
Seat 1: PANCHYOU ($830.38 in chips) 
Seat 2: kash1102 ($3248.32 in chips) 
Seat 3: manny007 ($1533.66 in chips) 
Seat 4: sCRYOU ($760.44 in chips) 
Seat 5: Lucifer999 ($2500 in chips) 
Seat 6: No username ($1856.66 in chips) 
No username: posts small blind $10
PANCHYOU: posts big blind $25
*** HOLE CARDS ***
Dealt to Lucifer999 [8c Kc]
kash1102: raises $50.00 to $75
manny007: calls $75
sCRYOU: folds
Lucifer999: folds
No username: folds
PANCHYOU: folds
*** FLOP *** [Ks Jh 9c]
kash1102: checks
manny007: checks
*** TURN *** [Ks Jh 9c] [Kh]
kash1102: checks
manny007: checks
*** RIVER *** [Ks Jh 9c Kh] [3s]
kash1102: bets $130.72
manny007: calls $130.72
*** SHOW DOWN ***
kash1102: shows [Ts Td] (Two pairs, KKTT)
manny007: doesn't show hand
kash1102 collected $419.03 from pot
*** SUMMARY ***
Total pot $446.44 | Rake $27.41
Board [Ks Jh 9c Kh 3s]
Seat 1: PANCHYOU (big blind) folded before Flop
Seat 2: kash1102  showed [Ts Td] and won ($419.03) with Two pairs, KKTT
Seat 3: manny007 mucked
Seat 4: sCRYOU folded before Flop (didn't bet)
Seat 5: Lucifer999 (button) folded before Flop (didn't bet)
Seat 6: No username (small blind) folded before Flop



PokerStars Game #00327519911: Hold'em No Limit ($25/$50 USD) - 2022/04/30 08:49:49 ET
Table 'Hold'em (Min 1K Max 5K)   216' 6-max Seat #1 is the button
Seat 1: Lucifer999 ($6902.75 in chips) 
Seat 2: rahulh1 ($4242.73 in chips) 
Seat 6: Pablit0 ($3693.43 in chips) 
rahulh1: posts small blind $25
Pablit0: posts big blind $50
*** HOLE CARDS ***
Dealt to Lucifer999 [4s 5c]
Lucifer999: folds
rahulh1: raises $50.00 to $100
Pablit0: folds
Uncalled bet ($50) returned to rahulh1
rahulh1: doesn't show hand
rahulh1 collected $100 from pot
*** SUMMARY ***
Total pot $100.00 | Rake $0
Board []
Seat 1: Lucifer999 (button) folded before Flop (didn't bet)
Seat 2: rahulh1 (small blind) collected ($100)
Seat 6: Pablit0 (big blind) folded before Flop



PokerStars Game #00327519984: Hold'em No Limit ($25/$50 USD) - 2022/04/30 08:50:20 ET
Table 'Hold'em (Min 1K Max 5K)   216' 6-max Seat #2 is the button
Seat 1: Lucifer999 ($6902.75 in chips) 
Seat 2: rahulh1 ($4292.73 in chips) 
Seat 6: Pablit0 ($3643.43 in chips) 
Pablit0: posts small blind $25
Lucifer999: posts big blind $50
*** HOLE CARDS ***
Dealt to Lucifer999 [Qh Ks]
rahulh1: folds
Pablit0: folds
Uncalled bet ($25) returned to Lucifer999
Lucifer999: doesn't show hand
Lucifer999 collected $50 from pot
*** SUMMARY ***
Total pot $50.00 | Rake $0
Board []
Seat 1: Lucifer999 (big blind) collected ($50)
Seat 2: rahulh1 (button) folded before Flop (didn't bet)
Seat 6: Pablit0 (small blind) folded before Flop



PokerStars Game #00327520004: Hold'em No Limit ($25/$50 USD) - 2022/04/30 08:50:30 ET
Table 'Hold'em (Min 1K Max 5K)   216' 6-max Seat #6 is the button
Seat 1: Lucifer999 ($6927.75 in chips) 
Seat 2: rahulh1 ($4292.73 in chips) 
Seat 6: Pablit0 ($3618.43 in chips) 
Lucifer999: posts small blind $25
rahulh1: posts big blind $50
*** HOLE CARDS ***
Dealt to Lucifer999 [3c 2h]
Pablit0: folds
Lucifer999: folds
Uncalled bet ($25) returned to rahulh1
rahulh1: doesn't show hand
rahulh1 collected $50 from pot
*** SUMMARY ***
Total pot $50.00 | Rake $0
Board []
Seat 1: Lucifer999 (small blind) folded before Flop
Seat 2: rahulh1 (big blind) collected ($50)
Seat 6: Pablit0 (button) folded before Flop (didn't bet)



PokerStars Game #00327519956: Hold'em No Limit ($10/$25 USD) - 2022/04/30 08:50:08 ET
Table 'Hold'em (Min 500Max 2500)  1282' 6-max Seat #6 is the button
Seat 1: PANCHYOU ($805.38 in chips) 
Seat 2: kash1102 ($3461.63 in chips) 
Seat 3: manny007 ($1327.94 in chips) 
Seat 4: sCRYOU ($760.44 in chips) 
Seat 5: Lucifer999 ($2500 in chips) 
Seat 6: No username ($1846.66 in chips) 
PANCHYOU: posts small blind $10
kash1102: posts big blind $25
*** HOLE CARDS ***
Dealt to Lucifer999 [8d Tc]
manny007: folds
sCRYOU: calls $25
Lucifer999: folds
No username: raises $85.00 to $110
PANCHYOU: folds
kash1102: folds
sCRYOU: calls $85
*** FLOP *** [Ks Qh 9d]
sCRYOU: checks
No username: bets $119.81
sCRYOU: raises $119.81 to $239.62
No username: calls $119.81
*** TURN *** [Ks Qh 9d] [Td]
sCRYOU: bets $410.82
No username: calls $410.82
*** RIVER *** [Ks Qh 9d Td] [2h]
*** SHOW DOWN ***
sCRYOU: shows [Kc 9c] (Two pairs, KK99)
No username: shows [7h Jh] (Straight, K-9)
No username collected $1469.25 from pot
*** SUMMARY ***
Total pot $1555.88 | Rake $86.63
Board [Ks Qh 9d Td 2h]
Seat 1: PANCHYOU (small blind) folded before Flop
Seat 2: kash1102 (big blind) folded before Flop
Seat 3: manny007 folded before Flop (didn't bet)
Seat 4: sCRYOU showed [Kc 9c] and lost with Two pairs, KK99
Seat 5: Lucifer999 folded before Flop (didn't bet)
Seat 6: No username  (button) showed [7h Jh] and won ($1469.25) with Straight, K-9



PokerStars Game #00327519953: Hold'em No Limit ($10/$25 USD) - 2022/04/30 08:50:06 ET
Table 'Hold'em (Min 500Max 2500) 1001' 6-max Seat #4 is the button
Seat 1: kash1102 ($1964.7 in chips) 
Seat 2: RKumarR ($4356.61 in chips) 
Seat 4: teamwork575 ($2800.13 in chips) 
Seat 5: Lucifer999 ($2510 in chips) 
Seat 6: spidy02 ($2787.97 in chips) 
Lucifer999: posts small blind $10
spidy02: posts big blind $25
*** HOLE CARDS ***
Dealt to Lucifer999 [5s Td]
kash1102: folds
RKumarR: folds
teamwork575: raises $50.00 to $75
Lucifer999: folds
spidy02: calls $50
*** FLOP *** [2h 3s 8h]
spidy02: checks
teamwork575: checks
*** TURN *** [2h 3s 8h] [Ac]
spidy02: bets $96.91
teamwork575: calls $96.91
*** RIVER *** [2h 3s 8h Ac] [7c]
spidy02: checks
teamwork575: checks
*** SHOW DOWN ***
spidy02: shows [Tc Qc] (High card, A)
teamwork575: shows [9h 8s] (Pair, 88)
teamwork575 collected $332.29 from pot
*** SUMMARY ***
Total pot $353.82 | Rake $21.53
Board [2h 3s 8h Ac 7c]
Seat 1: kash1102 folded before Flop (didn't bet)
Seat 2: RKumarR folded before Flop (didn't bet)
Seat 4: teamwork575  (button) showed [9h 8s] and won ($332.29) with Pair, 88
Seat 5: Lucifer999 (small blind) folded before Flop
Seat 6: spidy02 (big blind) showed [Tc Qc] and lost with High card, A



PokerStars Game #00327520087: Hold'em No Limit ($10/$25 USD) - 2022/04/30 08:51:09 ET
Table 'Hold'em (Min 500Max 2500)  1282' 6-max Seat #1 is the button
Seat 1: PANCHYOU ($795.38 in chips) 
Seat 2: kash1102 ($3436.63 in chips) 
Seat 3: manny007 ($1327.94 in chips) 
Seat 5: Lucifer999 ($2500 in chips) 
Seat 6: No username ($2555.47 in chips) 
kash1102: posts small blind $10
manny007: posts big blind $25
*** HOLE CARDS ***
Dealt to Lucifer999 [6h 7c]
Lucifer999: folds
No username: folds
PANCHYOU: folds
kash1102: folds
Uncalled bet ($15) returned to manny007
manny007: doesn't show hand
manny007 collected $20 from pot
*** SUMMARY ***
Total pot $20.00 | Rake $0
Board []
Seat 1: PANCHYOU (button) folded before Flop (didn't bet)
Seat 2: kash1102 (small blind) folded before Flop
Seat 3: manny007 (big blind) collected ($20)
Seat 5: Lucifer999 folded before Flop (didn't bet)
Seat 6: No username folded before Flop (didn't bet)



PokerStars Game #00327520063: Hold'em No Limit ($50/$100 USD) - 2022/04/30 08:50:58 ET
Table 'Hold'em (Min 25KMax 10K)    69' 6-max Seat #1 is the button
Seat 1: Lucifer999 ($11467.76 in chips) 
Seat 3: P0stman ($10431.8 in chips) 
Seat 4: vinuth ($9600.16 in chips) 
Lucifer999: posts small blind $50
P0stman: posts big blind $100
*** HOLE CARDS ***
Dealt to Lucifer999 [4d 9h]
Lucifer999: raises $100.00 to $200
P0stman: calls $100
*** FLOP *** [Td 6s Kc]
P0stman: checks
Lucifer999: checks
*** TURN *** [Td 6s Kc] [3s]
P0stman: checks
Lucifer999: checks
*** RIVER *** [Td 6s Kc 3s] [Qs]
P0stman: checks
Lucifer999: bets $300
P0stman: calls $300
*** SHOW DOWN ***
Lucifer999: shows [4d 9h] (High card, K)
P0stman: shows [3d Kd] (Two pairs, KK33)
P0stman collected $961 from pot
*** SUMMARY ***
Total pot $1000.00 | Rake $39
Board [Td 6s Kc 3s Qs]
Seat 1: Lucifer999 (button) (small blind) showed [4d 9h] and lost with High card, K
Seat 3: P0stman  (big blind) showed [3d Kd] and won ($961) with Two pairs, KK33



PokerStars Game #00327520076: Hold'em No Limit ($25/$50 USD) - 2022/04/30 08:51:03 ET
Table 'Hold'em (Min 1K Max 5K)   216' 6-max Seat #2 is the button
Seat 1: Lucifer999 ($6902.75 in chips) 
Seat 2: rahulh1 ($4317.73 in chips) 
Seat 6: Pablit0 ($3618.43 in chips) 
rahulh1: posts small blind $25
Lucifer999: posts big blind $50
*** HOLE CARDS ***
Dealt to Lucifer999 [8h Qs]
rahulh1: raises $61.39 to $111.39
Lucifer999: calls $61.39
*** FLOP *** [7c 7s Jh]
Lucifer999: checks
rahulh1: checks
*** TURN *** [7c 7s Jh] [7d]
Lucifer999: checks
rahulh1: bets $77.53
Lucifer999: calls $77.53
*** RIVER *** [7c 7s Jh 7d] [5d]
Lucifer999: checks
rahulh1: checks
*** SHOW DOWN ***
rahulh1: shows [9h As] (Three of a kind, 777)
Lucifer999: doesn't show hand
rahulh1 collected $360.88 from pot
*** SUMMARY ***
Total pot $377.84 | Rake $16.96
Board [7c 7s Jh 7d 5d]
Seat 1: Lucifer999 (big blind) mucked
Seat 2: rahulh1  (button) (small blind) showed [9h As] and won ($360.88) with Three of a kind, 777



PokerStars Game #00327520100: Hold'em No Limit ($10/$25 USD) - 2022/04/30 08:51:15 ET
Table 'Hold'em (Min 500Max 2500) 1001' 6-max Seat #5 is the button
Seat 1: kash1102 ($1964.7 in chips) 
Seat 2: RKumarR ($4356.61 in chips) 
Seat 4: teamwork575 ($2960.51 in chips) 
Seat 5: Lucifer999 ($2500 in chips) 
Seat 6: spidy02 ($2616.06 in chips) 
spidy02: posts small blind $10
kash1102: posts big blind $25
*** HOLE CARDS ***
Dealt to Lucifer999 [9c 2s]
RKumarR: folds
teamwork575: folds
Lucifer999: folds
spidy02: raises $50.00 to $75
kash1102: folds
Uncalled bet ($50) returned to spidy02
spidy02: doesn't show hand
spidy02 collected $50 from pot
*** SUMMARY ***
Total pot $50.00 | Rake $0
Board []
Seat 1: kash1102 (big blind) folded before Flop
Seat 2: RKumarR folded before Flop (didn't bet)
Seat 4: teamwork575 folded before Flop (didn't bet)
Seat 5: Lucifer999 (button) folded before Flop (didn't bet)
Seat 6: spidy02 (small blind) collected ($50)



PokerStars Game #00327520160: Hold'em No Limit ($50/$100 USD) - 2022/04/30 08:51:45 ET
Table 'Hold'em (Min 25KMax 10K)    69' 6-max Seat #3 is the button
Seat 1: Lucifer999 ($10967.76 in chips) 
Seat 3: P0stman ($10892.8 in chips) 
Seat 4: vinuth ($9600.16 in chips) 
P0stman: posts small blind $50
Lucifer999: posts big blind $100
*** HOLE CARDS ***
Dealt to Lucifer999 [6s 3h]
P0stman: raises $100.00 to $200
Lucifer999: folds
Uncalled bet ($100) returned to P0stman
P0stman: doesn't show hand
P0stman collected $200 from pot
*** SUMMARY ***
Total pot $200.00 | Rake $0
Board []
Seat 1: Lucifer999 (big blind) folded before Flop
Seat 3: P0stman (button) (small blind) collected ($200)



PokerStars Game #00327520172: Hold'em No Limit ($25/$50 USD) - 2022/04/30 08:51:48 ET
Table 'Hold'em (Min 1K Max 5K)   216' 6-max Seat #1 is the button
Seat 1: Lucifer999 ($6713.83 in chips) 
Seat 2: rahulh1 ($4489.69 in chips) 
Seat 6: Pablit0 ($3618.43 in chips) 
rahulh1: posts small blind $25
Pablit0: posts big blind $50
*** HOLE CARDS ***
Dealt to Lucifer999 [9c 7s]
Lucifer999: folds
rahulh1: folds
Uncalled bet ($25) returned to Pablit0
Pablit0: doesn't show hand
Pablit0 collected $50 from pot
*** SUMMARY ***
Total pot $50.00 | Rake $0
Board []
Seat 1: Lucifer999 (button) folded before Flop (didn't bet)
Seat 2: rahulh1 (small blind) folded before Flop
Seat 6: Pablit0 (big blind) collected ($50)



PokerStars Game #00327520128: Hold'em No Limit ($10/$25 USD) - 2022/04/30 08:51:29 ET
Table 'Hold'em (Min 500Max 2500)  1282' 6-max Seat #2 is the button
Seat 1: PANCHYOU ($795.38 in chips) 
Seat 2: kash1102 ($3426.63 in chips) 
Seat 3: manny007 ($1337.94 in chips) 
Seat 5: Lucifer999 ($2500 in chips) 
Seat 6: No username ($2555.47 in chips) 
manny007: posts small blind $10
Lucifer999: posts big blind $25
*** HOLE CARDS ***
Dealt to Lucifer999 [Td Jd]
No username: raises $31.67 to $56.67
PANCHYOU: raises $107.09 to $163.76
kash1102: folds
manny007: folds
Lucifer999: folds
No username: calls $107.09
*** FLOP *** [4c 6d 8d]
No username: checks
PANCHYOU: bets $255.39
No username: folds
Uncalled bet ($255.39) returned to PANCHYOU
PANCHYOU: doesn't show hand
PANCHYOU collected $340.52 from pot
*** SUMMARY ***
Total pot $362.52 | Rake $22
Board [4c 6d 8d]
Seat 1: PANCHYOU collected ($340.52)
Seat 2: kash1102 (button) folded before Flop (didn't bet)
Seat 3: manny007 (small blind) folded before Flop
Seat 5: Lucifer999 (big blind) folded before Flop
Seat 6: No username folded on the Flop



PokerStars Game #00327520191: Hold'em No Limit ($50/$100 USD) - 2022/04/30 08:51:56 ET
Table 'Hold'em (Min 25KMax 10K)    69' 6-max Seat #1 is the button
Seat 1: Lucifer999 ($10867.76 in chips) 
Seat 3: P0stman ($10992.8 in chips) 
Seat 4: vinuth ($9600.16 in chips) 
Lucifer999: posts small blind $50
P0stman: posts big blind $100
*** HOLE CARDS ***
Dealt to Lucifer999 [8s 9d]
Lucifer999: raises $100.00 to $200
P0stman: raises $10792.80 to $10992.8
Lucifer999: folds
Uncalled bet ($10792.8) returned to P0stman
P0stman: doesn't show hand
P0stman collected $400 from pot
*** SUMMARY ***
Total pot $400.00 | Rake $0
Board []
Seat 1: Lucifer999 (button) (small blind) folded before Flop
Seat 3: P0stman (big blind) collected ($400)



PokerStars Game #00327520223: Hold'em No Limit ($25/$50 USD) - 2022/04/30 08:52:09 ET
Table 'Hold'em (Min 1K Max 5K)   216' 6-max Seat #2 is the button
Seat 1: Lucifer999 ($6713.83 in chips) 
Seat 2: rahulh1 ($4464.69 in chips) 
Seat 6: Pablit0 ($3643.43 in chips) 
Pablit0: posts small blind $25
Lucifer999: posts big blind $50
*** HOLE CARDS ***
Dealt to Lucifer999 [Kd 7c]
rahulh1: raises $50.00 to $100
Pablit0: folds
Lucifer999: folds
Uncalled bet ($50) returned to rahulh1
rahulh1: doesn't show hand
rahulh1 collected $125 from pot
*** SUMMARY ***
Total pot $125.00 | Rake $0
Board []
Seat 1: Lucifer999 (big blind) folded before Flop
Seat 2: rahulh1 (button) collected ($125)
Seat 6: Pablit0 (small blind) folded before Flop



PokerStars Game #00327520251: Hold'em No Limit ($10/$25 USD) - 2022/04/30 08:52:20 ET
Table 'Hold'em (Min 500Max 2500)  1282' 6-max Seat #3 is the button
Seat 1: PANCHYOU ($972.14 in chips) 
Seat 2: kash1102 ($3426.63 in chips) 
Seat 3: manny007 ($1327.94 in chips) 
Seat 5: Lucifer999 ($2500 in chips) 
Seat 6: No username ($2391.71 in chips) 
Lucifer999: posts small blind $10
No username: posts big blind $25
*** HOLE CARDS ***
Dealt to Lucifer999 [Tc 6d]
PANCHYOU: folds
kash1102: folds
manny007: folds
Lucifer999: folds
Uncalled bet ($15) returned to No username
No username: doesn't show hand
No username collected $20 from pot
*** SUMMARY ***
Total pot $20.00 | Rake $0
Board []
Seat 1: PANCHYOU folded before Flop (didn't bet)
Seat 2: kash1102 folded before Flop (didn't bet)
Seat 3: manny007 (button) folded before Flop (didn't bet)
Seat 5: Lucifer999 (small blind) folded before Flop
Seat 6: No username (big blind) collected ($20)



PokerStars Game #00327520184: Hold'em No Limit ($10/$25 USD) - 2022/04/30 08:51:53 ET
Table 'Hold'em (Min 500Max 2500) 1001' 6-max Seat #6 is the button
Seat 1: kash1102 ($1939.7 in chips) 
Seat 2: RKumarR ($4356.61 in chips) 
Seat 4: teamwork575 ($2960.51 in chips) 
Seat 5: Lucifer999 ($2500 in chips) 
Seat 6: spidy02 ($2641.06 in chips) 
kash1102: posts small blind $10
RKumarR: posts big blind $25
*** HOLE CARDS ***
Dealt to Lucifer999 [Ad Qc]
teamwork575: folds
Lucifer999: raises $55.00 to $80
spidy02: calls $80
kash1102: folds
RKumarR: calls $55
*** FLOP *** [2s 9h Jc]
RKumarR: checks
Lucifer999: bets $170
spidy02: calls $170
RKumarR: folds
*** TURN *** [2s 9h Jc] [6s]
Lucifer999: checks
spidy02: bets $310.63
Lucifer999: folds
Uncalled bet ($310.63) returned to spidy02
spidy02: doesn't show hand
spidy02 collected $554.03 from pot
*** SUMMARY ***
Total pot $590.00 | Rake $35.97
Board [2s 9h Jc 6s]
Seat 1: kash1102 (small blind) folded before Flop
Seat 2: RKumarR (big blind) folded on the Flop
Seat 4: teamwork575 folded before Flop (didn't bet)
Seat 5: Lucifer999 folded on the Turn
Seat 6: spidy02 (button) collected ($554.03)



PokerStars Game #00327520295: Hold'em No Limit ($25/$50 USD) - 2022/04/30 08:52:40 ET
Table 'Hold'em (Min 1K Max 5K)   216' 6-max Seat #6 is the button
Seat 1: Lucifer999 ($6663.83 in chips) 
Seat 2: rahulh1 ($4539.69 in chips) 
Seat 5: Avaroni ($6471.25 in chips) 
Seat 6: Pablit0 ($3618.43 in chips) 
Lucifer999: posts small blind $25
rahulh1: posts big blind $50
*** HOLE CARDS ***
Dealt to Lucifer999 [9s Tc]
Pablit0: raises $100.00 to $150
Lucifer999: folds
rahulh1: folds
Uncalled bet ($100) returned to Pablit0
Pablit0: doesn't show hand
Pablit0 collected $125 from pot
*** SUMMARY ***
Total pot $125.00 | Rake $0
Board []
Seat 1: Lucifer999 (small blind) folded before Flop
Seat 2: rahulh1 (big blind) folded before Flop
Seat 6: Pablit0 (button) collected ($125)



PokerStars Game #00327520261: Hold'em No Limit ($50/$100 USD) - 2022/04/30 08:52:23 ET
Table 'Hold'em (Min 25KMax 10K)    69' 6-max Seat #3 is the button
Seat 1: Lucifer999 ($10667.76 in chips) 
Seat 3: P0stman ($11192.8 in chips) 
Seat 4: vinuth ($9600.16 in chips) 
P0stman: posts small blind $50
Lucifer999: posts big blind $100
*** HOLE CARDS ***
Dealt to Lucifer999 [Qc 6d]
P0stman: raises $100.00 to $200
Lucifer999: calls $100
*** FLOP *** [4d 8c Kc]
Lucifer999: checks
P0stman: checks
*** TURN *** [4d 8c Kc] [Kh]
Lucifer999: checks
P0stman: bets $192.2
Lucifer999: calls $192.2
*** RIVER *** [4d 8c Kc Kh] [As]
Lucifer999: checks
P0stman: checks
*** SHOW DOWN ***
P0stman: shows [9d 3h] (Pair, KK)
Lucifer999: shows [Qc 6d] (Pair, KK)
Lucifer999 collected $753.83 from pot
*** SUMMARY ***
Total pot $784.40 | Rake $30.57
Board [4d 8c Kc Kh As]
Seat 1: Lucifer999  (big blind) showed [Qc 6d] and won ($753.83) with Pair, KK
Seat 3: P0stman (button) (small blind) showed [9d 3h] and lost with Pair, KK



PokerStars Game #00327520353: Hold'em No Limit ($25/$50 USD) - 2022/04/30 08:53:04 ET
Table 'Hold'em (Min 1K Max 5K)   216' 6-max Seat #1 is the button
Seat 1: Lucifer999 ($6638.83 in chips) 
Seat 2: rahulh1 ($4489.69 in chips) 
Seat 5: Avaroni ($6471.25 in chips) 
Seat 6: Pablit0 ($3693.43 in chips) 
rahulh1: posts small blind $25
Avaroni: posts big blind $50
*** HOLE CARDS ***
Dealt to Lucifer999 [5d 4c]
Pablit0: calls $50
Lucifer999: folds
rahulh1: calls $25
Avaroni: raises $2200.00 to $2250
Pablit0: folds
rahulh1: folds
Uncalled bet ($2200) returned to Avaroni
Avaroni: doesn't show hand
Avaroni collected $150 from pot
*** SUMMARY ***
Total pot $150.00 | Rake $0
Board []
Seat 1: Lucifer999 (button) folded before Flop (didn't bet)
Seat 2: rahulh1 (small blind) folded before Flop
Seat 5: Avaroni (big blind) collected ($150)
Seat 6: Pablit0 folded before Flop



PokerStars Game #00327520337: Hold'em No Limit ($10/$25 USD) - 2022/04/30 08:52:58 ET
Table 'Hold'em (Min 500Max 2500) 1001' 6-max Seat #1 is the button
Seat 1: kash1102 ($1929.7 in chips) 
Seat 2: RKumarR ($4276.61 in chips) 
Seat 3: Mukesh_19 ($500 in chips) 
Seat 4: teamwork575 ($2960.51 in chips) 
Seat 5: Lucifer999 ($2500 in chips) 
Seat 6: spidy02 ($2945.09 in chips) 
RKumarR: posts small blind $10
Mukesh_19: posts big blind $25
*** HOLE CARDS ***
Dealt to Lucifer999 [6c 2h]
teamwork575: raises $50.00 to $75
Lucifer999: folds
spidy02: folds
kash1102: folds
RKumarR: folds
Mukesh_19: folds
Uncalled bet ($50) returned to teamwork575
teamwork575: doesn't show hand
teamwork575 collected $60 from pot
*** SUMMARY ***
Total pot $60.00 | Rake $0
Board []
Seat 1: kash1102 (button) folded before Flop (didn't bet)
Seat 2: RKumarR (small blind) folded before Flop
Seat 3: Mukesh_19 (big blind) folded before Flop
Seat 4: teamwork575 collected ($60)
Seat 5: Lucifer999 folded before Flop (didn't bet)
Seat 6: spidy02 folded before Flop (didn't bet)



PokerStars Game #00327520306: Hold'em No Limit ($10/$25 USD) - 2022/04/30 08:52:44 ET
Table 'Hold'em (Min 500Max 2500)  1282' 6-max Seat #5 is the button
Seat 1: PANCHYOU ($972.14 in chips) 
Seat 2: kash1102 ($3426.63 in chips) 
Seat 3: manny007 ($1327.94 in chips) 
Seat 5: Lucifer999 ($2500 in chips) 
Seat 6: No username ($2401.71 in chips) 
No username: posts small blind $10
PANCHYOU: posts big blind $25
*** HOLE CARDS ***
Dealt to Lucifer999 [9d Ah]
kash1102: folds
manny007: raises $60.00 to $85
Lucifer999: folds
No username: calls $75
PANCHYOU: folds
*** FLOP *** [Td 9h Jh]
No username: checks
manny007: checks
*** TURN *** [Td 9h Jh] [6d]
No username: checks
manny007: checks
*** RIVER *** [Td 9h Jh 6d] [3s]
No username: bets $216.33
manny007: calls $216.33
*** SHOW DOWN ***
No username: shows [Qs Kh] (Straight, K-9)
manny007: doesn't show hand
No username collected $589.75 from pot
*** SUMMARY ***
Total pot $627.66 | Rake $37.91
Board [Td 9h Jh 6d 3s]
Seat 1: PANCHYOU (big blind) folded before Flop
Seat 2: kash1102 folded before Flop (didn't bet)
Seat 3: manny007 mucked
Seat 5: Lucifer999 (button) folded before Flop (didn't bet)
Seat 6: No username  (small blind) showed [Qs Kh] and won ($589.75) with Straight, K-9



PokerStars Game #00327520415: Hold'em No Limit ($25/$50 USD) - 2022/04/30 08:53:26 ET
Table 'Hold'em (Min 1K Max 5K)   216' 6-max Seat #2 is the button
Seat 1: Lucifer999 ($6638.83 in chips) 
Seat 2: rahulh1 ($4439.69 in chips) 
Seat 5: Avaroni ($6571.25 in chips) 
Seat 6: Pablit0 ($3643.43 in chips) 
Avaroni: posts small blind $25
Pablit0: posts big blind $50
*** HOLE CARDS ***
Dealt to Lucifer999 [8s Ah]
Lucifer999: raises $100.00 to $150
rahulh1: folds
Avaroni: folds
Pablit0: folds
Uncalled bet ($100) returned to Lucifer999
Lucifer999: doesn't show hand
Lucifer999 collected $125 from pot
*** SUMMARY ***
Total pot $125.00 | Rake $0
Board []
Seat 1: Lucifer999 collected ($125)
Seat 2: rahulh1 (button) folded before Flop (didn't bet)
Seat 5: Avaroni (small blind) folded before Flop
Seat 6: Pablit0 (big blind) folded before Flop



PokerStars Game #00327520424: Hold'em No Limit ($10/$25 USD) - 2022/04/30 08:53:30 ET
Table 'Hold'em (Min 500Max 2500) 1001' 6-max Seat #2 is the button
Seat 1: kash1102 ($1929.7 in chips) 
Seat 2: RKumarR ($4266.61 in chips) 
Seat 3: Mukesh_19 ($475 in chips) 
Seat 4: teamwork575 ($2995.51 in chips) 
Seat 5: Lucifer999 ($2500 in chips) 
Seat 6: spidy02 ($2945.09 in chips) 
Mukesh_19: posts small blind $10
teamwork575: posts big blind $25
*** HOLE CARDS ***
Dealt to Lucifer999 [7d 8d]
Lucifer999: folds
spidy02: raises $35.00 to $60
kash1102: folds
RKumarR: folds
Mukesh_19: folds
teamwork575: folds
Uncalled bet ($35) returned to spidy02
spidy02: doesn't show hand
spidy02 collected $60 from pot
*** SUMMARY ***
Total pot $60.00 | Rake $0
Board []
Seat 1: kash1102 folded before Flop (didn't bet)
Seat 2: RKumarR (button) folded before Flop (didn't bet)
Seat 3: Mukesh_19 (small blind) folded before Flop
Seat 4: teamwork575 (big blind) folded before Flop
Seat 5: Lucifer999 folded before Flop (didn't bet)
Seat 6: spidy02 collected ($60)



PokerStars Game #00327520441: Hold'em No Limit ($10/$25 USD) - 2022/04/30 08:53:36 ET
Table 'Hold'em (Min 500Max 2500)  1282' 6-max Seat #6 is the button
Seat 1: PANCHYOU ($947.14 in chips) 
Seat 2: kash1102 ($3426.63 in chips) 
Seat 3: manny007 ($1026.61 in chips) 
Seat 5: Lucifer999 ($2500 in chips) 
Seat 6: No username ($2690.13 in chips) 
PANCHYOU: posts small blind $10
kash1102: posts big blind $25
*** HOLE CARDS ***
Dealt to Lucifer999 [Qd 7s]
manny007: folds
Lucifer999: folds
No username: folds
PANCHYOU: calls $15
kash1102: checks
*** FLOP *** [5s 6d 2s]
PANCHYOU: checks
kash1102: checks
*** TURN *** [5s 6d 2s] [4s]
PANCHYOU: checks
kash1102: checks
*** RIVER *** [5s 6d 2s 4s] [Qc]
PANCHYOU: checks
kash1102: checks
*** SHOW DOWN ***
PANCHYOU: shows [4c Kc] (Pair, 44)
kash1102: doesn't show hand
PANCHYOU collected $47.38 from pot
*** SUMMARY ***
Total pot $50.00 | Rake $2.62
Board [5s 6d 2s 4s Qc]
Seat 1: PANCHYOU  (small blind) showed [4c Kc] and won ($47.38) with Pair, 44
Seat 2: kash1102 (big blind) mucked
Seat 3: manny007 folded before Flop (didn't bet)
Seat 5: Lucifer999 folded before Flop (didn't bet)
Seat 6: No username (button) folded before Flop (didn't bet)



PokerStars Game #00327520500: Hold'em No Limit ($10/$25 USD) - 2022/04/30 08:54:06 ET
Table 'Hold'em (Min 500Max 2500) 1001' 6-max Seat #3 is the button
Seat 1: kash1102 ($1929.7 in chips) 
Seat 2: RKumarR ($4266.61 in chips) 
Seat 3: Mukesh_19 ($465 in chips) 
Seat 4: teamwork575 ($2970.51 in chips) 
Seat 5: Lucifer999 ($2500 in chips) 
Seat 6: spidy02 ($2980.09 in chips) 
teamwork575: posts small blind $10
Lucifer999: posts big blind $25
*** HOLE CARDS ***
Dealt to Lucifer999 [2d 7c]
spidy02: folds
kash1102: folds
RKumarR: folds
Mukesh_19: raises $60.00 to $85
teamwork575: folds
Lucifer999: folds
Uncalled bet ($60) returned to Mukesh_19
Mukesh_19: doesn't show hand
Mukesh_19 collected $60 from pot
*** SUMMARY ***
Total pot $60.00 | Rake $0
Board []
Seat 1: kash1102 folded before Flop (didn't bet)
Seat 2: RKumarR folded before Flop (didn't bet)
Seat 3: Mukesh_19 (button) collected ($60)
Seat 4: teamwork575 (small blind) folded before Flop
Seat 5: Lucifer999 (big blind) folded before Flop
Seat 6: spidy02 folded before Flop (didn't bet)



PokerStars Game #00327520488: Hold'em No Limit ($25/$50 USD) - 2022/04/30 08:53:57 ET
Table 'Hold'em (Min 1K Max 5K)   216' 6-max Seat #5 is the button
Seat 1: Lucifer999 ($6713.83 in chips) 
Seat 2: rahulh1 ($4439.69 in chips) 
Seat 5: Avaroni ($6546.25 in chips) 
Seat 6: Pablit0 ($3593.43 in chips) 
Pablit0: posts small blind $25
Lucifer999: posts big blind $50
*** HOLE CARDS ***
Dealt to Lucifer999 [8d 3h]
rahulh1: calls $50
Avaroni: folds
Pablit0: calls $25
Lucifer999: checks
*** FLOP *** [4h Ad Qc]
Pablit0: bets $100
Lucifer999: folds
rahulh1: calls $100
*** TURN *** [4h Ad Qc] [5s]
Pablit0: bets $150
rahulh1: calls $150
*** RIVER *** [4h Ad Qc 5s] [8s]
Pablit0: bets $308.75
rahulh1: folds
Uncalled bet ($308.75) returned to Pablit0
Pablit0: doesn't show hand
Pablit0 collected $617.5 from pot
*** SUMMARY ***
Total pot $650.00 | Rake $32.5
Board [4h Ad Qc 5s 8s]
Seat 1: Lucifer999 (big blind) folded on the Flop
Seat 2: rahulh1 folded on the River
Seat 5: Avaroni (button) folded before Flop (didn't bet)
Seat 6: Pablit0 (small blind) collected ($617.5)



PokerStars Game #00327520552: Hold'em No Limit ($10/$25 USD) - 2022/04/30 08:54:28 ET
Table 'Hold'em (Min 500Max 2500)  1282' 6-max Seat #1 is the button
Seat 1: PANCHYOU ($969.52 in chips) 
Seat 2: kash1102 ($3401.63 in chips) 
Seat 3: manny007 ($1026.61 in chips) 
Seat 5: Lucifer999 ($2500 in chips) 
Seat 6: No username ($2690.13 in chips) 
kash1102: posts small blind $10
manny007: posts big blind $25
*** HOLE CARDS ***
Dealt to Lucifer999 [As 9s]
Lucifer999: raises $55.00 to $80
No username: folds
PANCHYOU: folds
kash1102: folds
manny007: folds
Uncalled bet ($55) returned to Lucifer999
Lucifer999: doesn't show hand
Lucifer999 collected $60 from pot
*** SUMMARY ***
Total pot $60.00 | Rake $0
Board []
Seat 1: PANCHYOU (button) folded before Flop (didn't bet)
Seat 2: kash1102 (small blind) folded before Flop
Seat 3: manny007 (big blind) folded before Flop
Seat 5: Lucifer999 collected ($60)
Seat 6: No username folded before Flop (didn't bet)



PokerStars Game #00327520580: Hold'em No Limit ($10/$25 USD) - 2022/04/30 08:54:43 ET
Table 'Hold'em (Min 500Max 2500) 1001' 6-max Seat #4 is the button
Seat 1: kash1102 ($1929.7 in chips) 
Seat 2: RKumarR ($4266.61 in chips) 
Seat 3: Mukesh_19 ($500 in chips) 
Seat 4: teamwork575 ($2960.51 in chips) 
Seat 5: Lucifer999 ($2500 in chips) 
Seat 6: spidy02 ($2980.09 in chips) 
Lucifer999: posts small blind $10
spidy02: posts big blind $25
*** HOLE CARDS ***
Dealt to Lucifer999 [6c 3d]
kash1102: folds
RKumarR: folds
Mukesh_19: folds
teamwork575: raises $50.00 to $75
Lucifer999: folds
spidy02: calls $50
*** FLOP *** [6s 2h Js]
spidy02: checks
teamwork575: bets $125
spidy02: folds
Uncalled bet ($125) returned to teamwork575
teamwork575: doesn't show hand
teamwork575 collected $150.6 from pot
*** SUMMARY ***
Total pot $160.00 | Rake $9.4
Board [6s 2h Js]
Seat 1: kash1102 folded before Flop (didn't bet)
Seat 2: RKumarR folded before Flop (didn't bet)
Seat 3: Mukesh_19 folded before Flop (didn't bet)
Seat 4: teamwork575 (button) collected ($150.6)
Seat 5: Lucifer999 (small blind) folded before Flop
Seat 6: spidy02 (big blind) folded on the Flop



PokerStars Game #00327520600: Hold'em No Limit ($10/$25 USD) - 2022/04/30 08:54:52 ET
Table 'Hold'em (Min 500Max 2500)  1282' 6-max Seat #2 is the button
Seat 1: PANCHYOU ($969.52 in chips) 
Seat 2: kash1102 ($3391.63 in chips) 
Seat 3: manny007 ($1001.61 in chips) 
Seat 5: Lucifer999 ($2535 in chips) 
Seat 6: No username ($2690.13 in chips) 
manny007: posts small blind $10
Lucifer999: posts big blind $25
*** HOLE CARDS ***
Dealt to Lucifer999 [2s 9d]
No username: raises $38.75 to $63.75
PANCHYOU: folds
kash1102: folds
manny007: raises $152.50 to $216.25
Lucifer999: folds
No username: calls $152.5
*** FLOP *** [5c 9c As]
manny007: bets $785.36
No username: calls $785.36
*** TURN *** [5c 9c As] [Jh]
*** RIVER *** [5c 9c As Jh] [5h]
*** SHOW DOWN ***
manny007: shows [Kd Jd] (Two pairs, JJ55)
No username: shows [4c 3c] (Pair, 55)
manny007 collected $1916.75 from pot
*** SUMMARY ***
Total pot $2028.22 | Rake $111.47
Board [5c 9c As Jh 5h]
Seat 1: PANCHYOU folded before Flop (didn't bet)
Seat 2: kash1102 (button) folded before Flop (didn't bet)
Seat 3: manny007  (small blind) showed [Kd Jd] and won ($1916.75) with Two pairs, JJ55
Seat 5: Lucifer999 (big blind) folded before Flop
Seat 6: No username showed [4c 3c] and lost with Pair, 55



PokerStars Game #00327520594: Hold'em No Limit ($25/$50 USD) - 2022/04/30 08:54:50 ET
Table 'Hold'em (Min 1K Max 5K)   216' 6-max Seat #6 is the button
Seat 1: Lucifer999 ($6663.83 in chips) 
Seat 2: rahulh1 ($4139.69 in chips) 
Seat 5: Avaroni ($6546.25 in chips) 
Seat 6: Pablit0 ($3910.93 in chips) 
Lucifer999: posts small blind $25
rahulh1: posts big blind $50
*** HOLE CARDS ***
Dealt to Lucifer999 [4s Kd]
Avaroni: raises $100.00 to $150
Pablit0: calls $150
Lucifer999: folds
rahulh1: folds
*** FLOP *** [5d 6d Td]
Avaroni: checks
Pablit0: checks
*** TURN *** [5d 6d Td] [Kh]
Avaroni: checks
Pablit0: checks
*** RIVER *** [5d 6d Td Kh] [9s]
Avaroni: bets $178.12
Pablit0: raises $292.19 to $470.31
Avaroni: calls $292.19
*** SHOW DOWN ***
Pablit0: shows [As 2s] (High card, A)
Avaroni: shows [Ts Ac] (Pair, TT)
Avaroni collected $1249.87 from pot
*** SUMMARY ***
Total pot $1315.62 | Rake $65.75
Board [5d 6d Td Kh 9s]
Seat 1: Lucifer999 (small blind) folded before Flop
Seat 2: rahulh1 (big blind) folded before Flop
Seat 5: Avaroni  showed [Ts Ac] and won ($1249.87) with Pair, TT
Seat 6: Pablit0 (button) showed [As 2s] and lost with High card, A



PokerStars Game #00327520686: Hold'em No Limit ($10/$25 USD) - 2022/04/30 08:55:39 ET
Table 'Hold'em (Min 500Max 2500)  1282' 6-max Seat #3 is the button
Seat 1: PANCHYOU ($969.52 in chips) 
Seat 2: kash1102 ($3391.63 in chips) 
Seat 3: manny007 ($1916.75 in chips) 
Seat 5: Lucifer999 ($2510 in chips) 
Seat 6: No username ($1688.52 in chips) 
Lucifer999: posts small blind $10
No username: posts big blind $25
*** HOLE CARDS ***
Dealt to Lucifer999 [Js 6s]
PANCHYOU: folds
kash1102: folds
manny007: folds
Lucifer999: folds
Uncalled bet ($15) returned to No username
No username: doesn't show hand
No username collected $20 from pot
*** SUMMARY ***
Total pot $20.00 | Rake $0
Board []
Seat 1: PANCHYOU folded before Flop (didn't bet)
Seat 2: kash1102 folded before Flop (didn't bet)
Seat 3: manny007 (button) folded before Flop (didn't bet)
Seat 5: Lucifer999 (small blind) folded before Flop
Seat 6: No username (big blind) collected ($20)



PokerStars Game #00327520705: Hold'em No Limit ($25/$50 USD) - 2022/04/30 08:55:51 ET
Table 'Hold'em (Min 1K Max 5K)   216' 6-max Seat #1 is the button
Seat 1: Lucifer999 ($6638.83 in chips) 
Seat 2: rahulh1 ($4089.69 in chips) 
Seat 5: Avaroni ($7175.81 in chips) 
Seat 6: Pablit0 ($3290.62 in chips) 
rahulh1: posts small blind $25
Avaroni: posts big blind $50
*** HOLE CARDS ***
Dealt to Lucifer999 [Qd 7c]
Pablit0: folds
Lucifer999: folds
rahulh1: calls $25
Avaroni: raises $100.00 to $150
rahulh1: calls $100
*** FLOP *** [Ah 4d 6d]
rahulh1: checks
Avaroni: bets $142.5
rahulh1: calls $142.5
*** TURN *** [Ah 4d 6d] [4c]
rahulh1: checks
Avaroni: bets $475
rahulh1: calls $475
*** RIVER *** [Ah 4d 6d 4c] [8d]
rahulh1: checks
Avaroni: bets $1458.25
rahulh1: folds
Uncalled bet ($1458.25) returned to Avaroni
Avaroni: doesn't show hand
Avaroni collected $1458.25 from pot
*** SUMMARY ***
Total pot $1535.00 | Rake $76.75
Board [Ah 4d 6d 4c 8d]
Seat 1: Lucifer999 (button) folded before Flop (didn't bet)
Seat 2: rahulh1 (small blind) folded on the River
Seat 5: Avaroni (big blind) collected ($1458.25)
Seat 6: Pablit0 folded before Flop (didn't bet)



PokerStars Game #00327520660: Hold'em No Limit ($10/$25 USD) - 2022/04/30 08:55:26 ET
Table 'Hold'em (Min 500Max 2500) 1001' 6-max Seat #5 is the button
Seat 1: kash1102 ($1929.7 in chips) 
Seat 2: RKumarR ($4266.61 in chips) 
Seat 3: Mukesh_19 ($500 in chips) 
Seat 4: teamwork575 ($3036.11 in chips) 
Seat 5: Lucifer999 ($2500 in chips) 
Seat 6: spidy02 ($2905.09 in chips) 
spidy02: posts small blind $10
kash1102: posts big blind $25
*** HOLE CARDS ***
Dealt to Lucifer999 [Ad Ks]
RKumarR: folds
Mukesh_19: raises $60.00 to $85
teamwork575: raises $165.00 to $250
Lucifer999: raises $400.00 to $650
spidy02: folds
kash1102: folds
Mukesh_19: folds
teamwork575: calls $400
*** FLOP *** [4c Kc 5h]
teamwork575: checks
Lucifer999: bets $500
teamwork575: calls $500
*** TURN *** [4c Kc 5h] [Kd]
teamwork575: checks
Lucifer999: bets $1350
teamwork575: calls $1350
*** RIVER *** [4c Kc 5h Kd] [6h]
*** SHOW DOWN ***
teamwork575: shows [Tc Th] (Two pairs, KKTT)
Lucifer999: shows [Ad Ks] (Three of a kind, KKK)
Lucifer999 collected $4916 from pot
*** SUMMARY ***
Total pot $5120.00 | Rake $204
Board [4c Kc 5h Kd 6h]
Seat 1: kash1102 (big blind) folded before Flop
Seat 2: RKumarR folded before Flop (didn't bet)
Seat 3: Mukesh_19 folded before Flop
Seat 4: teamwork575 showed [Tc Th] and lost with Two pairs, KKTT
Seat 5: Lucifer999  (button) showed [Ad Ks] and won ($4916) with Three of a kind, KKK
Seat 6: spidy02 (small blind) folded before Flop



PokerStars Game #00327520721: Hold'em No Limit ($10/$25 USD) - 2022/04/30 08:56:02 ET
Table 'Hold'em (Min 500Max 2500)  1282' 6-max Seat #5 is the button
Seat 1: PANCHYOU ($969.52 in chips) 
Seat 2: kash1102 ($3391.63 in chips) 
Seat 3: manny007 ($1916.75 in chips) 
Seat 5: Lucifer999 ($2500 in chips) 
Seat 6: No username ($1698.52 in chips) 
No username: posts small blind $10
PANCHYOU: posts big blind $25
*** HOLE CARDS ***
Dealt to Lucifer999 [7c 4s]
kash1102: folds
manny007: calls $25
Lucifer999: folds
No username: folds
PANCHYOU: checks
*** FLOP *** [Ts Qs Qc]
PANCHYOU: checks
manny007: checks
*** TURN *** [Ts Qs Qc] [Tc]
PANCHYOU: bets $25
manny007: calls $25
*** RIVER *** [Ts Qs Qc Tc] [Ad]
PANCHYOU: checks
manny007: bets $51.62
PANCHYOU: folds
Uncalled bet ($51.62) returned to manny007
manny007: doesn't show hand
manny007 collected $103.23 from pot
*** SUMMARY ***
Total pot $110.00 | Rake $6.77
Board [Ts Qs Qc Tc Ad]
Seat 1: PANCHYOU (big blind) folded on the River
Seat 2: kash1102 folded before Flop (didn't bet)
Seat 3: manny007 collected ($103.23)
Seat 5: Lucifer999 (button) folded before Flop (didn't bet)
Seat 6: No username (small blind) folded before Flop



PokerStars Game #00327520796: Hold'em No Limit ($10/$25 USD) - 2022/04/30 08:56:54 ET
Table 'Hold'em (Min 500Max 2500) 1001' 6-max Seat #6 is the button
Seat 1: kash1102 ($1904.7 in chips) 
Seat 2: RKumarR ($4266.61 in chips) 
Seat 3: Mukesh_19 ($415 in chips) 
Seat 4: teamwork575 ($675 in chips) 
Seat 5: Lucifer999 ($4916 in chips) 
Seat 6: spidy02 ($2895.09 in chips) 
kash1102: posts small blind $10
RKumarR: posts big blind $25
*** HOLE CARDS ***
Dealt to Lucifer999 [4d 8s]
Mukesh_19: folds
teamwork575: raises $50.00 to $75
Lucifer999: folds
spidy02: folds
kash1102: folds
RKumarR: folds
Uncalled bet ($50) returned to teamwork575
teamwork575: doesn't show hand
teamwork575 collected $60 from pot
*** SUMMARY ***
Total pot $60.00 | Rake $0
Board []
Seat 1: kash1102 (small blind) folded before Flop
Seat 2: RKumarR (big blind) folded before Flop
Seat 3: Mukesh_19 folded before Flop (didn't bet)
Seat 4: teamwork575 collected ($60)
Seat 5: Lucifer999 folded before Flop (didn't bet)
Seat 6: spidy02 (button) folded before Flop (didn't bet)



PokerStars Game #00327520790: Hold'em No Limit ($25/$50 USD) - 2022/04/30 08:56:51 ET
Table 'Hold'em (Min 1K Max 5K)   216' 6-max Seat #2 is the button
Seat 1: Lucifer999 ($6638.83 in chips) 
Seat 2: rahulh1 ($3322.19 in chips) 
Seat 5: Avaroni ($7866.56 in chips) 
Seat 6: Pablit0 ($3290.62 in chips) 
Avaroni: posts small blind $25
Pablit0: posts big blind $50
*** HOLE CARDS ***
Dealt to Lucifer999 [5c Ad]
Lucifer999: raises $100.00 to $150
rahulh1: folds
Avaroni: folds
Pablit0: calls $100
*** FLOP *** [Kc 2h 2d]
Pablit0: checks
Lucifer999: bets $150
Pablit0: calls $150
*** TURN *** [Kc 2h 2d] [As]
Pablit0: checks
Lucifer999: checks
*** RIVER *** [Kc 2h 2d As] [3s]
Pablit0: bets $321.88
Lucifer999: raises $428.12 to $750
Pablit0: calls $428.12
*** SHOW DOWN ***
Lucifer999: shows [5c Ad] (Two pairs, AA22)
Pablit0: shows [Ah Td] (Two pairs, AA22)
Pablit0 collected $1009.38 from pot
Lucifer999 collected $1009.37 from pot
*** SUMMARY ***
Total pot $2125.00 | Rake $106.25
Board [Kc 2h 2d As 3s]
Seat 1: Lucifer999  showed [5c Ad] and won ($1009.37) with Two pairs, AA22
Seat 2: rahulh1 (button) folded before Flop (didn't bet)
Seat 5: Avaroni (small blind) folded before Flop
Seat 6: Pablit0  (big blind) showed [Ah Td] and won ($1009.38) with Two pairs, AA22



PokerStars Game #00327520848: Hold'em No Limit ($10/$25 USD) - 2022/04/30 08:57:25 ET
Table 'Hold'em (Min 500Max 2500) 1001' 6-max Seat #1 is the button
Seat 1: kash1102 ($1894.7 in chips) 
Seat 2: RKumarR ($4241.61 in chips) 
Seat 3: Mukesh_19 ($415 in chips) 
Seat 4: teamwork575 ($2060 in chips) 
Seat 5: Lucifer999 ($4916 in chips) 
Seat 6: spidy02 ($2895.09 in chips) 
RKumarR: posts small blind $10
Mukesh_19: posts big blind $25
*** HOLE CARDS ***
Dealt to Lucifer999 [9s Th]
teamwork575: folds
Lucifer999: folds
spidy02: raises $60.00 to $85
kash1102: folds
RKumarR: folds
Mukesh_19: folds
Uncalled bet ($60) returned to spidy02
spidy02: doesn't show hand
spidy02 collected $60 from pot
*** SUMMARY ***
Total pot $60.00 | Rake $0
Board []
Seat 1: kash1102 (button) folded before Flop (didn't bet)
Seat 2: RKumarR (small blind) folded before Flop
Seat 3: Mukesh_19 (big blind) folded before Flop
Seat 4: teamwork575 folded before Flop (didn't bet)
Seat 5: Lucifer999 folded before Flop (didn't bet)
Seat 6: spidy02 collected ($60)



PokerStars Game #00327520803: Hold'em No Limit ($10/$25 USD) - 2022/04/30 08:56:57 ET
Table 'Hold'em (Min 500Max 2500)  1282' 6-max Seat #6 is the button
Seat 1: PANCHYOU ($919.52 in chips) 
Seat 2: kash1102 ($3391.63 in chips) 
Seat 3: manny007 ($1969.98 in chips) 
Seat 5: Lucifer999 ($2500 in chips) 
Seat 6: No username ($1688.52 in chips) 
PANCHYOU: posts small blind $10
kash1102: posts big blind $25
*** HOLE CARDS ***
Dealt to Lucifer999 [5s Td]
manny007: raises $25.00 to $50
Lucifer999: folds
No username: folds
PANCHYOU: calls $40
kash1102: folds
*** FLOP *** [4s 7c 4h]
PANCHYOU: checks
manny007: checks
*** TURN *** [4s 7c 4h] [6h]
PANCHYOU: bets $75
manny007: folds
Uncalled bet ($75) returned to PANCHYOU
PANCHYOU: doesn't show hand
PANCHYOU collected $117.44 from pot
*** SUMMARY ***
Total pot $125.00 | Rake $7.56
Board [4s 7c 4h 6h]
Seat 1: PANCHYOU (small blind) collected ($117.44)
Seat 2: kash1102 (big blind) folded before Flop
Seat 3: manny007 folded on the Turn
Seat 5: Lucifer999 folded before Flop (didn't bet)
Seat 6: No username (button) folded before Flop (didn't bet)



PokerStars Game #00327520881: Hold'em No Limit ($25/$50 USD) - 2022/04/30 08:57:45 ET
Table 'Hold'em (Min 1K Max 5K)   216' 6-max Seat #5 is the button
Seat 1: Lucifer999 ($6598.2 in chips) 
Seat 2: rahulh1 ($3322.19 in chips) 
Seat 5: Avaroni ($7841.56 in chips) 
Seat 6: Pablit0 ($3250 in chips) 
Pablit0: posts small blind $25
Lucifer999: posts big blind $50
*** HOLE CARDS ***
Dealt to Lucifer999 [7d 2h]
rahulh1: folds
Avaroni: folds
Pablit0: calls $25
Lucifer999: raises $125.00 to $175
Pablit0: folds
Uncalled bet ($125) returned to Lucifer999
Lucifer999: doesn't show hand
Lucifer999 collected $100 from pot
*** SUMMARY ***
Total pot $100.00 | Rake $0
Board []
Seat 1: Lucifer999 (big blind) collected ($100)
Seat 2: rahulh1 folded before Flop (didn't bet)
Seat 5: Avaroni (button) folded before Flop (didn't bet)
Seat 6: Pablit0 (small blind) folded before Flop



PokerStars Game #00327520930: Hold'em No Limit ($10/$25 USD) - 2022/04/30 08:58:14 ET
Table 'Hold'em (Min 500Max 2500)  1282' 6-max Seat #1 is the button
Seat 1: PANCHYOU ($986.96 in chips) 
Seat 2: kash1102 ($3366.63 in chips) 
Seat 3: manny007 ($1919.98 in chips) 
Seat 5: Lucifer999 ($2500 in chips) 
Seat 6: No username ($1688.52 in chips) 
kash1102: posts small blind $10
manny007: posts big blind $25
*** HOLE CARDS ***
Dealt to Lucifer999 [5c 8s]
Lucifer999: folds
No username: folds
PANCHYOU: folds
kash1102: folds
Uncalled bet ($15) returned to manny007
manny007: doesn't show hand
manny007 collected $20 from pot
*** SUMMARY ***
Total pot $20.00 | Rake $0
Board []
Seat 1: PANCHYOU (button) folded before Flop (didn't bet)
Seat 2: kash1102 (small blind) folded before Flop
Seat 3: manny007 (big blind) collected ($20)
Seat 5: Lucifer999 folded before Flop (didn't bet)
Seat 6: No username folded before Flop (didn't bet)



PokerStars Game #00327520944: Hold'em No Limit ($25/$50 USD) - 2022/04/30 08:58:21 ET
Table 'Hold'em (Min 1K Max 5K)   216' 6-max Seat #6 is the button
Seat 1: Lucifer999 ($6648.2 in chips) 
Seat 2: rahulh1 ($3322.19 in chips) 
Seat 3: kash1102 ($5000 in chips) 
Seat 5: Avaroni ($7841.56 in chips) 
Seat 6: Pablit0 ($3200 in chips) 
Lucifer999: posts small blind $25
rahulh1: posts big blind $50
*** HOLE CARDS ***
Dealt to Lucifer999 [As 8d]
Avaroni: folds
Pablit0: folds
Lucifer999: raises $100.00 to $150
rahulh1: folds
Uncalled bet ($100) returned to Lucifer999
Lucifer999: doesn't show hand
Lucifer999 collected $100 from pot
*** SUMMARY ***
Total pot $100.00 | Rake $0
Board []
Seat 1: Lucifer999 (small blind) collected ($100)
Seat 2: rahulh1 (big blind) folded before Flop
Seat 5: Avaroni folded before Flop (didn't bet)
Seat 6: Pablit0 (button) folded before Flop (didn't bet)



PokerStars Game #00327520897: Hold'em No Limit ($10/$25 USD) - 2022/04/30 08:57:57 ET
Table 'Hold'em (Min 500Max 2500) 1001' 6-max Seat #2 is the button
Seat 2: RKumarR ($4231.61 in chips) 
Seat 3: Mukesh_19 ($390 in chips) 
Seat 4: teamwork575 ($2060 in chips) 
Seat 5: Lucifer999 ($4916 in chips) 
Seat 6: spidy02 ($2930.09 in chips) 
Mukesh_19: posts small blind $10
teamwork575: posts big blind $25
*** HOLE CARDS ***
Dealt to Lucifer999 [9d 7s]
Lucifer999: folds
spidy02: calls $25
RKumarR: folds
Mukesh_19: folds
teamwork575: checks
*** FLOP *** [3s Qc Tc]
teamwork575: checks
spidy02: bets $42.64
teamwork575: calls $42.64
*** TURN *** [3s Qc Tc] [8d]
teamwork575: bets $100
spidy02: calls $100
*** RIVER *** [3s Qc Tc 8d] [Th]
teamwork575: checks
spidy02: checks
*** SHOW DOWN ***
teamwork575: shows [Td 4s] (Three of a kind, TTT)
spidy02: doesn't show hand
teamwork575 collected $324.17 from pot
*** SUMMARY ***
Total pot $345.28 | Rake $21.11
Board [3s Qc Tc 8d Th]
Seat 2: RKumarR (button) folded before Flop (didn't bet)
Seat 3: Mukesh_19 (small blind) folded before Flop
Seat 4: teamwork575  (big blind) showed [Td 4s] and won ($324.17) with Three of a kind, TTT
Seat 5: Lucifer999 folded before Flop (didn't bet)
Seat 6: spidy02 mucked



PokerStars Game #00327520974: Hold'em No Limit ($10/$25 USD) - 2022/04/30 08:58:37 ET
Table 'Hold'em (Min 500Max 2500)  1282' 6-max Seat #2 is the button
Seat 1: PANCHYOU ($986.96 in chips) 
Seat 2: kash1102 ($3356.63 in chips) 
Seat 3: manny007 ($1929.98 in chips) 
Seat 5: Lucifer999 ($2500 in chips) 
Seat 6: No username ($1688.52 in chips) 
manny007: posts small blind $10
Lucifer999: posts big blind $25
*** HOLE CARDS ***
Dealt to Lucifer999 [Ad 8d]
No username: folds
PANCHYOU: folds
kash1102: raises $50.00 to $75
manny007: folds
Lucifer999: folds
Uncalled bet ($50) returned to kash1102
kash1102: doesn't show hand
kash1102 collected $60 from pot
*** SUMMARY ***
Total pot $60.00 | Rake $0
Board []
Seat 1: PANCHYOU folded before Flop (didn't bet)
Seat 2: kash1102 (button) collected ($60)
Seat 3: manny007 (small blind) folded before Flop
Seat 5: Lucifer999 (big blind) folded before Flop
Seat 6: No username folded before Flop (didn't bet)



PokerStars Game #00327520990: Hold'em No Limit ($25/$50 USD) - 2022/04/30 08:58:48 ET
Table 'Hold'em (Min 1K Max 5K)   216' 6-max Seat #1 is the button
Seat 1: Lucifer999 ($6698.2 in chips) 
Seat 2: rahulh1 ($3272.19 in chips) 
Seat 3: kash1102 ($5000 in chips) 
Seat 5: Avaroni ($7841.56 in chips) 
Seat 6: Pablit0 ($3200 in chips) 
rahulh1: posts small blind $25
kash1102: posts big blind $50
*** HOLE CARDS ***
Dealt to Lucifer999 [Qs Ad]
Avaroni: folds
Pablit0: folds
Lucifer999: raises $100.00 to $150
rahulh1: folds
kash1102: folds
Uncalled bet ($100) returned to Lucifer999
Lucifer999: doesn't show hand
Lucifer999 collected $125 from pot
*** SUMMARY ***
Total pot $125.00 | Rake $0
Board []
Seat 1: Lucifer999 (button) collected ($125)
Seat 2: rahulh1 (small blind) folded before Flop
Seat 3: kash1102 (big blind) folded before Flop
Seat 5: Avaroni folded before Flop (didn't bet)
Seat 6: Pablit0 folded before Flop (didn't bet)



PokerStars Game #00327521034: Hold'em No Limit ($25/$50 USD) - 2022/04/30 08:59:17 ET
Table 'Hold'em (Min 1K Max 5K)   216' 6-max Seat #2 is the button
Seat 1: Lucifer999 ($6773.2 in chips) 
Seat 2: rahulh1 ($3247.19 in chips) 
Seat 3: kash1102 ($4950 in chips) 
Seat 5: Avaroni ($7841.56 in chips) 
Seat 6: Pablit0 ($3200 in chips) 
kash1102: posts small blind $25
Avaroni: posts big blind $50
*** HOLE CARDS ***
Dealt to Lucifer999 [3c Ad]
Pablit0: folds
Lucifer999: folds
rahulh1: calls $50
kash1102: folds
Avaroni: checks
*** FLOP *** [Kd As 8d]
Avaroni: checks
rahulh1: bets $50
Avaroni: folds
Uncalled bet ($50) returned to rahulh1
rahulh1: doesn't show hand
rahulh1 collected $118.75 from pot
*** SUMMARY ***
Total pot $125.00 | Rake $6.25
Board [Kd As 8d]
Seat 1: Lucifer999 folded before Flop (didn't bet)
Seat 2: rahulh1 (button) collected ($118.75)
Seat 3: kash1102 (small blind) folded before Flop
Seat 5: Avaroni (big blind) folded on the Flop
Seat 6: Pablit0 folded before Flop (didn't bet)



PokerStars Game #00327521006: Hold'em No Limit ($10/$25 USD) - 2022/04/30 08:58:58 ET
Table 'Hold'em (Min 500Max 2500) 1001' 6-max Seat #3 is the button
Seat 2: RKumarR ($4231.61 in chips) 
Seat 3: Mukesh_19 ($380 in chips) 
Seat 4: teamwork575 ($2249.17 in chips) 
Seat 5: Lucifer999 ($4916 in chips) 
Seat 6: spidy02 ($2762.45 in chips) 
teamwork575: posts small blind $10
Lucifer999: posts big blind $25
*** HOLE CARDS ***
Dealt to Lucifer999 [6c 2h]
spidy02: folds
RKumarR: raises $55.00 to $80
Mukesh_19: folds
teamwork575: raises $170.00 to $250
Lucifer999: folds
RKumarR: calls $170
*** FLOP *** [Th 5s 9d]
teamwork575: checks
RKumarR: checks
*** TURN *** [Th 5s 9d] [Ks]
teamwork575: checks
RKumarR: checks
*** RIVER *** [Th 5s 9d Ks] [2c]
teamwork575: bets $350
RKumarR: calls $350
*** SHOW DOWN ***
teamwork575: shows [7c Ac] (High card, A)
RKumarR: shows [6s 6h] (Pair, 66)
RKumarR collected $1155.69 from pot
*** SUMMARY ***
Total pot $1225.00 | Rake $69.31
Board [Th 5s 9d Ks 2c]
Seat 2: RKumarR  showed [6s 6h] and won ($1155.69) with Pair, 66
Seat 3: Mukesh_19 (button) folded before Flop (didn't bet)
Seat 4: teamwork575 (small blind) showed [7c Ac] and lost with High card, A
Seat 5: Lucifer999 (big blind) folded before Flop
Seat 6: spidy02 folded before Flop (didn't bet)



PokerStars Game #00327521033: Hold'em No Limit ($10/$25 USD) - 2022/04/30 08:59:16 ET
Table 'Hold'em (Min 500Max 2500)  1282' 6-max Seat #3 is the button
Seat 1: PANCHYOU ($986.96 in chips) 
Seat 2: kash1102 ($3391.63 in chips) 
Seat 3: manny007 ($1919.98 in chips) 
Seat 5: Lucifer999 ($2500 in chips) 
Seat 6: No username ($1688.52 in chips) 
Lucifer999: posts small blind $10
No username: posts big blind $25
*** HOLE CARDS ***
Dealt to Lucifer999 [4d 2d]
PANCHYOU: folds
kash1102: folds
manny007: calls $25
Lucifer999: folds
No username: checks
*** FLOP *** [Jd 7d Js]
No username: checks
manny007: checks
*** TURN *** [Jd 7d Js] [3s]
No username: checks
manny007: checks
*** RIVER *** [Jd 7d Js 3s] [9h]
No username: checks
manny007: checks
*** SHOW DOWN ***
No username: shows [Kd 6s] (Pair, JJ)
manny007: doesn't show hand
No username collected $56.85 from pot
*** SUMMARY ***
Total pot $60.00 | Rake $3.15
Board [Jd 7d Js 3s 9h]
Seat 1: PANCHYOU folded before Flop (didn't bet)
Seat 2: kash1102 folded before Flop (didn't bet)
Seat 3: manny007 (button) mucked
Seat 5: Lucifer999 (small blind) folded before Flop
Seat 6: No username  (big blind) showed [Kd 6s] and won ($56.85) with Pair, JJ



PokerStars Game #00327521105: Hold'em No Limit ($10/$25 USD) - 2022/04/30 08:59:56 ET
Table 'Hold'em (Min 500Max 2500) 1001' 6-max Seat #4 is the button
Seat 1: JaspritBumrah786 ($500 in chips) 
Seat 2: RKumarR ($4787.3 in chips) 
Seat 3: Mukesh_19 ($380 in chips) 
Seat 4: teamwork575 ($1675 in chips) 
Seat 5: Lucifer999 ($4891 in chips) 
Seat 6: spidy02 ($2762.45 in chips) 
Lucifer999: posts small blind $10
spidy02: posts big blind $25
*** HOLE CARDS ***
Dealt to Lucifer999 [Td 4s]
RKumarR: raises $55.00 to $80
Mukesh_19: folds
teamwork575: folds
Lucifer999: folds
spidy02: folds
Uncalled bet ($55) returned to RKumarR
RKumarR: doesn't show hand
RKumarR collected $60 from pot
*** SUMMARY ***
Total pot $60.00 | Rake $0
Board []
Seat 2: RKumarR collected ($60)
Seat 3: Mukesh_19 folded before Flop (didn't bet)
Seat 4: teamwork575 (button) folded before Flop (didn't bet)
Seat 5: Lucifer999 (small blind) folded before Flop
Seat 6: spidy02 (big blind) folded before Flop



PokerStars Game #00327521062: Hold'em No Limit ($50/$100 USD) - 2022/04/30 08:59:31 ET
Table 'Hold'em (Min 25KMax 10K)    69' 6-max Seat #1 is the button
Seat 1: Lucifer999 ($11029.39 in chips) 
Seat 4: vinuth ($10000 in chips) 
Lucifer999: posts small blind $50
vinuth: posts big blind $100
*** HOLE CARDS ***
Dealt to Lucifer999 [Kc 5s]
Lucifer999: raises $100.00 to $200
vinuth: calls $100
*** FLOP *** [4d Kh Qd]
vinuth: checks
Lucifer999: checks
*** TURN *** [4d Kh Qd] [8d]
vinuth: bets $352.88
Lucifer999: raises $702.22 to $1055.1
vinuth: raises $8744.90 to $9800
Lucifer999: folds
Uncalled bet ($8744.9) returned to vinuth
vinuth: doesn't show hand
vinuth collected $2412.31 from pot
*** SUMMARY ***
Total pot $2510.20 | Rake $97.89
Board [4d Kh Qd 8d]
Seat 1: Lucifer999 (button) (small blind) folded on the Turn
Seat 4: vinuth (big blind) collected ($2412.31)



PokerStars Game #00327521102: Hold'em No Limit ($25/$50 USD) - 2022/04/30 08:59:55 ET
Table 'Hold'em (Min 1K Max 5K)   216' 6-max Seat #3 is the button
Seat 1: Lucifer999 ($6773.2 in chips) 
Seat 2: rahulh1 ($3315.94 in chips) 
Seat 3: kash1102 ($4925 in chips) 
Seat 5: Avaroni ($7791.56 in chips) 
Seat 6: Pablit0 ($3200 in chips) 
Avaroni: posts small blind $25
Pablit0: posts big blind $50
*** HOLE CARDS ***
Dealt to Lucifer999 [Ks 8s]
Lucifer999: raises $100.00 to $150
rahulh1: folds
kash1102: folds
Avaroni: folds
Pablit0: calls $100
*** FLOP *** [9c 2s Jd]
Pablit0: checks
Lucifer999: bets $225
Pablit0: calls $225
*** TURN *** [9c 2s Jd] [Ad]
Pablit0: checks
Lucifer999: bets $450
Pablit0: folds
Uncalled bet ($450) returned to Lucifer999
Lucifer999: doesn't show hand
Lucifer999 collected $736.25 from pot
*** SUMMARY ***
Total pot $775.00 | Rake $38.75
Board [9c 2s Jd Ad]
Seat 1: Lucifer999 collected ($736.25)
Seat 2: rahulh1 folded before Flop (didn't bet)
Seat 3: kash1102 (button) folded before Flop (didn't bet)
Seat 5: Avaroni (small blind) folded before Flop
Seat 6: Pablit0 (big blind) folded on the Turn



PokerStars Game #00327521110: Hold'em No Limit ($10/$25 USD) - 2022/04/30 08:59:58 ET
Table 'Hold'em (Min 500Max 2500)  1282' 6-max Seat #5 is the button
Seat 1: PANCHYOU ($986.96 in chips) 
Seat 2: kash1102 ($3391.63 in chips) 
Seat 3: manny007 ($1894.98 in chips) 
Seat 5: Lucifer999 ($2500 in chips) 
Seat 6: No username ($1720.37 in chips) 
No username: posts small blind $10
PANCHYOU: posts big blind $25
*** HOLE CARDS ***
Dealt to Lucifer999 [4s Ac]
kash1102: folds
manny007: calls $25
Lucifer999: folds
No username: calls $15
PANCHYOU: checks
*** FLOP *** [3s 9c 4c]
No username: checks
PANCHYOU: checks
manny007: checks
*** TURN *** [3s 9c 4c] [Kc]
No username: checks
PANCHYOU: checks
manny007: checks
*** RIVER *** [3s 9c 4c Kc] [Qs]
No username: checks
PANCHYOU: checks
manny007: checks
*** SHOW DOWN ***
No username: shows [2d Jd] (High card, K)
PANCHYOU: doesn't show hand
manny007: shows [Ad 6d] (High card, A)
manny007 collected $71.07 from pot
*** SUMMARY ***
Total pot $75.00 | Rake $3.93
Board [3s 9c 4c Kc Qs]
Seat 1: PANCHYOU (big blind) mucked
Seat 2: kash1102 folded before Flop (didn't bet)
Seat 3: manny007  showed [Ad 6d] and won ($71.07) with High card, A
Seat 5: Lucifer999 (button) folded before Flop (didn't bet)
Seat 6: No username (small blind) showed [2d Jd] and lost with High card, K



PokerStars Game #00327521248: Hold'em No Limit ($25/$50 USD) - 2022/04/30 09:00:46 ET
Table 'Hold'em (Min 1K Max 5K)   216' 6-max Seat #5 is the button
Seat 1: Lucifer999 ($7134.45 in chips) 
Seat 2: rahulh1 ($3315.94 in chips) 
Seat 3: kash1102 ($4925 in chips) 
Seat 5: Avaroni ($7766.56 in chips) 
Seat 6: Pablit0 ($2825 in chips) 
Pablit0: posts small blind $25
Lucifer999: posts big blind $50
*** HOLE CARDS ***
Dealt to Lucifer999 [Td 4c]
rahulh1: folds
kash1102: folds
Avaroni: raises $100.00 to $150
Pablit0: folds
Lucifer999: folds
Uncalled bet ($100) returned to Avaroni
Avaroni: doesn't show hand
Avaroni collected $125 from pot
*** SUMMARY ***
Total pot $125.00 | Rake $0
Board []
Seat 1: Lucifer999 (big blind) folded before Flop
Seat 2: rahulh1 folded before Flop (didn't bet)
Seat 3: kash1102 folded before Flop (didn't bet)
Seat 5: Avaroni (button) collected ($125)
Seat 6: Pablit0 (small blind) folded before Flop



PokerStars Game #00327521265: Hold'em No Limit ($10/$25 USD) - 2022/04/30 09:00:54 ET
Table 'Hold'em (Min 500Max 2500)  1282' 6-max Seat #6 is the button
Seat 1: PANCHYOU ($961.96 in chips) 
Seat 2: kash1102 ($3391.63 in chips) 
Seat 3: manny007 ($1941.05 in chips) 
Seat 5: Lucifer999 ($2500 in chips) 
Seat 6: No username ($1695.37 in chips) 
PANCHYOU: posts small blind $10
kash1102: posts big blind $25
*** HOLE CARDS ***
Dealt to Lucifer999 [6s Ks]
manny007: folds
Lucifer999: folds
No username: raises $60.00 to $85
PANCHYOU: folds
kash1102: folds
Uncalled bet ($60) returned to No username
No username: doesn't show hand
No username collected $60 from pot
*** SUMMARY ***
Total pot $60.00 | Rake $0
Board []
Seat 1: PANCHYOU (small blind) folded before Flop
Seat 2: kash1102 (big blind) folded before Flop
Seat 3: manny007 folded before Flop (didn't bet)
Seat 5: Lucifer999 folded before Flop (didn't bet)
Seat 6: No username (button) collected ($60)



PokerStars Game #00327521208: Hold'em No Limit ($10/$25 USD) - 2022/04/30 09:00:34 ET
Table 'Hold'em (Min 500Max 2500) 1001' 6-max Seat #5 is the button
Seat 1: JaspritBumrah786 ($500 in chips) 
Seat 2: RKumarR ($4822.3 in chips) 
Seat 3: Mukesh_19 ($380 in chips) 
Seat 5: Lucifer999 ($4881 in chips) 
Seat 6: spidy02 ($2737.45 in chips) 
spidy02: posts small blind $10
JaspritBumrah786: posts big blind $25
*** HOLE CARDS ***
Dealt to Lucifer999 [6d 6c]
RKumarR: raises $55.00 to $80
Mukesh_19: folds
Lucifer999: calls $80
spidy02: folds
JaspritBumrah786: folds
*** FLOP *** [Qc 9d 2s]
RKumarR: bets $160
Lucifer999: folds
Uncalled bet ($160) returned to RKumarR
RKumarR: doesn't show hand
RKumarR collected $183.77 from pot
*** SUMMARY ***
Total pot $195.00 | Rake $11.23
Board [Qc 9d 2s]
Seat 1: JaspritBumrah786 (big blind) folded before Flop
Seat 2: RKumarR collected ($183.77)
Seat 3: Mukesh_19 folded before Flop (didn't bet)
Seat 5: Lucifer999 (button) folded on the Flop
Seat 6: spidy02 (small blind) folded before Flop



PokerStars Game #00327521210: Hold'em No Limit ($50/$100 USD) - 2022/04/30 09:00:36 ET
Table 'Hold'em (Min 25KMax 10K)    69' 6-max Seat #3 is the button
Seat 1: Lucifer999 ($10000 in chips) 
Seat 3: tabby20 ($10000 in chips) 
Seat 4: vinuth ($11157.21 in chips) 
tabby20: posts small blind $50
Lucifer999: posts big blind $100
*** HOLE CARDS ***
Dealt to Lucifer999 [Jd 9c]
tabby20: raises $100.00 to $200
Lucifer999: calls $100
*** FLOP *** [Qd Td 6c]
Lucifer999: checks
tabby20: bets $192.2
Lucifer999: calls $192.2
*** TURN *** [Qd Td 6c] [3s]
Lucifer999: checks
tabby20: checks
*** RIVER *** [Qd Td 6c 3s] [2s]
Lucifer999: bets $550
tabby20: calls $550
*** SHOW DOWN ***
Lucifer999: shows [Jd 9c] (High card, Q)
tabby20: shows [Ts Js] (Pair, TT)
tabby20 collected $1810.93 from pot
*** SUMMARY ***
Total pot $1884.40 | Rake $73.47
Board [Qd Td 6c 3s 2s]
Seat 1: Lucifer999 (big blind) showed [Jd 9c] and lost with High card, Q
Seat 3: tabby20  (button) (small blind) showed [Ts Js] and won ($1810.93) with Pair, TT



PokerStars Game #00327521339: Hold'em No Limit ($10/$25 USD) - 2022/04/30 09:01:18 ET
Table 'Hold'em (Min 500Max 2500)  1282' 6-max Seat #1 is the button
Seat 1: PANCHYOU ($951.96 in chips) 
Seat 2: kash1102 ($3366.63 in chips) 
Seat 3: manny007 ($1941.05 in chips) 
Seat 5: Lucifer999 ($2500 in chips) 
Seat 6: No username ($1730.37 in chips) 
kash1102: posts small blind $10
manny007: posts big blind $25
*** HOLE CARDS ***
Dealt to Lucifer999 [Ad Jd]
Lucifer999: raises $55.00 to $80
No username: calls $80
PANCHYOU: folds
kash1102: folds
manny007: calls $55
*** FLOP *** [Th 7d 2s]
manny007: bets $146.82
Lucifer999: calls $146.82
No username: folds
*** TURN *** [Th 7d 2s] [2c]
manny007: bets $25
Lucifer999: calls $25
*** RIVER *** [Th 7d 2s 2c] [Jc]
manny007: bets $25
Lucifer999: calls $25
*** SHOW DOWN ***
manny007: shows [5d Td] (Two pairs, TT22)
Lucifer999: shows [Ad Jd] (Two pairs, JJ22)
Lucifer999 collected $604.89 from pot
*** SUMMARY ***
Total pot $643.64 | Rake $38.75
Board [Th 7d 2s 2c Jc]
Seat 1: PANCHYOU (button) folded before Flop (didn't bet)
Seat 2: kash1102 (small blind) folded before Flop
Seat 3: manny007 (big blind) showed [5d Td] and lost with Two pairs, TT22
Seat 5: Lucifer999  showed [Ad Jd] and won ($604.89) with Two pairs, JJ22
Seat 6: No username folded on the Flop



PokerStars Game #00327521455: Hold'em No Limit ($50/$100 USD) - 2022/04/30 09:01:58 ET
Table 'Hold'em (Min 25KMax 10K)    69' 6-max Seat #1 is the button
Seat 1: Lucifer999 ($10000 in chips) 
Seat 4: vinuth ($11157.21 in chips) 
Lucifer999: posts small blind $50
vinuth: posts big blind $100
*** HOLE CARDS ***
Dealt to Lucifer999 [2h 7c]
Lucifer999: folds
Uncalled bet ($50) returned to vinuth
vinuth: doesn't show hand
vinuth collected $100 from pot
*** SUMMARY ***
Total pot $100.00 | Rake $0
Board []
Seat 1: Lucifer999 (button) (small blind) folded before Flop
Seat 4: vinuth (big blind) collected ($100)



PokerStars Game #00327521367: Hold'em No Limit ($10/$25 USD) - 2022/04/30 09:01:25 ET
Table 'Hold'em (Min 500Max 2500) 1001' 6-max Seat #6 is the button
Seat 1: JaspritBumrah786 ($475 in chips) 
Seat 2: RKumarR ($4926.07 in chips) 
Seat 3: Mukesh_19 ($380 in chips) 
Seat 5: Lucifer999 ($4801 in chips) 
Seat 6: spidy02 ($2727.45 in chips) 
JaspritBumrah786: posts small blind $10
RKumarR: posts big blind $25
*** HOLE CARDS ***
Dealt to Lucifer999 [6s Ac]
Mukesh_19: raises $60.00 to $85
Lucifer999: folds
spidy02: calls $85
JaspritBumrah786: folds
RKumarR: folds
*** FLOP *** [Jd Qc Tc]
Mukesh_19: bets $192.24
spidy02: raises $320.40 to $512.64
Mukesh_19: calls $102.76
Uncalled bet ($217.64) returned to spidy02
*** TURN *** [Jd Qc Tc] [Ts]
*** RIVER *** [Jd Qc Tc Ts] [5h]
*** SHOW DOWN ***
Mukesh_19: shows [Ad Qh] (Two pairs, QQTT)
spidy02: shows [Td Ks] (Three of a kind, TTT)
spidy02 collected $748.27 from pot
*** SUMMARY ***
Total pot $795.00 | Rake $46.73
Board [Jd Qc Tc Ts 5h]
Seat 1: JaspritBumrah786 (small blind) folded before Flop
Seat 2: RKumarR (big blind) folded before Flop
Seat 3: Mukesh_19 showed [Ad Qh] and lost with Two pairs, QQTT
Seat 5: Lucifer999 folded before Flop (didn't bet)
Seat 6: spidy02  (button) showed [Td Ks] and won ($748.27) with Three of a kind, TTT



PokerStars Game #00327521312: Hold'em No Limit ($25/$50 USD) - 2022/04/30 09:01:06 ET
Table 'Hold'em (Min 1K Max 5K)   216' 6-max Seat #6 is the button
Seat 1: Lucifer999 ($7084.45 in chips) 
Seat 2: rahulh1 ($3315.94 in chips) 
Seat 3: kash1102 ($4925 in chips) 
Seat 5: Avaroni ($7841.56 in chips) 
Seat 6: Pablit0 ($2800 in chips) 
Lucifer999: posts small blind $25
rahulh1: posts big blind $50
*** HOLE CARDS ***
Dealt to Lucifer999 [6h 9d]
kash1102: folds
Avaroni: raises $100.00 to $150
Pablit0: calls $150
Lucifer999: folds
rahulh1: folds
*** FLOP *** [7d 6s Th]
Avaroni: bets $225
Pablit0: calls $225
*** TURN *** [7d 6s Th] [9h]
Avaroni: bets $550
Pablit0: raises $1875.00 to $2425
Avaroni: folds
Uncalled bet ($1875) returned to Pablit0
Pablit0: doesn't show hand
Pablit0 collected $1828.75 from pot
*** SUMMARY ***
Total pot $1925.00 | Rake $96.25
Board [7d 6s Th 9h]
Seat 1: Lucifer999 (small blind) folded before Flop
Seat 2: rahulh1 (big blind) folded before Flop
Seat 3: kash1102 folded before Flop (didn't bet)
Seat 5: Avaroni folded on the Turn
Seat 6: Pablit0 (button) collected ($1828.75)



PokerStars Game #00327521488: Hold'em No Limit ($10/$25 USD) - 2022/04/30 09:02:11 ET
Table 'Hold'em (Min 500Max 2500) 1001' 6-max Seat #1 is the button
Seat 1: JaspritBumrah786 ($2025 in chips) 
Seat 2: RKumarR ($4901.07 in chips) 
Seat 3: Mukesh_19 ($500 in chips) 
Seat 4: SA754 ($1000 in chips) 
Seat 5: Lucifer999 ($4801 in chips) 
Seat 6: spidy02 ($3095.72 in chips) 
RKumarR: posts small blind $10
Lucifer999: posts big blind $25
*** HOLE CARDS ***
Dealt to Lucifer999 [Jc 4c]
spidy02: raises $35.00 to $60
JaspritBumrah786: folds
RKumarR: folds
Lucifer999: folds
Uncalled bet ($35) returned to spidy02
spidy02: doesn't show hand
spidy02 collected $60 from pot
*** SUMMARY ***
Total pot $60.00 | Rake $0
Board []
Seat 1: JaspritBumrah786 (button) folded before Flop (didn't bet)
Seat 2: RKumarR (small blind) folded before Flop
Seat 5: Lucifer999 (big blind) folded before Flop
Seat 6: spidy02 collected ($60)



PokerStars Game #00327521479: Hold'em No Limit ($10/$25 USD) - 2022/04/30 09:02:07 ET
Table 'Hold'em (Min 500Max 2500)  1282' 6-max Seat #2 is the button
Seat 1: PANCHYOU ($951.96 in chips) 
Seat 2: kash1102 ($3356.63 in chips) 
Seat 3: manny007 ($1664.23 in chips) 
Seat 4: RKumarR ($2500 in chips) 
Seat 5: Lucifer999 ($2828.07 in chips) 
Seat 6: No username ($1650.37 in chips) 
manny007: posts small blind $10
RKumarR: posts big blind $25
*** HOLE CARDS ***
Dealt to Lucifer999 [Jc 5c]
Lucifer999: folds
No username: folds
PANCHYOU: raises $35.00 to $60
kash1102: folds
manny007: raises $96.25 to $156.25
RKumarR: folds
PANCHYOU: folds
Uncalled bet ($96.25) returned to manny007
manny007: doesn't show hand
manny007 collected $145 from pot
*** SUMMARY ***
Total pot $145.00 | Rake $0
Board []
Seat 1: PANCHYOU folded before Flop
Seat 2: kash1102 (button) folded before Flop (didn't bet)
Seat 3: manny007 (small blind) collected ($145)
Seat 4: RKumarR (big blind) folded before Flop
Seat 5: Lucifer999 folded before Flop (didn't bet)
Seat 6: No username folded before Flop (didn't bet)



PokerStars Game #00327521477: Hold'em No Limit ($50/$100 USD) - 2022/04/30 09:02:07 ET
Table 'Hold'em (Min 25KMax 10K)    69' 6-max Seat #4 is the button
Seat 1: Lucifer999 ($10000 in chips) 
Seat 3: binny35 ($10000 in chips) 
Seat 4: vinuth ($11207.21 in chips) 
Lucifer999: posts small blind $50
binny35: posts big blind $100
*** HOLE CARDS ***
Dealt to Lucifer999 [Kc Jd]
vinuth: folds
Lucifer999: raises $200.00 to $300
binny35: calls $200
*** FLOP *** [8d 9s 8c]
Lucifer999: bets $450
binny35: calls $450
*** TURN *** [8d 9s 8c] [Jc]
Lucifer999: checks
binny35: bets $9250
Lucifer999: folds
Uncalled bet ($9250) returned to binny35
binny35: doesn't show hand
binny35 collected $1434 from pot
*** SUMMARY ***
Total pot $1500.00 | Rake $66
Board [8d 9s 8c Jc]
Seat 1: Lucifer999 (small blind) folded on the Turn
Seat 3: binny35 (big blind) collected ($1434)
Seat 4: vinuth (button) folded before Flop (didn't bet)



PokerStars Game #00327521574: Hold'em No Limit ($10/$25 USD) - 2022/04/30 09:02:44 ET
Table 'Hold'em (Min 500Max 2500) 1001' 6-max Seat #2 is the button
Seat 1: JaspritBumrah786 ($2025 in chips) 
Seat 2: RKumarR ($4891.07 in chips) 
Seat 3: Mukesh_19 ($500 in chips) 
Seat 4: SA754 ($1000 in chips) 
Seat 5: Lucifer999 ($4776 in chips) 
Seat 6: spidy02 ($3130.72 in chips) 
Lucifer999: posts small blind $10
spidy02: posts big blind $25
*** HOLE CARDS ***
Dealt to Lucifer999 [8s Qh]
JaspritBumrah786: folds
RKumarR: raises $55.00 to $80
Lucifer999: folds
spidy02: folds
Uncalled bet ($55) returned to RKumarR
RKumarR: doesn't show hand
RKumarR collected $60 from pot
*** SUMMARY ***
Total pot $60.00 | Rake $0
Board []
Seat 1: JaspritBumrah786 folded before Flop (didn't bet)
Seat 2: RKumarR (button) collected ($60)
Seat 5: Lucifer999 (small blind) folded before Flop
Seat 6: spidy02 (big blind) folded before Flop



PokerStars Game #00327521487: Hold'em No Limit ($25/$50 USD) - 2022/04/30 09:02:10 ET
Table 'Hold'em (Min 1K Max 5K)   216' 6-max Seat #1 is the button
Seat 1: Lucifer999 ($7059.45 in chips) 
Seat 2: rahulh1 ($3265.94 in chips) 
Seat 3: kash1102 ($4925 in chips) 
Seat 5: Avaroni ($6916.56 in chips) 
Seat 6: Pablit0 ($3703.75 in chips) 
rahulh1: posts small blind $25
kash1102: posts big blind $50
*** HOLE CARDS ***
Dealt to Lucifer999 [7s 7h]
Avaroni: raises $100.00 to $150
Pablit0: folds
Lucifer999: calls $150
rahulh1: calls $125
kash1102: folds
*** FLOP *** [8d 4d 4h]
rahulh1: checks
Avaroni: checks
Lucifer999: bets $175
rahulh1: calls $175
Avaroni: folds
*** TURN *** [8d 4d 4h] [3c]
rahulh1: checks
Lucifer999: checks
*** RIVER *** [8d 4d 4h 3c] [4s]
rahulh1: checks
Lucifer999: bets $300
rahulh1: folds
Uncalled bet ($300) returned to Lucifer999
Lucifer999: doesn't show hand
Lucifer999 collected $807.5 from pot
*** SUMMARY ***
Total pot $850.00 | Rake $42.5
Board [8d 4d 4h 3c 4s]
Seat 1: Lucifer999 (button) collected ($807.5)
Seat 2: rahulh1 (small blind) folded on the River
Seat 3: kash1102 (big blind) folded before Flop
Seat 5: Avaroni folded on the Flop
Seat 6: Pablit0 folded before Flop (didn't bet)



PokerStars Game #00327521586: Hold'em No Limit ($10/$25 USD) - 2022/04/30 09:02:46 ET
Table 'Hold'em (Min 500Max 2500)  1282' 6-max Seat #3 is the button
Seat 1: PANCHYOU ($891.96 in chips) 
Seat 2: kash1102 ($3356.63 in chips) 
Seat 3: manny007 ($1749.23 in chips) 
Seat 4: RKumarR ($2500 in chips) 
Seat 5: Lucifer999 ($2828.07 in chips) 
Seat 6: No username ($1650.37 in chips) 
RKumarR: posts small blind $10
Lucifer999: posts big blind $25
*** HOLE CARDS ***
Dealt to Lucifer999 [9s 5s]
No username: raises $60.00 to $85
PANCHYOU: folds
kash1102: folds
manny007: folds
RKumarR: folds
Lucifer999: folds
Uncalled bet ($60) returned to No username
No username: doesn't show hand
No username collected $60 from pot
*** SUMMARY ***
Total pot $60.00 | Rake $0
Board []
Seat 1: PANCHYOU folded before Flop (didn't bet)
Seat 2: kash1102 folded before Flop (didn't bet)
Seat 3: manny007 (button) folded before Flop (didn't bet)
Seat 4: RKumarR (small blind) folded before Flop
Seat 5: Lucifer999 (big blind) folded before Flop
Seat 6: No username collected ($60)



PokerStars Game #00327521606: Hold'em No Limit ($50/$100 USD) - 2022/04/30 09:02:54 ET
Table 'Hold'em (Min 25KMax 10K)    69' 6-max Seat #1 is the button
Seat 1: Lucifer999 ($10000 in chips) 
Seat 3: binny35 ($10684 in chips) 
Seat 4: vinuth ($11207.21 in chips) 
binny35: posts small blind $50
vinuth: posts big blind $100
*** HOLE CARDS ***
Dealt to Lucifer999 [Ah 6c]
Lucifer999: raises $200.00 to $300
binny35: folds
vinuth: folds
Uncalled bet ($200) returned to Lucifer999
Lucifer999: doesn't show hand
Lucifer999 collected $250 from pot
*** SUMMARY ***
Total pot $250.00 | Rake $0
Board []
Seat 1: Lucifer999 (button) collected ($250)
Seat 3: binny35 (small blind) folded before Flop
Seat 4: vinuth (big blind) folded before Flop



PokerStars Game #00327521702: Hold'em No Limit ($50/$100 USD) - 2022/04/30 09:03:29 ET
Table 'Hold'em (Min 25KMax 10K)    69' 6-max Seat #3 is the button
Seat 1: Lucifer999 ($10150 in chips) 
Seat 3: binny35 ($10634 in chips) 
Seat 4: vinuth ($11107.21 in chips) 
vinuth: posts small blind $50
Lucifer999: posts big blind $100
*** HOLE CARDS ***
Dealt to Lucifer999 [Jh 2s]
binny35: raises $200.00 to $300
vinuth: folds
Lucifer999: folds
Uncalled bet ($200) returned to binny35
binny35: doesn't show hand
binny35 collected $250 from pot
*** SUMMARY ***
Total pot $250.00 | Rake $0
Board []
Seat 1: Lucifer999 (big blind) folded before Flop
Seat 3: binny35 (button) collected ($250)
Seat 4: vinuth (small blind) folded before Flop



PokerStars Game #00327521682: Hold'em No Limit ($25/$50 USD) - 2022/04/30 09:03:22 ET
Table 'Hold'em (Min 1K Max 5K)   216' 6-max Seat #2 is the button
Seat 1: Lucifer999 ($7541.95 in chips) 
Seat 2: rahulh1 ($2940.94 in chips) 
Seat 3: kash1102 ($4875 in chips) 
Seat 5: Avaroni ($6766.56 in chips) 
Seat 6: Pablit0 ($3703.75 in chips) 
kash1102: posts small blind $25
Avaroni: posts big blind $50
*** HOLE CARDS ***
Dealt to Lucifer999 [8d Qs]
Pablit0: folds
Lucifer999: folds
rahulh1: folds
kash1102: raises $125.00 to $175
Avaroni: folds
Uncalled bet ($125) returned to kash1102
kash1102: doesn't show hand
kash1102 collected $100 from pot
*** SUMMARY ***
Total pot $100.00 | Rake $0
Board []
Seat 1: Lucifer999 folded before Flop (didn't bet)
Seat 2: rahulh1 (button) folded before Flop (didn't bet)
Seat 3: kash1102 (small blind) collected ($100)
Seat 5: Avaroni (big blind) folded before Flop
Seat 6: Pablit0 folded before Flop (didn't bet)



PokerStars Game #00327521756: Hold'em No Limit ($50/$100 USD) - 2022/04/30 09:03:43 ET
Table 'Hold'em (Min 25KMax 10K)    69' 6-max Seat #4 is the button
Seat 1: Lucifer999 ($10050 in chips) 
Seat 3: binny35 ($10784 in chips) 
Seat 4: vinuth ($11057.21 in chips) 
Lucifer999: posts small blind $50
binny35: posts big blind $100
*** HOLE CARDS ***
Dealt to Lucifer999 [9d 4h]
vinuth: folds
Lucifer999: folds
Uncalled bet ($50) returned to binny35
binny35: doesn't show hand
binny35 collected $100 from pot
*** SUMMARY ***
Total pot $100.00 | Rake $0
Board []
Seat 1: Lucifer999 (small blind) folded before Flop
Seat 3: binny35 (big blind) collected ($100)
Seat 4: vinuth (button) folded before Flop (didn't bet)



PokerStars Game #00327521686: Hold'em No Limit ($10/$25 USD) - 2022/04/30 09:03:23 ET
Table 'Hold'em (Min 500Max 2500)  1282' 6-max Seat #4 is the button
Seat 1: PANCHYOU ($891.96 in chips) 
Seat 2: kash1102 ($3356.63 in chips) 
Seat 3: manny007 ($1749.23 in chips) 
Seat 4: RKumarR ($2500 in chips) 
Seat 5: Lucifer999 ($2803.07 in chips) 
Seat 6: No username ($1685.37 in chips) 
Lucifer999: posts small blind $10
No username: posts big blind $25
*** HOLE CARDS ***
Dealt to Lucifer999 [Ac 5d]
PANCHYOU: raises $55.00 to $80
kash1102: folds
manny007: folds
RKumarR: folds
Lucifer999: folds
No username: folds
Uncalled bet ($55) returned to PANCHYOU
PANCHYOU: doesn't show hand
PANCHYOU collected $60 from pot
*** SUMMARY ***
Total pot $60.00 | Rake $0
Board []
Seat 1: PANCHYOU collected ($60)
Seat 2: kash1102 folded before Flop (didn't bet)
Seat 3: manny007 folded before Flop (didn't bet)
Seat 4: RKumarR (button) folded before Flop (didn't bet)
Seat 5: Lucifer999 (small blind) folded before Flop
Seat 6: No username (big blind) folded before Flop



PokerStars Game #00327521781: Hold'em No Limit ($25/$50 USD) - 2022/04/30 09:03:52 ET
Table 'Hold'em (Min 1K Max 5K)   216' 6-max Seat #3 is the button
Seat 1: Lucifer999 ($7541.95 in chips) 
Seat 2: rahulh1 ($2940.94 in chips) 
Seat 3: kash1102 ($4925 in chips) 
Seat 5: Avaroni ($6716.56 in chips) 
Seat 6: Pablit0 ($3703.75 in chips) 
Avaroni: posts small blind $25
Pablit0: posts big blind $50
*** HOLE CARDS ***
Dealt to Lucifer999 [Jh 7d]
Lucifer999: folds
rahulh1: folds
kash1102: folds
Avaroni: folds
Uncalled bet ($25) returned to Pablit0
Pablit0: doesn't show hand
Pablit0 collected $50 from pot
*** SUMMARY ***
Total pot $50.00 | Rake $0
Board []
Seat 1: Lucifer999 folded before Flop (didn't bet)
Seat 2: rahulh1 folded before Flop (didn't bet)
Seat 3: kash1102 (button) folded before Flop (didn't bet)
Seat 5: Avaroni (small blind) folded before Flop
Seat 6: Pablit0 (big blind) collected ($50)



PokerStars Game #00327521800: Hold'em No Limit ($50/$100 USD) - 2022/04/30 09:03:57 ET
Table 'Hold'em (Min 25KMax 10K)    69' 6-max Seat #1 is the button
Seat 1: Lucifer999 ($10000 in chips) 
Seat 3: binny35 ($10834 in chips) 
Seat 4: vinuth ($11057.21 in chips) 
binny35: posts small blind $50
vinuth: posts big blind $100
*** HOLE CARDS ***
Dealt to Lucifer999 [Tc 2c]
Lucifer999: folds
binny35: folds
Uncalled bet ($50) returned to vinuth
vinuth: doesn't show hand
vinuth collected $100 from pot
*** SUMMARY ***
Total pot $100.00 | Rake $0
Board []
Seat 1: Lucifer999 (button) folded before Flop (didn't bet)
Seat 3: binny35 (small blind) folded before Flop
Seat 4: vinuth (big blind) collected ($100)



PokerStars Game #00327521667: Hold'em No Limit ($10/$25 USD) - 2022/04/30 09:03:16 ET
Table 'Hold'em (Min 500Max 2500) 1001' 6-max Seat #5 is the button
Seat 1: JaspritBumrah786 ($2025 in chips) 
Seat 2: RKumarR ($4926.07 in chips) 
Seat 3: Mukesh_19 ($500 in chips) 
Seat 4: SA754 ($1000 in chips) 
Seat 5: Lucifer999 ($4766 in chips) 
Seat 6: spidy02 ($3105.72 in chips) 
spidy02: posts small blind $10
JaspritBumrah786: posts big blind $25
Mukesh_19: posts small & big blinds $35
SA754: posts big blind $25
*** HOLE CARDS ***
Dealt to Lucifer999 [2d Td]
RKumarR: folds
Mukesh_19: raises $47.50 to $82.5
SA754: calls $47.5
Lucifer999: folds
spidy02: folds
JaspritBumrah786: folds
*** FLOP *** [6h 8s As]
Mukesh_19: bets $60.34
SA754: calls $60.34
*** TURN *** [6h 8s As] [6d]
Mukesh_19: checks
SA754: checks
*** RIVER *** [6h 8s As 6d] [Tc]
Mukesh_19: checks
SA754: bets $291.41
Mukesh_19: folds
Uncalled bet ($291.41) returned to SA754
SA754: doesn't show hand
SA754 collected $291.41 from pot
*** SUMMARY ***
Total pot $310.68 | Rake $19.27
Board [6h 8s As 6d Tc]
Seat 1: JaspritBumrah786 (big blind) folded before Flop
Seat 2: RKumarR folded before Flop (didn't bet)
Seat 3: Mukesh_19 folded on the River
Seat 4: SA754 collected ($291.41)
Seat 5: Lucifer999 (button) folded before Flop (didn't bet)
Seat 6: spidy02 (small blind) folded before Flop



PokerStars Game #00327521822: Hold'em No Limit ($10/$25 USD) - 2022/04/30 09:04:04 ET
Table 'Hold'em (Min 500Max 2500)  1282' 6-max Seat #5 is the button
Seat 1: PANCHYOU ($926.96 in chips) 
Seat 2: kash1102 ($3356.63 in chips) 
Seat 3: manny007 ($1749.23 in chips) 
Seat 4: RKumarR ($2500 in chips) 
Seat 5: Lucifer999 ($2793.07 in chips) 
Seat 6: No username ($1660.37 in chips) 
No username: posts small blind $10
PANCHYOU: posts big blind $25
*** HOLE CARDS ***
Dealt to Lucifer999 [2c Qd]
kash1102: folds
manny007: folds
RKumarR: folds
Lucifer999: folds
No username: folds
Uncalled bet ($15) returned to PANCHYOU
PANCHYOU: doesn't show hand
PANCHYOU collected $20 from pot
*** SUMMARY ***
Total pot $20.00 | Rake $0
Board []
Seat 1: PANCHYOU (big blind) collected ($20)
Seat 2: kash1102 folded before Flop (didn't bet)
Seat 3: manny007 folded before Flop (didn't bet)
Seat 4: RKumarR folded before Flop (didn't bet)
Seat 5: Lucifer999 (button) folded before Flop (didn't bet)
Seat 6: No username (small blind) folded before Flop



PokerStars Game #00327521858: Hold'em No Limit ($50/$100 USD) - 2022/04/30 09:04:18 ET
Table 'Hold'em (Min 25KMax 10K)    69' 6-max Seat #3 is the button
Seat 1: Lucifer999 ($10000 in chips) 
Seat 3: binny35 ($10784 in chips) 
Seat 4: vinuth ($11107.21 in chips) 
vinuth: posts small blind $50
Lucifer999: posts big blind $100
*** HOLE CARDS ***
Dealt to Lucifer999 [8h 9h]
binny35: folds
vinuth: raises $200.00 to $300
Lucifer999: calls $200
*** FLOP *** [Tc Kc Jc]
vinuth: bets $430.2
Lucifer999: folds
Uncalled bet ($430.2) returned to vinuth
vinuth: doesn't show hand
vinuth collected $573.6 from pot
*** SUMMARY ***
Total pot $600.00 | Rake $26.4
Board [Tc Kc Jc]
Seat 1: Lucifer999 (big blind) folded on the Flop
Seat 3: binny35 (button) folded before Flop (didn't bet)
Seat 4: vinuth (small blind) collected ($573.6)



PokerStars Game #00327521947: Hold'em No Limit ($50/$100 USD) - 2022/04/30 09:04:51 ET
Table 'Hold'em (Min 25KMax 10K)    69' 6-max Seat #4 is the button
Seat 1: Lucifer999 ($10000 in chips) 
Seat 3: binny35 ($10784 in chips) 
Seat 4: vinuth ($11380.81 in chips) 
Lucifer999: posts small blind $50
binny35: posts big blind $100
*** HOLE CARDS ***
Dealt to Lucifer999 [Tc 2d]
vinuth: folds
Lucifer999: folds
Uncalled bet ($50) returned to binny35
binny35: doesn't show hand
binny35 collected $100 from pot
*** SUMMARY ***
Total pot $100.00 | Rake $0
Board []
Seat 1: Lucifer999 (small blind) folded before Flop
Seat 3: binny35 (big blind) collected ($100)
Seat 4: vinuth (button) folded before Flop (didn't bet)



PokerStars Game #00327521901: Hold'em No Limit ($10/$25 USD) - 2022/04/30 09:04:33 ET
Table 'Hold'em (Min 500Max 2500) 1001' 6-max Seat #6 is the button
Seat 1: JaspritBumrah786 ($2000 in chips) 
Seat 3: Mukesh_19 ($357.16 in chips) 
Seat 4: SA754 ($1158.57 in chips) 
Seat 5: Lucifer999 ($4766 in chips) 
Seat 6: spidy02 ($3095.72 in chips) 
JaspritBumrah786: posts small blind $10
Mukesh_19: posts big blind $25
*** HOLE CARDS ***
Dealt to Lucifer999 [3c 9c]
SA754: calls $25
Lucifer999: folds
spidy02: folds
JaspritBumrah786: folds
Mukesh_19: checks
*** FLOP *** [Th Tc Qs]
Mukesh_19: checks
SA754: bets $56.85
Mukesh_19: folds
Uncalled bet ($56.85) returned to SA754
SA754: doesn't show hand
SA754 collected $56.85 from pot
*** SUMMARY ***
Total pot $60.00 | Rake $3.15
Board [Th Tc Qs]
Seat 1: JaspritBumrah786 (small blind) folded before Flop
Seat 3: Mukesh_19 (big blind) folded on the Flop
Seat 4: SA754 collected ($56.85)
Seat 5: Lucifer999 folded before Flop (didn't bet)
Seat 6: spidy02 (button) folded before Flop (didn't bet)



PokerStars Game #00327521857: Hold'em No Limit ($25/$50 USD) - 2022/04/30 09:04:18 ET
Table 'Hold'em (Min 1K Max 5K)   216' 6-max Seat #5 is the button
Seat 1: Lucifer999 ($7541.95 in chips) 
Seat 2: rahulh1 ($2940.94 in chips) 
Seat 3: kash1102 ($4925 in chips) 
Seat 5: Avaroni ($6691.56 in chips) 
Seat 6: Pablit0 ($3728.75 in chips) 
Pablit0: posts small blind $25
Lucifer999: posts big blind $50
*** HOLE CARDS ***
Dealt to Lucifer999 [8s 6c]
rahulh1: calls $50
kash1102: folds
Avaroni: folds
Pablit0: folds
Lucifer999: checks
*** FLOP *** [3s 3h 2h]
Lucifer999: bets $100
rahulh1: calls $100
*** TURN *** [3s 3h 2h] [5h]
Lucifer999: checks
rahulh1: bets $127.35
Lucifer999: folds
Uncalled bet ($127.35) returned to rahulh1
rahulh1: doesn't show hand
rahulh1 collected $308.75 from pot
*** SUMMARY ***
Total pot $325.00 | Rake $16.25
Board [3s 3h 2h 5h]
Seat 1: Lucifer999 (big blind) folded on the Turn
Seat 2: rahulh1 collected ($308.75)
Seat 3: kash1102 folded before Flop (didn't bet)
Seat 5: Avaroni (button) folded before Flop (didn't bet)
Seat 6: Pablit0 (small blind) folded before Flop



PokerStars Game #00327521974: Hold'em No Limit ($50/$100 USD) - 2022/04/30 09:05:01 ET
Table 'Hold'em (Min 25KMax 10K)    69' 6-max Seat #1 is the button
Seat 1: Lucifer999 ($10000 in chips) 
Seat 3: binny35 ($10834 in chips) 
Seat 4: vinuth ($11380.81 in chips) 
Lucifer999: posts small blind $50
binny35: posts big blind $100
*** HOLE CARDS ***
Dealt to Lucifer999 [Tc 8c]
Lucifer999: raises $100.00 to $200
binny35: raises $500.00 to $700
Lucifer999: calls $500
*** FLOP *** [Jh 6c 7d]
binny35: checks
Lucifer999: checks
*** TURN *** [Jh 6c 7d] [5s]
binny35: checks
Lucifer999: checks
*** RIVER *** [Jh 6c 7d 5s] [5c]
binny35: bets $1345.4
Lucifer999: folds
Uncalled bet ($1345.4) returned to binny35
binny35: doesn't show hand
binny35 collected $1345.4 from pot
*** SUMMARY ***
Total pot $1400.00 | Rake $54.6
Board [Jh 6c 7d 5s 5c]
Seat 1: Lucifer999 (button) (small blind) folded on the River
Seat 3: binny35 (big blind) collected ($1345.4)



PokerStars Game #00327522000: Hold'em No Limit ($10/$25 USD) - 2022/04/30 09:05:08 ET
Table 'Hold'em (Min 500Max 2500) 1001' 6-max Seat #1 is the button
Seat 1: JaspritBumrah786 ($2025 in chips) 
Seat 3: Mukesh_19 ($332.16 in chips) 
Seat 4: SA754 ($1190.42 in chips) 
Seat 5: Lucifer999 ($4766 in chips) 
Seat 6: spidy02 ($3095.72 in chips) 
Mukesh_19: posts small blind $10
SA754: posts big blind $25
*** HOLE CARDS ***
Dealt to Lucifer999 [2c Th]
Lucifer999: folds
spidy02: folds
JaspritBumrah786: raises $50.00 to $75
Mukesh_19: raises $175.00 to $250
SA754: calls $225
JaspritBumrah786: folds
*** FLOP *** [5d 2h Js]
Mukesh_19: bets $82.16
SA754: calls $82.16
*** TURN *** [5d 2h Js] [Kd]
*** RIVER *** [5d 2h Js Kd] [Ks]
*** SHOW DOWN ***
Mukesh_19: shows [9c 9d] (Two pairs, KK99)
SA754: shows [3c 6c] (Pair, KK)
Mukesh_19 collected $695.53 from pot
*** SUMMARY ***
Total pot $739.32 | Rake $43.79
Board [5d 2h Js Kd Ks]
Seat 1: JaspritBumrah786 (button) folded before Flop
Seat 3: Mukesh_19  (small blind) showed [9c 9d] and won ($695.53) with Two pairs, KK99
Seat 4: SA754 (big blind) showed [3c 6c] and lost with Pair, KK
Seat 5: Lucifer999 folded before Flop (didn't bet)
Seat 6: spidy02 folded before Flop (didn't bet)



PokerStars Game #00327522136: Hold'em No Limit ($50/$100 USD) - 2022/04/30 09:05:54 ET
Table 'Hold'em (Min 25KMax 10K)    69' 6-max Seat #3 is the button
Seat 1: Lucifer999 ($10000 in chips) 
Seat 3: binny35 ($11479.4 in chips) 
Seat 4: vinuth ($11380.81 in chips) 
binny35: posts small blind $50
Lucifer999: posts big blind $100
*** HOLE CARDS ***
Dealt to Lucifer999 [4s 6c]
binny35: raises $100.00 to $200
Lucifer999: folds
Uncalled bet ($100) returned to binny35
binny35: doesn't show hand
binny35 collected $200 from pot
*** SUMMARY ***
Total pot $200.00 | Rake $0
Board []
Seat 1: Lucifer999 (big blind) folded before Flop
Seat 3: binny35 (button) (small blind) collected ($200)



PokerStars Game #00327522148: Hold'em No Limit ($10/$25 USD) - 2022/04/30 09:05:59 ET
Table 'Hold'em (Min 500Max 2500) 1001' 6-max Seat #3 is the button
Seat 1: JaspritBumrah786 ($2025 in chips) 
Seat 3: Mukesh_19 ($695.53 in chips) 
Seat 4: SA754 ($858.26 in chips) 
Seat 5: Lucifer999 ($4766 in chips) 
Seat 6: spidy02 ($3095.72 in chips) 
SA754: posts small blind $10
Lucifer999: posts big blind $25
*** HOLE CARDS ***
Dealt to Lucifer999 [6h Td]
spidy02: folds
JaspritBumrah786: folds
Mukesh_19: folds
SA754: raises $85.00 to $110
Lucifer999: folds
Uncalled bet ($85) returned to SA754
SA754: doesn't show hand
SA754 collected $50 from pot
*** SUMMARY ***
Total pot $50.00 | Rake $0
Board []
Seat 1: JaspritBumrah786 folded before Flop (didn't bet)
Seat 3: Mukesh_19 (button) folded before Flop (didn't bet)
Seat 4: SA754 (small blind) collected ($50)
Seat 5: Lucifer999 (big blind) folded before Flop
Seat 6: spidy02 folded before Flop (didn't bet)



PokerStars Game #00327522041: Hold'em No Limit ($25/$50 USD) - 2022/04/30 09:05:21 ET
Table 'Hold'em (Min 1K Max 5K)   216' 6-max Seat #6 is the button
Seat 1: Lucifer999 ($7391.95 in chips) 
Seat 2: rahulh1 ($3099.69 in chips) 
Seat 3: kash1102 ($4925 in chips) 
Seat 5: Avaroni ($6691.56 in chips) 
Seat 6: Pablit0 ($3703.75 in chips) 
Lucifer999: posts small blind $25
rahulh1: posts big blind $50
*** HOLE CARDS ***
Dealt to Lucifer999 [Ts Ks]
kash1102: folds
Avaroni: folds
Pablit0: raises $100.00 to $150
Lucifer999: calls $125
rahulh1: folds
*** FLOP *** [Qd Qh Kd]
Lucifer999: checks
Pablit0: bets $166.25
Lucifer999: calls $166.25
*** TURN *** [Qd Qh Kd] [5d]
Lucifer999: checks
Pablit0: checks
*** RIVER *** [Qd Qh Kd 5d] [4c]
Lucifer999: bets $400
Pablit0: raises $600.00 to $1000
Lucifer999: calls $600
*** SHOW DOWN ***
Pablit0: shows [Ac Qc] (Three of a kind, QQQ)
Lucifer999: doesn't show hand
Pablit0 collected $2548.4 from pot
*** SUMMARY ***
Total pot $2682.50 | Rake $134.1
Board [Qd Qh Kd 5d 4c]
Seat 1: Lucifer999 (small blind) mucked
Seat 2: rahulh1 (big blind) folded before Flop
Seat 3: kash1102 folded before Flop (didn't bet)
Seat 5: Avaroni folded before Flop (didn't bet)
Seat 6: Pablit0  (button) showed [Ac Qc] and won ($2548.4) with Three of a kind, QQQ



PokerStars Game #00327521913: Hold'em No Limit ($10/$25 USD) - 2022/04/30 09:04:40 ET
Table 'Hold'em (Min 500Max 2500)  1282' 6-max Seat #6 is the button
Seat 1: PANCHYOU ($936.96 in chips) 
Seat 2: kash1102 ($3356.63 in chips) 
Seat 3: manny007 ($1749.23 in chips) 
Seat 4: RKumarR ($2500 in chips) 
Seat 5: Lucifer999 ($2793.07 in chips) 
Seat 6: No username ($1650.37 in chips) 
PANCHYOU: posts small blind $10
kash1102: posts big blind $25
*** HOLE CARDS ***
Dealt to Lucifer999 [Qd 5d]
manny007: folds
RKumarR: raises $55.00 to $80
Lucifer999: folds
No username: calls $80
PANCHYOU: folds
kash1102: calls $55
*** FLOP *** [Js 3d 4d]
kash1102: checks
RKumarR: checks
No username: checks
*** TURN *** [Js 3d 4d] [Kd]
kash1102: checks
RKumarR: checks
No username: checks
*** RIVER *** [Js 3d 4d Kd] [Ac]
kash1102: bets $345.27
RKumarR: folds
No username: folds
Uncalled bet ($345.27) returned to kash1102
kash1102: doesn't show hand
kash1102 collected $234.88 from pot
*** SUMMARY ***
Total pot $250.00 | Rake $15.12
Board [Js 3d 4d Kd Ac]
Seat 1: PANCHYOU (small blind) folded before Flop
Seat 2: kash1102 (big blind) collected ($234.88)
Seat 3: manny007 folded before Flop (didn't bet)
Seat 4: RKumarR folded on the River
Seat 5: Lucifer999 folded before Flop (didn't bet)
Seat 6: No username (button) folded on the River



PokerStars Game #00327522232: Hold'em No Limit ($10/$25 USD) - 2022/04/30 09:06:28 ET
Table 'Hold'em (Min 500Max 2500) 1001' 6-max Seat #4 is the button
Seat 1: JaspritBumrah786 ($2025 in chips) 
Seat 3: Mukesh_19 ($695.53 in chips) 
Seat 4: SA754 ($883.26 in chips) 
Seat 5: Lucifer999 ($4741 in chips) 
Seat 6: spidy02 ($3095.72 in chips) 
Lucifer999: posts small blind $10
spidy02: posts big blind $25
*** HOLE CARDS ***
Dealt to Lucifer999 [7s Th]
JaspritBumrah786: folds
SA754: calls $25
Lucifer999: folds
spidy02: checks
*** FLOP *** [4d 5h Jh]
spidy02: checks
SA754: checks
*** TURN *** [4d 5h Jh] [3s]
spidy02: checks
SA754: checks
*** RIVER *** [4d 5h Jh 3s] [Td]
spidy02: checks
SA754: checks
*** SHOW DOWN ***
spidy02: shows [8d Qc] (High card, Q)
SA754: doesn't show hand
spidy02 collected $56.85 from pot
*** SUMMARY ***
Total pot $60.00 | Rake $3.15
Board [4d 5h Jh 3s Td]
Seat 1: JaspritBumrah786 folded before Flop (didn't bet)
Seat 4: SA754 (button) mucked
Seat 5: Lucifer999 (small blind) folded before Flop
Seat 6: spidy02  (big blind) showed [8d Qc] and won ($56.85) with High card, Q



PokerStars Game #00327522162: Hold'em No Limit ($50/$100 USD) - 2022/04/30 09:06:05 ET
Table 'Hold'em (Min 25KMax 10K)    69' 6-max Seat #1 is the button
Seat 1: Lucifer999 ($10000 in chips) 
Seat 3: binny35 ($11579.4 in chips) 
Seat 4: vinuth ($11380.81 in chips) 
Lucifer999: posts small blind $50
binny35: posts big blind $100
*** HOLE CARDS ***
Dealt to Lucifer999 [3s Tc]
Lucifer999: raises $100.00 to $200
binny35: raises $100.00 to $300
Lucifer999: calls $100
*** FLOP *** [2s 5d Ah]
binny35: bets $288.3
Lucifer999: calls $288.3
*** TURN *** [2s 5d Ah] [3h]
binny35: checks
Lucifer999: bets $700
binny35: folds
Uncalled bet ($700) returned to Lucifer999
Lucifer999: doesn't show hand
Lucifer999 collected $1130.74 from pot
*** SUMMARY ***
Total pot $1176.60 | Rake $45.86
Board [2s 5d Ah 3h]
Seat 1: Lucifer999 (button) (small blind) collected ($1130.74)
Seat 3: binny35 (big blind) folded on the Turn



PokerStars Game #00327522254: Hold'em No Limit ($25/$50 USD) - 2022/04/30 09:06:34 ET
Table 'Hold'em (Min 1K Max 5K)   216' 6-max Seat #1 is the button
Seat 1: Lucifer999 ($6075.7 in chips) 
Seat 2: rahulh1 ($3049.69 in chips) 
Seat 3: kash1102 ($4925 in chips) 
Seat 5: Avaroni ($6691.56 in chips) 
Seat 6: Pablit0 ($4935.9 in chips) 
rahulh1: posts small blind $25
kash1102: posts big blind $50
*** HOLE CARDS ***
Dealt to Lucifer999 [6d 4s]
Avaroni: folds
Pablit0: folds
Lucifer999: raises $100.00 to $150
rahulh1: folds
kash1102: folds
Uncalled bet ($100) returned to Lucifer999
Lucifer999: doesn't show hand
Lucifer999 collected $125 from pot
*** SUMMARY ***
Total pot $125.00 | Rake $0
Board []
Seat 1: Lucifer999 (button) collected ($125)
Seat 2: rahulh1 (small blind) folded before Flop
Seat 3: kash1102 (big blind) folded before Flop
Seat 5: Avaroni folded before Flop (didn't bet)
Seat 6: Pablit0 folded before Flop (didn't bet)



PokerStars Game #00327522295: Hold'em No Limit ($10/$25 USD) - 2022/04/30 09:06:50 ET
Table 'Hold'em (Min 500Max 2500)  1282' 6-max Seat #1 is the button
Seat 1: PANCHYOU ($926.96 in chips) 
Seat 2: kash1102 ($3511.51 in chips) 
Seat 3: manny007 ($1749.23 in chips) 
Seat 4: RKumarR ($2500 in chips) 
Seat 5: Lucifer999 ($2793.07 in chips) 
Seat 6: No username ($1570.37 in chips) 
kash1102: posts small blind $10
manny007: posts big blind $25
*** HOLE CARDS ***
Dealt to Lucifer999 [8d 6c]
RKumarR: folds
Lucifer999: folds
No username: folds
PANCHYOU: folds
kash1102: folds
Uncalled bet ($15) returned to manny007
manny007: doesn't show hand
manny007 collected $20 from pot
*** SUMMARY ***
Total pot $20.00 | Rake $0
Board []
Seat 1: PANCHYOU (button) folded before Flop (didn't bet)
Seat 2: kash1102 (small blind) folded before Flop
Seat 3: manny007 (big blind) collected ($20)
Seat 4: RKumarR folded before Flop (didn't bet)
Seat 5: Lucifer999 folded before Flop (didn't bet)
Seat 6: No username folded before Flop (didn't bet)



PokerStars Game #00327522321: Hold'em No Limit ($50/$100 USD) - 2022/04/30 09:07:00 ET
Table 'Hold'em (Min 25KMax 10K)    69' 6-max Seat #3 is the button
Seat 1: Lucifer999 ($10542.44 in chips) 
Seat 3: binny35 ($10991.1 in chips) 
Seat 4: vinuth ($11380.81 in chips) 
binny35: posts small blind $50
Lucifer999: posts big blind $100
*** HOLE CARDS ***
Dealt to Lucifer999 [Js Qc]
binny35: raises $100.00 to $200
Lucifer999: raises $500.00 to $700
binny35: folds
Uncalled bet ($500) returned to Lucifer999
Lucifer999: doesn't show hand
Lucifer999 collected $400 from pot
*** SUMMARY ***
Total pot $400.00 | Rake $0
Board []
Seat 1: Lucifer999 (big blind) collected ($400)
Seat 3: binny35 (button) (small blind) folded before Flop



PokerStars Game #00327522319: Hold'em No Limit ($10/$25 USD) - 2022/04/30 09:07:00 ET
Table 'Hold'em (Min 500Max 2500) 1001' 6-max Seat #5 is the button
Seat 1: JaspritBumrah786 ($2025 in chips) 
Seat 3: Mukesh_19 ($695.53 in chips) 
Seat 4: SA754 ($858.26 in chips) 
Seat 5: Lucifer999 ($4731 in chips) 
Seat 6: spidy02 ($3127.57 in chips) 
spidy02: posts small blind $10
JaspritBumrah786: posts big blind $25
*** HOLE CARDS ***
Dealt to Lucifer999 [Tc 4c]
SA754: raises $25.00 to $50
Lucifer999: folds
spidy02: folds
JaspritBumrah786: calls $25
*** FLOP *** [Qd 5s 7d]
JaspritBumrah786: checks
SA754: checks
*** TURN *** [Qd 5s 7d] [Th]
JaspritBumrah786: checks
SA754: bets $103.23
JaspritBumrah786: folds
Uncalled bet ($103.23) returned to SA754
SA754: doesn't show hand
SA754 collected $103.23 from pot
*** SUMMARY ***
Total pot $110.00 | Rake $6.77
Board [Qd 5s 7d Th]
Seat 1: JaspritBumrah786 (big blind) folded on the Turn
Seat 4: SA754 collected ($103.23)
Seat 5: Lucifer999 (button) folded before Flop (didn't bet)
Seat 6: spidy02 (small blind) folded before Flop



PokerStars Game #00327522392: Hold'em No Limit ($10/$25 USD) - 2022/04/30 09:07:21 ET
Table 'Hold'em (Min 500Max 2500)  1282' 6-max Seat #2 is the button
Seat 1: PANCHYOU ($926.96 in chips) 
Seat 2: kash1102 ($3501.51 in chips) 
Seat 3: manny007 ($1759.23 in chips) 
Seat 4: Avaroni ($2500 in chips) 
Seat 5: Lucifer999 ($2793.07 in chips) 
Seat 6: No username ($1570.37 in chips) 
manny007: posts small blind $10
Lucifer999: posts big blind $25
*** HOLE CARDS ***
Dealt to Lucifer999 [4h 5h]
No username: folds
PANCHYOU: folds
kash1102: folds
manny007: raises $50.00 to $75
Lucifer999: calls $50
*** FLOP *** [Qd 7s 7d]
manny007: bets $49.51
Lucifer999: folds
Uncalled bet ($49.51) returned to manny007
manny007: doesn't show hand
manny007 collected $141.13 from pot
*** SUMMARY ***
Total pot $150.00 | Rake $8.87
Board [Qd 7s 7d]
Seat 1: PANCHYOU folded before Flop (didn't bet)
Seat 2: kash1102 (button) folded before Flop (didn't bet)
Seat 3: manny007 (small blind) collected ($141.13)
Seat 5: Lucifer999 (big blind) folded on the Flop
Seat 6: No username folded before Flop (didn't bet)



PokerStars Game #00327522343: Hold'em No Limit ($25/$50 USD) - 2022/04/30 09:07:08 ET
Table 'Hold'em (Min 1K Max 5K)   216' 6-max Seat #2 is the button
Seat 1: Lucifer999 ($6150.7 in chips) 
Seat 2: rahulh1 ($3024.69 in chips) 
Seat 3: kash1102 ($4875 in chips) 
Seat 5: Avaroni ($6691.56 in chips) 
Seat 6: Pablit0 ($4935.9 in chips) 
kash1102: posts small blind $25
Avaroni: posts big blind $50
*** HOLE CARDS ***
Dealt to Lucifer999 [8d 4h]
Lucifer999: folds
rahulh1: folds
kash1102: raises $75.00 to $125
Avaroni: calls $75
*** FLOP *** [2d 8c 5s]
kash1102: checks
Avaroni: bets $150
kash1102: calls $150
*** TURN *** [2d 8c 5s] [Jd]
kash1102: checks
Avaroni: checks
*** RIVER *** [2d 8c 5s Jd] [7d]
kash1102: checks
Avaroni: checks
*** SHOW DOWN ***
Avaroni: shows [6c 7c] (Pair, 77)
kash1102: doesn't show hand
Avaroni collected $522.5 from pot
*** SUMMARY ***
Total pot $550.00 | Rake $27.5
Board [2d 8c 5s Jd 7d]
Seat 1: Lucifer999 folded before Flop (didn't bet)
Seat 2: rahulh1 (button) folded before Flop (didn't bet)
Seat 3: kash1102 (small blind) mucked
Seat 5: Avaroni  (big blind) showed [6c 7c] and won ($522.5) with Pair, 77



PokerStars Game #00327522534: Hold'em No Limit ($25/$50 USD) - 2022/04/30 09:08:12 ET
Table 'Hold'em (Min 1K Max 5K)   216' 6-max Seat #3 is the button
Seat 1: Lucifer999 ($6150.7 in chips) 
Seat 2: rahulh1 ($3024.69 in chips) 
Seat 3: kash1102 ($4600 in chips) 
Seat 5: Avaroni ($6939.06 in chips) 
Avaroni: posts small blind $25
Lucifer999: posts big blind $50
*** HOLE CARDS ***
Dealt to Lucifer999 [4c Th]
rahulh1: folds
kash1102: folds
Avaroni: folds
Uncalled bet ($25) returned to Lucifer999
Lucifer999: doesn't show hand
Lucifer999 collected $50 from pot
*** SUMMARY ***
Total pot $50.00 | Rake $0
Board []
Seat 1: Lucifer999 (big blind) collected ($50)
Seat 2: rahulh1 folded before Flop (didn't bet)
Seat 3: kash1102 (button) folded before Flop (didn't bet)
Seat 5: Avaroni (small blind) folded before Flop



PokerStars Game #00327522463: Hold'em No Limit ($10/$25 USD) - 2022/04/30 09:07:45 ET
Table 'Hold'em (Min 500Max 2500) 1001' 6-max Seat #6 is the button
Seat 1: JaspritBumrah786 ($2025 in chips) 
Seat 3: Mukesh_19 ($695.53 in chips) 
Seat 4: SA754 ($911.49 in chips) 
Seat 5: Lucifer999 ($4731 in chips) 
Seat 6: spidy02 ($3117.57 in chips) 
JaspritBumrah786: posts small blind $10
SA754: posts big blind $25
*** HOLE CARDS ***
Dealt to Lucifer999 [Qh Th]
Lucifer999: folds
spidy02: raises $60.00 to $85
JaspritBumrah786: folds
SA754: calls $60
*** FLOP *** [Qd Ad 7d]
SA754: checks
spidy02: checks
*** TURN *** [Qd Ad 7d] [5h]
SA754: bets $53.84
spidy02: calls $53.84
*** RIVER *** [Qd Ad 7d 5h] [2c]
SA754: bets $270.62
spidy02: folds
Uncalled bet ($270.62) returned to SA754
SA754: doesn't show hand
SA754 collected $270.62 from pot
*** SUMMARY ***
Total pot $287.68 | Rake $17.06
Board [Qd Ad 7d 5h 2c]
Seat 1: JaspritBumrah786 (small blind) folded before Flop
Seat 4: SA754 (big blind) collected ($270.62)
Seat 5: Lucifer999 folded before Flop (didn't bet)
Seat 6: spidy02 (button) folded on the River



PokerStars Game #00327522522: Hold'em No Limit ($10/$25 USD) - 2022/04/30 09:08:07 ET
Table 'Hold'em (Min 500Max 2500)  1282' 6-max Seat #3 is the button
Seat 1: PANCHYOU ($926.96 in chips) 
Seat 2: kash1102 ($3501.51 in chips) 
Seat 3: manny007 ($1825.36 in chips) 
Seat 4: Avaroni ($2500 in chips) 
Seat 5: Lucifer999 ($2718.07 in chips) 
Seat 6: No username ($1570.37 in chips) 
Lucifer999: posts small blind $10
No username: posts big blind $25
*** HOLE CARDS ***
Dealt to Lucifer999 [2s Kc]
PANCHYOU: raises $25.00 to $50
kash1102: folds
manny007: calls $50
Lucifer999: folds
No username: calls $25
*** FLOP *** [2c 6h 4c]
No username: checks
PANCHYOU: checks
manny007: checks
*** TURN *** [2c 6h 4c] [Qd]
No username: bets $112.95
PANCHYOU: folds
manny007: folds
Uncalled bet ($112.95) returned to No username
No username: doesn't show hand
No username collected $150.6 from pot
*** SUMMARY ***
Total pot $160.00 | Rake $9.4
Board [2c 6h 4c Qd]
Seat 1: PANCHYOU folded on the Turn
Seat 2: kash1102 folded before Flop (didn't bet)
Seat 3: manny007 (button) folded on the Turn
Seat 5: Lucifer999 (small blind) folded before Flop
Seat 6: No username (big blind) collected ($150.6)



PokerStars Game #00327522589: Hold'em No Limit ($25/$50 USD) - 2022/04/30 09:08:30 ET
Table 'Hold'em (Min 1K Max 5K)   216' 6-max Seat #5 is the button
Seat 1: Lucifer999 ($6175.7 in chips) 
Seat 2: rahulh1 ($3024.69 in chips) 
Seat 3: kash1102 ($4600 in chips) 
Seat 5: Avaroni ($6914.06 in chips) 
Lucifer999: posts small blind $25
rahulh1: posts big blind $50
*** HOLE CARDS ***
Dealt to Lucifer999 [4c 4s]
kash1102: raises $100.00 to $150
Avaroni: folds
Lucifer999: calls $125
rahulh1: calls $100
*** FLOP *** [Ac 5d Qd]
Lucifer999: checks
rahulh1: checks
kash1102: bets $213.75
Lucifer999: folds
rahulh1: calls $213.75
*** TURN *** [Ac 5d Qd] [Ks]
rahulh1: checks
kash1102: bets $625.24
rahulh1: calls $625.24
*** RIVER *** [Ac 5d Qd Ks] [Td]
rahulh1: bets $1010.82
kash1102: folds
Uncalled bet ($1010.82) returned to rahulh1
rahulh1: doesn't show hand
rahulh1 collected $2021.63 from pot
*** SUMMARY ***
Total pot $2127.98 | Rake $106.35
Board [Ac 5d Qd Ks Td]
Seat 1: Lucifer999 (small blind) folded on the Flop
Seat 2: rahulh1 (big blind) collected ($2021.63)
Seat 3: kash1102 folded on the River
Seat 5: Avaroni (button) folded before Flop (didn't bet)



PokerStars Game #00327522696: Hold'em No Limit ($10/$25 USD) - 2022/04/30 09:09:04 ET
Table 'Hold'em (Min 500Max 2500)  1282' 6-max Seat #5 is the button
Seat 1: PANCHYOU ($876.96 in chips) 
Seat 2: kash1102 ($3501.51 in chips) 
Seat 3: manny007 ($1775.36 in chips) 
Seat 4: Avaroni ($2500 in chips) 
Seat 5: Lucifer999 ($2708.07 in chips) 
Seat 6: No username ($1670.97 in chips) 
No username: posts small blind $10
PANCHYOU: posts big blind $25
*** HOLE CARDS ***
Dealt to Lucifer999 [6d 9s]
kash1102: folds
manny007: calls $25
Lucifer999: folds
No username: folds
PANCHYOU: checks
*** FLOP *** [Ad 6h Jh]
PANCHYOU: checks
manny007: checks
*** TURN *** [Ad 6h Jh] [Ts]
PANCHYOU: checks
manny007: checks
*** RIVER *** [Ad 6h Jh Ts] [Jc]
PANCHYOU: bets $55
manny007: folds
Uncalled bet ($55) returned to PANCHYOU
PANCHYOU: doesn't show hand
PANCHYOU collected $56.85 from pot
*** SUMMARY ***
Total pot $60.00 | Rake $3.15
Board [Ad 6h Jh Ts Jc]
Seat 1: PANCHYOU (big blind) collected ($56.85)
Seat 2: kash1102 folded before Flop (didn't bet)
Seat 3: manny007 folded on the River
Seat 5: Lucifer999 (button) folded before Flop (didn't bet)
Seat 6: No username (small blind) folded before Flop



PokerStars Game #00327522804: Hold'em No Limit ($25/$50 USD) - 2022/04/30 09:09:40 ET
Table 'Hold'em (Min 1K Max 5K)   216' 6-max Seat #1 is the button
Seat 1: Lucifer999 ($6025.7 in chips) 
Seat 2: rahulh1 ($4057.33 in chips) 
Seat 3: kash1102 ($3611.01 in chips) 
Seat 5: Avaroni ($6914.06 in chips) 
rahulh1: posts small blind $25
kash1102: posts big blind $50
*** HOLE CARDS ***
Dealt to Lucifer999 [Kc Ad]
Avaroni: folds
Lucifer999: raises $100.00 to $150
rahulh1: folds
kash1102: folds
Uncalled bet ($100) returned to Lucifer999
Lucifer999: doesn't show hand
Lucifer999 collected $125 from pot
*** SUMMARY ***
Total pot $125.00 | Rake $0
Board []
Seat 1: Lucifer999 (button) collected ($125)
Seat 2: rahulh1 (small blind) folded before Flop
Seat 3: kash1102 (big blind) folded before Flop
Seat 5: Avaroni folded before Flop (didn't bet)



PokerStars Game #00327522809: Hold'em No Limit ($10/$25 USD) - 2022/04/30 09:09:42 ET
Table 'Hold'em (Min 500Max 2500)  1282' 6-max Seat #6 is the button
Seat 1: PANCHYOU ($908.81 in chips) 
Seat 2: kash1102 ($3501.51 in chips) 
Seat 3: manny007 ($1750.36 in chips) 
Seat 4: Avaroni ($2500 in chips) 
Seat 5: Lucifer999 ($2708.07 in chips) 
Seat 6: No username ($1660.97 in chips) 
PANCHYOU: posts small blind $10
kash1102: posts big blind $25
*** HOLE CARDS ***
Dealt to Lucifer999 [Ac 7d]
manny007: folds
Lucifer999: folds
No username: raises $60.00 to $85
PANCHYOU: folds
kash1102: folds
Uncalled bet ($60) returned to No username
No username: doesn't show hand
No username collected $60 from pot
*** SUMMARY ***
Total pot $60.00 | Rake $0
Board []
Seat 1: PANCHYOU (small blind) folded before Flop
Seat 2: kash1102 (big blind) folded before Flop
Seat 3: manny007 folded before Flop (didn't bet)
Seat 5: Lucifer999 folded before Flop (didn't bet)
Seat 6: No username (button) collected ($60)



PokerStars Game #00327522682: Hold'em No Limit ($10/$25 USD) - 2022/04/30 09:09:00 ET
Table 'Hold'em (Min 500Max 2500) 1001' 6-max Seat #1 is the button
Seat 1: JaspritBumrah786 ($2015 in chips) 
Seat 3: Mukesh_19 ($695.53 in chips) 
Seat 4: SA754 ($1043.27 in chips) 
Seat 5: Lucifer999 ($4731 in chips) 
Seat 6: spidy02 ($2978.73 in chips) 
SA754: posts small blind $10
Lucifer999: posts big blind $25
*** HOLE CARDS ***
Dealt to Lucifer999 [Th 6s]
spidy02: calls $25
JaspritBumrah786: folds
SA754: calls $15
Lucifer999: checks
*** FLOP *** [6c 7s Kh]
SA754: checks
Lucifer999: checks
spidy02: checks
*** TURN *** [6c 7s Kh] [4c]
SA754: checks
Lucifer999: bets $80
spidy02: calls $80
SA754: calls $80
*** RIVER *** [6c 7s Kh 4c] [8h]
SA754: bets $295.47
Lucifer999: folds
spidy02: raises $295.47 to $590.94
SA754: raises $347.33 to $938.27
spidy02: calls $347.33
*** SHOW DOWN ***
SA754: shows [Jd 5d] (Straight, 8-4)
spidy02: shows [5c 5s] (Straight, 8-4)
SA754 collected $1035.76 from pot
spidy02 collected $1035.76 from pot
*** SUMMARY ***
Total pot $2191.54 | Rake $120.02
Board [6c 7s Kh 4c 8h]
Seat 1: JaspritBumrah786 (button) folded before Flop (didn't bet)
Seat 4: SA754  (small blind) showed [Jd 5d] and won ($1035.76) with Straight, 8-4
Seat 5: Lucifer999 (big blind) folded on the River
Seat 6: spidy02  showed [5c 5s] and won ($1035.76) with Straight, 8-4



PokerStars Game #00327522897: Hold'em No Limit ($10/$25 USD) - 2022/04/30 09:10:12 ET
Table 'Hold'em (Min 500Max 2500)  1282' 6-max Seat #1 is the button
Seat 1: PANCHYOU ($898.81 in chips) 
Seat 2: kash1102 ($3476.51 in chips) 
Seat 3: manny007 ($1750.36 in chips) 
Seat 4: Avaroni ($2500 in chips) 
Seat 5: Lucifer999 ($2708.07 in chips) 
Seat 6: No username ($1695.97 in chips) 
kash1102: posts small blind $10
manny007: posts big blind $25
*** HOLE CARDS ***
Dealt to Lucifer999 [4d Qs]
Lucifer999: folds
No username: folds
PANCHYOU: folds
kash1102: folds
Uncalled bet ($15) returned to manny007
manny007: doesn't show hand
manny007 collected $20 from pot
*** SUMMARY ***
Total pot $20.00 | Rake $0
Board []
Seat 1: PANCHYOU (button) folded before Flop (didn't bet)
Seat 2: kash1102 (small blind) folded before Flop
Seat 3: manny007 (big blind) collected ($20)
Seat 5: Lucifer999 folded before Flop (didn't bet)
Seat 6: No username folded before Flop (didn't bet)



PokerStars Game #00327522874: Hold'em No Limit ($50/$100 USD) - 2022/04/30 09:10:04 ET
Table 'Hold'em (Min 25KMax 10K)    69' 6-max Seat #1 is the button
Seat 1: Lucifer999 ($10742.44 in chips) 
Seat 4: vinuth ($11380.81 in chips) 
Seat 6: binny35 ($10791.1 in chips) 
Lucifer999: posts small blind $50
binny35: posts big blind $100
*** HOLE CARDS ***
Dealt to Lucifer999 [Kh Js]
Lucifer999: raises $100.00 to $200
binny35: calls $100
*** FLOP *** [2h 2s Qs]
binny35: checks
Lucifer999: checks
*** TURN *** [2h 2s Qs] [Qd]
binny35: bets $192.2
Lucifer999: calls $192.2
*** RIVER *** [2h 2s Qs Qd] [Tc]
binny35: checks
Lucifer999: checks
*** SHOW DOWN ***
binny35: shows [6h 9c] (Two pairs, QQ22)
Lucifer999: shows [Kh Js] (Two pairs, QQ22)
Lucifer999 collected $753.83 from pot
*** SUMMARY ***
Total pot $784.40 | Rake $30.57
Board [2h 2s Qs Qd Tc]
Seat 1: Lucifer999  (button) (small blind) showed [Kh Js] and won ($753.83) with Two pairs, QQ22
Seat 6: binny35 (big blind) showed [6h 9c] and lost with Two pairs, QQ22



PokerStars Game #00327522882: Hold'em No Limit ($25/$50 USD) - 2022/04/30 09:10:07 ET
Table 'Hold'em (Min 1K Max 5K)   216' 6-max Seat #2 is the button
Seat 1: Lucifer999 ($6100.7 in chips) 
Seat 2: rahulh1 ($4032.33 in chips) 
Seat 3: kash1102 ($3561.01 in chips) 
Seat 5: Avaroni ($6914.06 in chips) 
kash1102: posts small blind $25
Avaroni: posts big blind $50
*** HOLE CARDS ***
Dealt to Lucifer999 [Kc Ah]
Lucifer999: calls $50
rahulh1: folds
kash1102: folds
Avaroni: raises $150.00 to $200
Lucifer999: raises $500.00 to $700
Avaroni: calls $500
*** FLOP *** [Ad 4d Qs]
Avaroni: checks
Lucifer999: bets $1000
Avaroni: folds
Uncalled bet ($1000) returned to Lucifer999
Lucifer999: doesn't show hand
Lucifer999 collected $1353.75 from pot
*** SUMMARY ***
Total pot $1425.00 | Rake $71.25
Board [Ad 4d Qs]
Seat 1: Lucifer999 collected ($1353.75)
Seat 2: rahulh1 (button) folded before Flop (didn't bet)
Seat 3: kash1102 (small blind) folded before Flop
Seat 5: Avaroni (big blind) folded on the Flop



PokerStars Game #00327522972: Hold'em No Limit ($10/$25 USD) - 2022/04/30 09:10:36 ET
Table 'Hold'em (Min 500Max 2500)  1282' 6-max Seat #2 is the button
Seat 1: PANCHYOU ($898.81 in chips) 
Seat 2: kash1102 ($3466.51 in chips) 
Seat 3: manny007 ($1760.36 in chips) 
Seat 4: Avaroni ($2500 in chips) 
Seat 5: Lucifer999 ($2708.07 in chips) 
Seat 6: No username ($1695.97 in chips) 
manny007: posts small blind $10
Avaroni: posts big blind $25
*** HOLE CARDS ***
Dealt to Lucifer999 [Ks Kc]
Lucifer999: raises $55.00 to $80
No username: folds
PANCHYOU: folds
kash1102: folds
manny007: folds
Avaroni: folds
Uncalled bet ($55) returned to Lucifer999
Lucifer999: doesn't show hand
Lucifer999 collected $60 from pot
*** SUMMARY ***
Total pot $60.00 | Rake $0
Board []
Seat 1: PANCHYOU folded before Flop (didn't bet)
Seat 2: kash1102 (button) folded before Flop (didn't bet)
Seat 3: manny007 (small blind) folded before Flop
Seat 4: Avaroni (big blind) folded before Flop
Seat 5: Lucifer999 collected ($60)
Seat 6: No username folded before Flop (didn't bet)



PokerStars Game #00327523018: Hold'em No Limit ($50/$100 USD) - 2022/04/30 09:10:51 ET
Table 'Hold'em (Min 25KMax 10K)    69' 6-max Seat #6 is the button
Seat 1: Lucifer999 ($11104.07 in chips) 
Seat 4: vinuth ($11380.81 in chips) 
Seat 6: binny35 ($10398.9 in chips) 
binny35: posts small blind $50
Lucifer999: posts big blind $100
*** HOLE CARDS ***
Dealt to Lucifer999 [2d 3d]
binny35: raises $100.00 to $200
Lucifer999: calls $100
*** FLOP *** [5h 4c Js]
Lucifer999: checks
binny35: bets $100
Lucifer999: calls $100
*** TURN *** [5h 4c Js] [4s]
Lucifer999: checks
binny35: checks
*** RIVER *** [5h 4c Js 4s] [5c]
Lucifer999: bets $400
binny35: folds
Uncalled bet ($400) returned to Lucifer999
Lucifer999: doesn't show hand
Lucifer999 collected $576.6 from pot
*** SUMMARY ***
Total pot $600.00 | Rake $23.4
Board [5h 4c Js 4s 5c]
Seat 1: Lucifer999 (big blind) collected ($576.6)
Seat 6: binny35 (button) (small blind) folded on the River



PokerStars Game #00327523021: Hold'em No Limit ($25/$50 USD) - 2022/04/30 09:10:54 ET
Table 'Hold'em (Min 1K Max 5K)   216' 6-max Seat #3 is the button
Seat 1: Lucifer999 ($6754.45 in chips) 
Seat 2: rahulh1 ($4032.33 in chips) 
Seat 3: kash1102 ($5000 in chips) 
Seat 5: Avaroni ($6214.06 in chips) 
Avaroni: posts small blind $25
Lucifer999: posts big blind $50
*** HOLE CARDS ***
Dealt to Lucifer999 [8s 7c]
rahulh1: folds
kash1102: folds
Avaroni: raises $100.00 to $150
Lucifer999: calls $100
*** FLOP *** [7s 6c 5h]
Avaroni: bets $142.5
Lucifer999: calls $142.5
*** TURN *** [7s 6c 5h] [8h]
Avaroni: bets $400
Lucifer999: calls $400
*** RIVER *** [7s 6c 5h 8h] [Td]
Avaroni: bets $1315.75
Lucifer999: calls $1315.75
*** SHOW DOWN ***
Avaroni: shows [Kd Js] (High card, K)
Lucifer999: shows [8s 7c] (Two pairs, 8877)
Lucifer999 collected $3815.7 from pot
*** SUMMARY ***
Total pot $4016.50 | Rake $200.8
Board [7s 6c 5h 8h Td]
Seat 1: Lucifer999  (big blind) showed [8s 7c] and won ($3815.7) with Two pairs, 8877
Seat 2: rahulh1 folded before Flop (didn't bet)
Seat 3: kash1102 (button) folded before Flop (didn't bet)
Seat 5: Avaroni (small blind) showed [Kd Js] and lost with High card, K



PokerStars Game #00327522906: Hold'em No Limit ($10/$25 USD) - 2022/04/30 09:10:13 ET
Table 'Hold'em (Min 500Max 2500) 1001' 6-max Seat #4 is the button
Seat 1: JaspritBumrah786 ($2015 in chips) 
Seat 2: spaceman47157 ($2500 in chips) 
Seat 3: Mukesh_19 ($695.53 in chips) 
Seat 4: SA754 ($1035.76 in chips) 
Seat 5: Lucifer999 ($4626 in chips) 
Seat 6: spidy02 ($2971.22 in chips) 
Lucifer999: posts small blind $10
spidy02: posts big blind $25
spaceman47157: posts big blind $25
*** HOLE CARDS ***
Dealt to Lucifer999 [3c Ts]
JaspritBumrah786: folds
spaceman47157: checks
SA754: raises $25.00 to $50
Lucifer999: folds
spidy02: calls $25
spaceman47157: calls $25
*** FLOP *** [4c 9s Kh]
spidy02: checks
spaceman47157: checks
SA754: checks
*** TURN *** [4c 9s Kh] [Jc]
spidy02: checks
spaceman47157: checks
SA754: bets $45
spidy02: folds
spaceman47157: calls $45
*** RIVER *** [4c 9s Kh Jc] [5d]
spaceman47157: checks
SA754: bets $117.44
spaceman47157: folds
Uncalled bet ($117.44) returned to SA754
SA754: doesn't show hand
SA754 collected $234.88 from pot
*** SUMMARY ***
Total pot $250.00 | Rake $15.12
Board [4c 9s Kh Jc 5d]
Seat 1: JaspritBumrah786 folded before Flop (didn't bet)
Seat 2: spaceman47157 folded on the River
Seat 4: SA754 (button) collected ($234.88)
Seat 5: Lucifer999 (small blind) folded before Flop
Seat 6: spidy02 (big blind) folded on the Turn



PokerStars Game #00327523160: Hold'em No Limit ($50/$100 USD) - 2022/04/30 09:11:40 ET
Table 'Hold'em (Min 25KMax 10K)    69' 6-max Seat #1 is the button
Seat 1: Lucifer999 ($11380.67 in chips) 
Seat 4: vinuth ($11380.81 in chips) 
Seat 6: binny35 ($10098.9 in chips) 
Lucifer999: posts small blind $50
binny35: posts big blind $100
*** HOLE CARDS ***
Dealt to Lucifer999 [2h 5c]
Lucifer999: raises $100.00 to $200
binny35: raises $500.00 to $700
Lucifer999: folds
Uncalled bet ($500) returned to binny35
binny35: doesn't show hand
binny35 collected $400 from pot
*** SUMMARY ***
Total pot $400.00 | Rake $0
Board []
Seat 1: Lucifer999 (button) (small blind) folded before Flop
Seat 6: binny35 (big blind) collected ($400)



PokerStars Game #00327523136: Hold'em No Limit ($10/$25 USD) - 2022/04/30 09:11:34 ET
Table 'Hold'em (Min 500Max 2500)  1282' 6-max Seat #3 is the button
Seat 1: PANCHYOU ($898.81 in chips) 
Seat 2: kash1102 ($3466.51 in chips) 
Seat 3: manny007 ($1750.36 in chips) 
Seat 4: Avaroni ($2500 in chips) 
Seat 5: Lucifer999 ($2743.07 in chips) 
Seat 6: No username ($1695.97 in chips) 
Lucifer999: posts small blind $10
No username: posts big blind $25
*** HOLE CARDS ***
Dealt to Lucifer999 [Ah Th]
PANCHYOU: folds
kash1102: folds
manny007: calls $25
Lucifer999: raises $85.00 to $110
No username: folds
manny007: folds
Uncalled bet ($85) returned to Lucifer999
Lucifer999: doesn't show hand
Lucifer999 collected $75 from pot
*** SUMMARY ***
Total pot $75.00 | Rake $0
Board []
Seat 1: PANCHYOU folded before Flop (didn't bet)
Seat 2: kash1102 folded before Flop (didn't bet)
Seat 3: manny007 (button) folded before Flop
Seat 5: Lucifer999 (small blind) collected ($75)
Seat 6: No username (big blind) folded before Flop



PokerStars Game #00327523177: Hold'em No Limit ($25/$50 USD) - 2022/04/30 09:11:45 ET
Table 'Hold'em (Min 1K Max 5K)   216' 6-max Seat #5 is the button
Seat 1: Lucifer999 ($8561.9 in chips) 
Seat 2: rahulh1 ($4032.33 in chips) 
Seat 3: kash1102 ($5000 in chips) 
Seat 5: Avaroni ($5000 in chips) 
Lucifer999: posts small blind $25
rahulh1: posts big blind $50
*** HOLE CARDS ***
Dealt to Lucifer999 [Ts 4h]
kash1102: raises $100.00 to $150
Avaroni: folds
Lucifer999: folds
rahulh1: folds
Uncalled bet ($100) returned to kash1102
kash1102: doesn't show hand
kash1102 collected $125 from pot
*** SUMMARY ***
Total pot $125.00 | Rake $0
Board []
Seat 1: Lucifer999 (small blind) folded before Flop
Seat 2: rahulh1 (big blind) folded before Flop
Seat 3: kash1102 collected ($125)
Seat 5: Avaroni (button) folded before Flop (didn't bet)



PokerStars Game #00327523225: Hold'em No Limit ($50/$100 USD) - 2022/04/30 09:12:02 ET
Table 'Hold'em (Min 25KMax 10K)    69' 6-max Seat #6 is the button
Seat 1: Lucifer999 ($11180.67 in chips) 
Seat 4: vinuth ($11380.81 in chips) 
Seat 6: binny35 ($10298.9 in chips) 
binny35: posts small blind $50
Lucifer999: posts big blind $100
*** HOLE CARDS ***
Dealt to Lucifer999 [9d Jd]
binny35: raises $100.00 to $200
Lucifer999: raises $500.00 to $700
binny35: folds
Uncalled bet ($500) returned to Lucifer999
Lucifer999: doesn't show hand
Lucifer999 collected $400 from pot
*** SUMMARY ***
Total pot $400.00 | Rake $0
Board []
Seat 1: Lucifer999 (big blind) collected ($400)
Seat 6: binny35 (button) (small blind) folded before Flop



PokerStars Game #00327523180: Hold'em No Limit ($10/$25 USD) - 2022/04/30 09:11:46 ET
Table 'Hold'em (Min 500Max 2500) 1001' 6-max Seat #5 is the button
Seat 1: JaspritBumrah786 ($2015 in chips) 
Seat 2: spaceman47157 ($2405 in chips) 
Seat 3: Mukesh_19 ($695.53 in chips) 
Seat 4: SA754 ($1175.64 in chips) 
Seat 5: Lucifer999 ($4616 in chips) 
Seat 6: spidy02 ($2921.22 in chips) 
spidy02: posts small blind $10
JaspritBumrah786: posts big blind $25
*** HOLE CARDS ***
Dealt to Lucifer999 [2s Qh]
spaceman47157: folds
SA754: calls $25
Lucifer999: folds
spidy02: raises $52.50 to $77.5
JaspritBumrah786: calls $52.5
SA754: calls $52.5
*** FLOP *** [4d 7s 4c]
spidy02: checks
JaspritBumrah786: checks
SA754: checks
*** TURN *** [4d 7s 4c] [9c]
spidy02: bets $163.74
JaspritBumrah786: folds
SA754: folds
Uncalled bet ($163.74) returned to spidy02
spidy02: doesn't show hand
spidy02 collected $218.32 from pot
*** SUMMARY ***
Total pot $232.50 | Rake $14.18
Board [4d 7s 4c 9c]
Seat 1: JaspritBumrah786 (big blind) folded on the Turn
Seat 2: spaceman47157 folded before Flop (didn't bet)
Seat 4: SA754 folded on the Turn
Seat 5: Lucifer999 (button) folded before Flop (didn't bet)
Seat 6: spidy02 (small blind) collected ($218.32)



PokerStars Game #00327523235: Hold'em No Limit ($10/$25 USD) - 2022/04/30 09:12:06 ET
Table 'Hold'em (Min 500Max 2500)  1282' 6-max Seat #5 is the button
Seat 1: PANCHYOU ($898.81 in chips) 
Seat 2: kash1102 ($3466.51 in chips) 
Seat 3: manny007 ($1725.36 in chips) 
Seat 4: Avaroni ($2500 in chips) 
Seat 5: Lucifer999 ($2793.07 in chips) 
Seat 6: No username ($1670.97 in chips) 
No username: posts small blind $10
PANCHYOU: posts big blind $25
*** HOLE CARDS ***
Dealt to Lucifer999 [3h 2h]
kash1102: folds
manny007: calls $25
Lucifer999: folds
No username: folds
PANCHYOU: checks
*** FLOP *** [8s Kc 4d]
PANCHYOU: checks
manny007: bets $56.85
PANCHYOU: folds
Uncalled bet ($56.85) returned to manny007
manny007: doesn't show hand
manny007 collected $56.85 from pot
*** SUMMARY ***
Total pot $60.00 | Rake $3.15
Board [8s Kc 4d]
Seat 1: PANCHYOU (big blind) folded on the Flop
Seat 2: kash1102 folded before Flop (didn't bet)
Seat 3: manny007 collected ($56.85)
Seat 5: Lucifer999 (button) folded before Flop (didn't bet)
Seat 6: No username (small blind) folded before Flop



PokerStars Game #00327523311: Hold'em No Limit ($10/$25 USD) - 2022/04/30 09:12:32 ET
Table 'Hold'em (Min 500Max 2500) 1001' 6-max Seat #6 is the button
Seat 1: JaspritBumrah786 ($1972.5 in chips) 
Seat 2: spaceman47157 ($2405 in chips) 
Seat 3: Mukesh_19 ($695.53 in chips) 
Seat 4: SA754 ($1098.14 in chips) 
Seat 5: Lucifer999 ($4616 in chips) 
Seat 6: spidy02 ($3062.04 in chips) 
JaspritBumrah786: posts small blind $10
spaceman47157: posts big blind $25
*** HOLE CARDS ***
Dealt to Lucifer999 [8c 2c]
SA754: calls $25
Lucifer999: folds
spidy02: folds
JaspritBumrah786: raises $75.00 to $100
spaceman47157: folds
SA754: calls $75
*** FLOP *** [3h Ad 6h]
JaspritBumrah786: bets $175
SA754: folds
Uncalled bet ($175) returned to JaspritBumrah786
JaspritBumrah786: doesn't show hand
JaspritBumrah786 collected $211.19 from pot
*** SUMMARY ***
Total pot $225.00 | Rake $13.81
Board [3h Ad 6h]
Seat 1: JaspritBumrah786 (small blind) collected ($211.19)
Seat 2: spaceman47157 (big blind) folded before Flop
Seat 4: SA754 folded on the Flop
Seat 5: Lucifer999 folded before Flop (didn't bet)
Seat 6: spidy02 (button) folded before Flop (didn't bet)



PokerStars Game #00327523331: Hold'em No Limit ($10/$25 USD) - 2022/04/30 09:12:38 ET
Table 'Hold'em (Min 500Max 2500)  1282' 6-max Seat #6 is the button
Seat 1: PANCHYOU ($873.81 in chips) 
Seat 2: kash1102 ($3466.51 in chips) 
Seat 3: manny007 ($1757.21 in chips) 
Seat 4: Avaroni ($2500 in chips) 
Seat 5: Lucifer999 ($2793.07 in chips) 
Seat 6: No username ($1660.97 in chips) 
PANCHYOU: posts small blind $10
kash1102: posts big blind $25
*** HOLE CARDS ***
Dealt to Lucifer999 [Td 5h]
manny007: calls $25
Lucifer999: folds
No username: folds
PANCHYOU: folds
kash1102: checks
*** FLOP *** [7c 2c 7s]
kash1102: checks
manny007: bets $37.53
kash1102: folds
Uncalled bet ($37.53) returned to manny007
manny007: doesn't show hand
manny007 collected $56.85 from pot
*** SUMMARY ***
Total pot $60.00 | Rake $3.15
Board [7c 2c 7s]
Seat 1: PANCHYOU (small blind) folded before Flop
Seat 2: kash1102 (big blind) folded on the Flop
Seat 3: manny007 collected ($56.85)
Seat 5: Lucifer999 folded before Flop (didn't bet)
Seat 6: No username (button) folded before Flop (didn't bet)



PokerStars Game #00327523252: Hold'em No Limit ($25/$50 USD) - 2022/04/30 09:12:12 ET
Table 'Hold'em (Min 1K Max 5K)   216' 6-max Seat #1 is the button
Seat 1: Lucifer999 ($8536.9 in chips) 
Seat 2: rahulh1 ($3982.33 in chips) 
Seat 3: kash1102 ($5075 in chips) 
Seat 5: Avaroni ($5000 in chips) 
rahulh1: posts small blind $25
kash1102: posts big blind $50
*** HOLE CARDS ***
Dealt to Lucifer999 [4d 2d]
Avaroni: folds
Lucifer999: raises $100.00 to $150
rahulh1: folds
kash1102: calls $100
*** FLOP *** [8s 6s 4h]
kash1102: checks
Lucifer999: bets $225
kash1102: folds
Uncalled bet ($225) returned to Lucifer999
Lucifer999: doesn't show hand
Lucifer999 collected $308.75 from pot
*** SUMMARY ***
Total pot $325.00 | Rake $16.25
Board [8s 6s 4h]
Seat 1: Lucifer999 (button) collected ($308.75)
Seat 2: rahulh1 (small blind) folded before Flop
Seat 3: kash1102 (big blind) folded on the Flop
Seat 5: Avaroni folded before Flop (didn't bet)



PokerStars Game #00327523389: Hold'em No Limit ($10/$25 USD) - 2022/04/30 09:12:57 ET
Table 'Hold'em (Min 500Max 2500) 1001' 6-max Seat #1 is the button
Seat 1: JaspritBumrah786 ($2146.19 in chips) 
Seat 2: spaceman47157 ($2380 in chips) 
Seat 3: Mukesh_19 ($695.53 in chips) 
Seat 4: SA754 ($998.14 in chips) 
Seat 5: Lucifer999 ($4616 in chips) 
Seat 6: spidy02 ($3062.04 in chips) 
spaceman47157: posts small blind $10
SA754: posts big blind $25
*** HOLE CARDS ***
Dealt to Lucifer999 [8c Qs]
Lucifer999: folds
spidy02: folds
JaspritBumrah786: folds
spaceman47157: raises $25.00 to $50
SA754: calls $25
*** FLOP *** [7h Kc Td]
spaceman47157: checks
SA754: checks
*** TURN *** [7h Kc Td] [As]
spaceman47157: bets $93.75
SA754: folds
Uncalled bet ($93.75) returned to spaceman47157
spaceman47157: doesn't show hand
spaceman47157 collected $93.75 from pot
*** SUMMARY ***
Total pot $100.00 | Rake $6.25
Board [7h Kc Td As]
Seat 1: JaspritBumrah786 (button) folded before Flop (didn't bet)
Seat 2: spaceman47157 (small blind) collected ($93.75)
Seat 4: SA754 (big blind) folded on the Turn
Seat 5: Lucifer999 folded before Flop (didn't bet)
Seat 6: spidy02 folded before Flop (didn't bet)



PokerStars Game #00327523458: Hold'em No Limit ($25/$50 USD) - 2022/04/30 09:13:23 ET
Table 'Hold'em (Min 1K Max 5K)   216' 6-max Seat #2 is the button
Seat 1: Lucifer999 ($8695.65 in chips) 
Seat 2: rahulh1 ($3957.33 in chips) 
Seat 3: kash1102 ($4925 in chips) 
Seat 5: Avaroni ($5000 in chips) 
kash1102: posts small blind $25
Avaroni: posts big blind $50
*** HOLE CARDS ***
Dealt to Lucifer999 [7s Tc]
Lucifer999: folds
rahulh1: folds
kash1102: folds
Uncalled bet ($25) returned to Avaroni
Avaroni: doesn't show hand
Avaroni collected $50 from pot
*** SUMMARY ***
Total pot $50.00 | Rake $0
Board []
Seat 1: Lucifer999 folded before Flop (didn't bet)
Seat 2: rahulh1 (button) folded before Flop (didn't bet)
Seat 3: kash1102 (small blind) folded before Flop
Seat 5: Avaroni (big blind) collected ($50)



PokerStars Game #00327523445: Hold'em No Limit ($10/$25 USD) - 2022/04/30 09:13:20 ET
Table 'Hold'em (Min 500Max 2500)  1282' 6-max Seat #1 is the button
Seat 1: PANCHYOU ($863.81 in chips) 
Seat 2: kash1102 ($3441.51 in chips) 
Seat 3: manny007 ($1789.06 in chips) 
Seat 5: Lucifer999 ($2793.07 in chips) 
Seat 6: No username ($1660.97 in chips) 
kash1102: posts small blind $10
manny007: posts big blind $25
*** HOLE CARDS ***
Dealt to Lucifer999 [Jc 6s]
Lucifer999: folds
No username: folds
PANCHYOU: folds
kash1102: folds
Uncalled bet ($15) returned to manny007
manny007: doesn't show hand
manny007 collected $20 from pot
*** SUMMARY ***
Total pot $20.00 | Rake $0
Board []
Seat 1: PANCHYOU (button) folded before Flop (didn't bet)
Seat 2: kash1102 (small blind) folded before Flop
Seat 3: manny007 (big blind) collected ($20)
Seat 5: Lucifer999 folded before Flop (didn't bet)
Seat 6: No username folded before Flop (didn't bet)



PokerStars Game #00327523523: Hold'em No Limit ($25/$50 USD) - 2022/04/30 09:13:42 ET
Table 'Hold'em (Min 1K Max 5K)   216' 6-max Seat #3 is the button
Seat 1: Lucifer999 ($8695.65 in chips) 
Seat 2: rahulh1 ($3957.33 in chips) 
Seat 3: kash1102 ($4900 in chips) 
Seat 5: Avaroni ($5025 in chips) 
Avaroni: posts small blind $25
Lucifer999: posts big blind $50
*** HOLE CARDS ***
Dealt to Lucifer999 [7d 6c]
rahulh1: folds
kash1102: folds
Avaroni: raises $100.00 to $150
Lucifer999: calls $100
*** FLOP *** [Js Ac 8h]
Avaroni: checks
Lucifer999: checks
*** TURN *** [Js Ac 8h] [9h]
Avaroni: checks
Lucifer999: checks
*** RIVER *** [Js Ac 8h 9h] [7s]
Avaroni: checks
Lucifer999: checks
*** SHOW DOWN ***
Avaroni: shows [As 2s] (Pair, AA)
Lucifer999: doesn't show hand
Avaroni collected $285 from pot
*** SUMMARY ***
Total pot $300.00 | Rake $15
Board [Js Ac 8h 9h 7s]
Seat 1: Lucifer999 (big blind) mucked
Seat 2: rahulh1 folded before Flop (didn't bet)
Seat 3: kash1102 (button) folded before Flop (didn't bet)
Seat 5: Avaroni  (small blind) showed [As 2s] and won ($285) with Pair, AA



PokerStars Game #00327523504: Hold'em No Limit ($50/$100 USD) - 2022/04/30 09:13:38 ET
Table 'Hold'em (Min 25KMax 10K)    69' 6-max Seat #1 is the button
Seat 1: Lucifer999 ($11380.67 in chips) 
Seat 4: vinuth ($11380.81 in chips) 
Seat 6: tabby20 ($10868.73 in chips) 
Lucifer999: posts small blind $50
tabby20: posts big blind $100
*** HOLE CARDS ***
Dealt to Lucifer999 [Jd Js]
Lucifer999: raises $100.00 to $200
tabby20: calls $100
*** FLOP *** [5s 2h 3c]
tabby20: checks
Lucifer999: bets $200
tabby20: raises $292.20 to $492.2
Lucifer999: calls $292.2
*** TURN *** [5s 2h 3c] [4s]
tabby20: bets $850
Lucifer999: calls $850
*** RIVER *** [5s 2h 3c 4s] [7h]
tabby20: checks
Lucifer999: checks
*** SHOW DOWN ***
tabby20: shows [5c 5d] (Three of a kind, 555)
Lucifer999: doesn't show hand
tabby20 collected $2964.13 from pot
*** SUMMARY ***
Total pot $3084.40 | Rake $120.27
Board [5s 2h 3c 4s 7h]
Seat 1: Lucifer999 (button) (small blind) mucked
Seat 6: tabby20  (big blind) showed [5c 5d] and won ($2964.13) with Three of a kind, 555



PokerStars Game #00327523678: Hold'em No Limit ($50/$100 USD) - 2022/04/30 09:14:34 ET
Table 'Hold'em (Min 25KMax 10K)    69' 6-max Seat #6 is the button
Seat 1: Lucifer999 ($10000 in chips) 
Seat 4: vinuth ($11380.81 in chips) 
Seat 6: tabby20 ($12290.66 in chips) 
tabby20: posts small blind $50
Lucifer999: posts big blind $100
*** HOLE CARDS ***
Dealt to Lucifer999 [Ah Ks]
tabby20: raises $100.00 to $200
Lucifer999: raises $500.00 to $700
tabby20: folds
Uncalled bet ($500) returned to Lucifer999
Lucifer999: doesn't show hand
Lucifer999 collected $400 from pot
*** SUMMARY ***
Total pot $400.00 | Rake $0
Board []
Seat 1: Lucifer999 (big blind) collected ($400)
Seat 6: tabby20 (button) (small blind) folded before Flop



PokerStars Game #00327523587: Hold'em No Limit ($10/$25 USD) - 2022/04/30 09:14:03 ET
Table 'Hold'em (Min 500Max 2500)  1282' 6-max Seat #2 is the button
Seat 1: PANCHYOU ($863.81 in chips) 
Seat 2: kash1102 ($3431.51 in chips) 
Seat 3: manny007 ($1799.06 in chips) 
Seat 4: foldmybets ($2500 in chips) 
Seat 5: Lucifer999 ($2793.07 in chips) 
Seat 6: No username ($1660.97 in chips) 
manny007: posts small blind $10
foldmybets: posts big blind $25
*** HOLE CARDS ***
Dealt to Lucifer999 [4c 6h]
Lucifer999: folds
No username: folds
PANCHYOU: folds
kash1102: raises $50.00 to $75
manny007: calls $65
foldmybets: raises $225.00 to $300
kash1102: folds
manny007: folds
Uncalled bet ($225) returned to foldmybets
foldmybets: doesn't show hand
foldmybets collected $225 from pot
*** SUMMARY ***
Total pot $225.00 | Rake $0
Board []
Seat 1: PANCHYOU folded before Flop (didn't bet)
Seat 2: kash1102 (button) folded before Flop
Seat 3: manny007 (small blind) folded before Flop
Seat 4: foldmybets (big blind) collected ($225)
Seat 5: Lucifer999 folded before Flop (didn't bet)
Seat 6: No username folded before Flop (didn't bet)



PokerStars Game #00327523489: Hold'em No Limit ($10/$25 USD) - 2022/04/30 09:13:33 ET
Table 'Hold'em (Min 500Max 2500) 1001' 6-max Seat #2 is the button
Seat 1: JaspritBumrah786 ($2146.19 in chips) 
Seat 2: spaceman47157 ($2423.75 in chips) 
Seat 3: Mukesh_19 ($695.53 in chips) 
Seat 4: SA754 ($948.14 in chips) 
Seat 5: Lucifer999 ($4616 in chips) 
Seat 6: spidy02 ($3062.04 in chips) 
SA754: posts small blind $10
Lucifer999: posts big blind $25
*** HOLE CARDS ***
Dealt to Lucifer999 [3c 3h]
spidy02: raises $60.00 to $85
JaspritBumrah786: folds
spaceman47157: folds
SA754: calls $75
Lucifer999: calls $60
*** FLOP *** [Js 4s Qs]
SA754: checks
Lucifer999: checks
spidy02: bets $119.81
SA754: calls $119.81
Lucifer999: folds
*** TURN *** [Js 4s Qs] [4c]
SA754: checks
spidy02: bets $312.49
SA754: calls $312.49
*** RIVER *** [Js 4s Qs 4c] [5h]
SA754: checks
spidy02: bets $527.93
SA754: calls $430.84
Uncalled bet ($97.09) returned to spidy02
*** SHOW DOWN ***
SA754: shows [6h Qh] (Two pairs, QQ44)
spidy02: shows [Ah As] (Two pairs, AA44)
spidy02 collected $1872.28 from pot
*** SUMMARY ***
Total pot $1981.28 | Rake $109
Board [Js 4s Qs 4c 5h]
Seat 1: JaspritBumrah786 folded before Flop (didn't bet)
Seat 2: spaceman47157 (button) folded before Flop (didn't bet)
Seat 4: SA754 (small blind) showed [6h Qh] and lost with Two pairs, QQ44
Seat 5: Lucifer999 (big blind) folded on the Flop
Seat 6: spidy02  showed [Ah As] and won ($1872.28) with Two pairs, AA44



PokerStars Game #00327523642: Hold'em No Limit ($25/$50 USD) - 2022/04/30 09:14:21 ET
Table 'Hold'em (Min 1K Max 5K)   216' 6-max Seat #5 is the button
Seat 1: Lucifer999 ($8545.65 in chips) 
Seat 2: rahulh1 ($3957.33 in chips) 
Seat 3: kash1102 ($4900 in chips) 
Seat 5: Avaroni ($5160 in chips) 
Lucifer999: posts small blind $25
rahulh1: posts big blind $50
*** HOLE CARDS ***
Dealt to Lucifer999 [2h 2c]
kash1102: folds
Avaroni: raises $100.00 to $150
Lucifer999: calls $125
rahulh1: folds
*** FLOP *** [Tc Qs Qd]
Lucifer999: checks
Avaroni: checks
*** TURN *** [Tc Qs Qd] [7d]
Lucifer999: checks
Avaroni: checks
*** RIVER *** [Tc Qs Qd 7d] [9d]
Lucifer999: checks
Avaroni: checks
*** SHOW DOWN ***
Avaroni: shows [5h Ks] (Pair, QQ)
Lucifer999: shows [2h 2c] (Two pairs, QQ22)
Lucifer999 collected $332.5 from pot
*** SUMMARY ***
Total pot $350.00 | Rake $17.5
Board [Tc Qs Qd 7d 9d]
Seat 1: Lucifer999  (small blind) showed [2h 2c] and won ($332.5) with Two pairs, QQ22
Seat 2: rahulh1 (big blind) folded before Flop
Seat 3: kash1102 folded before Flop (didn't bet)
Seat 5: Avaroni (button) showed [5h Ks] and lost with Pair, QQ



PokerStars Game #00327523742: Hold'em No Limit ($50/$100 USD) - 2022/04/30 09:14:54 ET
Table 'Hold'em (Min 25KMax 10K)    69' 6-max Seat #1 is the button
Seat 1: Lucifer999 ($10200 in chips) 
Seat 4: vinuth ($11380.81 in chips) 
Seat 6: tabby20 ($12090.66 in chips) 
Lucifer999: posts small blind $50
tabby20: posts big blind $100
*** HOLE CARDS ***
Dealt to Lucifer999 [Td 7d]
Lucifer999: raises $100.00 to $200
tabby20: calls $100
*** FLOP *** [4c Js 4d]
tabby20: checks
Lucifer999: bets $200
tabby20: folds
Uncalled bet ($200) returned to Lucifer999
Lucifer999: doesn't show hand
Lucifer999 collected $384.4 from pot
*** SUMMARY ***
Total pot $400.00 | Rake $15.6
Board [4c Js 4d]
Seat 1: Lucifer999 (button) (small blind) collected ($384.4)
Seat 6: tabby20 (big blind) folded on the Flop



PokerStars Game #00327523759: Hold'em No Limit ($10/$25 USD) - 2022/04/30 09:15:01 ET
Table 'Hold'em (Min 500Max 2500)  1282' 6-max Seat #3 is the button
Seat 1: PANCHYOU ($863.81 in chips) 
Seat 2: kash1102 ($3356.51 in chips) 
Seat 3: manny007 ($1724.06 in chips) 
Seat 4: foldmybets ($2650 in chips) 
Seat 5: Lucifer999 ($2793.07 in chips) 
Seat 6: No username ($1660.97 in chips) 
foldmybets: posts small blind $10
Lucifer999: posts big blind $25
*** HOLE CARDS ***
Dealt to Lucifer999 [9d Ks]
No username: folds
PANCHYOU: raises $45.00 to $70
kash1102: folds
manny007: raises $51.38 to $121.38
foldmybets: folds
Lucifer999: folds
PANCHYOU: folds
Uncalled bet ($51.38) returned to manny007
manny007: doesn't show hand
manny007 collected $175 from pot
*** SUMMARY ***
Total pot $175.00 | Rake $0
Board []
Seat 1: PANCHYOU folded before Flop
Seat 2: kash1102 folded before Flop (didn't bet)
Seat 3: manny007 (button) collected ($175)
Seat 4: foldmybets (small blind) folded before Flop
Seat 5: Lucifer999 (big blind) folded before Flop
Seat 6: No username folded before Flop (didn't bet)



PokerStars Game #00327523791: Hold'em No Limit ($25/$50 USD) - 2022/04/30 09:15:11 ET
Table 'Hold'em (Min 1K Max 5K)   216' 6-max Seat #1 is the button
Seat 1: Lucifer999 ($8728.15 in chips) 
Seat 2: rahulh1 ($3907.33 in chips) 
Seat 3: kash1102 ($4900 in chips) 
Seat 5: Avaroni ($5010 in chips) 
rahulh1: posts small blind $25
kash1102: posts big blind $50
*** HOLE CARDS ***
Dealt to Lucifer999 [6c Th]
Avaroni: raises $100.00 to $150
Lucifer999: folds
rahulh1: calls $125
kash1102: folds
*** FLOP *** [7h Jd 2h]
rahulh1: checks
Avaroni: bets $200
rahulh1: folds
Uncalled bet ($200) returned to Avaroni
Avaroni: doesn't show hand
Avaroni collected $332.5 from pot
*** SUMMARY ***
Total pot $350.00 | Rake $17.5
Board [7h Jd 2h]
Seat 1: Lucifer999 (button) folded before Flop (didn't bet)
Seat 2: rahulh1 (small blind) folded on the Flop
Seat 3: kash1102 (big blind) folded before Flop
Seat 5: Avaroni collected ($332.5)



PokerStars Game #00327523790: Hold'em No Limit ($10/$25 USD) - 2022/04/30 09:15:11 ET
Table 'Hold'em (Min 500Max 2500) 1001' 6-max Seat #5 is the button
Seat 1: JaspritBumrah786 ($2146.19 in chips) 
Seat 2: spaceman47157 ($2423.75 in chips) 
Seat 3: Mukesh_19 ($695.53 in chips) 
Seat 5: Lucifer999 ($4531 in chips) 
Seat 6: spidy02 ($3986.18 in chips) 
spidy02: posts small blind $10
JaspritBumrah786: posts big blind $25
*** HOLE CARDS ***
Dealt to Lucifer999 [7h Qh]
spaceman47157: folds
Lucifer999: folds
spidy02: raises $50.00 to $75
JaspritBumrah786: calls $50
*** FLOP *** [Qs Tc 6c]
spidy02: checks
JaspritBumrah786: checks
*** TURN *** [Qs Tc 6c] [4c]
spidy02: checks
JaspritBumrah786: bets $125
spidy02: folds
Uncalled bet ($125) returned to JaspritBumrah786
JaspritBumrah786: doesn't show hand
JaspritBumrah786 collected $141.13 from pot
*** SUMMARY ***
Total pot $150.00 | Rake $8.87
Board [Qs Tc 6c 4c]
Seat 1: JaspritBumrah786 (big blind) collected ($141.13)
Seat 2: spaceman47157 folded before Flop (didn't bet)
Seat 5: Lucifer999 (button) folded before Flop (didn't bet)
Seat 6: spidy02 (small blind) folded on the Turn



PokerStars Game #00327523844: Hold'em No Limit ($50/$100 USD) - 2022/04/30 09:15:27 ET
Table 'Hold'em (Min 25KMax 10K)    69' 6-max Seat #6 is the button
Seat 1: Lucifer999 ($10384.4 in chips) 
Seat 2: Baba_Tilteshwar ($5000 in chips) 
Seat 6: tabby20 ($11890.66 in chips) 
Lucifer999: posts small blind $50
Baba_Tilteshwar: posts big blind $100
*** HOLE CARDS ***
Dealt to Lucifer999 [2c 9c]
tabby20: raises $200.00 to $300
Lucifer999: folds
Baba_Tilteshwar: calls $200
*** FLOP *** [8s 3c Kh]
Baba_Tilteshwar: checks
tabby20: checks
*** TURN *** [8s 3c Kh] [8d]
Baba_Tilteshwar: bets $250
tabby20: calls $250
*** RIVER *** [8s 3c Kh 8d] [6h]
Baba_Tilteshwar: bets $450
tabby20: calls $450
*** SHOW DOWN ***
Baba_Tilteshwar: shows [Th 6c] (Two pairs, 8866)
tabby20: doesn't show hand
Baba_Tilteshwar collected $1959.8 from pot
*** SUMMARY ***
Total pot $2050.00 | Rake $90.2
Board [8s 3c Kh 8d 6h]
Seat 1: Lucifer999 (small blind) folded before Flop
Seat 2: Baba_Tilteshwar  (big blind) showed [Th 6c] and won ($1959.8) with Two pairs, 8866
Seat 6: tabby20 (button) mucked



PokerStars Game #00327523949: Hold'em No Limit ($10/$25 USD) - 2022/04/30 09:16:02 ET
Table 'Hold'em (Min 500Max 2500) 1001' 6-max Seat #6 is the button
Seat 1: JaspritBumrah786 ($2291.13 in chips) 
Seat 2: spaceman47157 ($2423.75 in chips) 
Seat 3: Mukesh_19 ($695.53 in chips) 
Seat 5: Lucifer999 ($4531 in chips) 
Seat 6: spidy02 ($3911.18 in chips) 
JaspritBumrah786: posts small blind $10
spaceman47157: posts big blind $25
*** HOLE CARDS ***
Dealt to Lucifer999 [7h Jd]
Lucifer999: folds
spidy02: folds
JaspritBumrah786: folds
Uncalled bet ($15) returned to spaceman47157
spaceman47157: doesn't show hand
spaceman47157 collected $20 from pot
*** SUMMARY ***
Total pot $20.00 | Rake $0
Board []
Seat 1: JaspritBumrah786 (small blind) folded before Flop
Seat 2: spaceman47157 (big blind) collected ($20)
Seat 5: Lucifer999 folded before Flop (didn't bet)
Seat 6: spidy02 (button) folded before Flop (didn't bet)



PokerStars Game #00327523874: Hold'em No Limit ($10/$25 USD) - 2022/04/30 09:15:37 ET
Table 'Hold'em (Min 500Max 2500)  1282' 6-max Seat #4 is the button
Seat 1: PANCHYOU ($793.81 in chips) 
Seat 2: kash1102 ($3356.51 in chips) 
Seat 3: manny007 ($1829.06 in chips) 
Seat 4: foldmybets ($2640 in chips) 
Seat 5: Lucifer999 ($2768.07 in chips) 
Seat 6: No username ($1660.97 in chips) 
Lucifer999: posts small blind $10
No username: posts big blind $25
*** HOLE CARDS ***
Dealt to Lucifer999 [Qh 7d]
PANCHYOU: folds
kash1102: folds
manny007: folds
foldmybets: raises $50.00 to $75
Lucifer999: folds
No username: calls $50
*** FLOP *** [9d Ts 4s]
No username: checks
foldmybets: checks
*** TURN *** [9d Ts 4s] [5h]
No username: checks
foldmybets: checks
*** RIVER *** [9d Ts 4s 5h] [Ks]
No username: checks
foldmybets: bets $100
No username: folds
Uncalled bet ($100) returned to foldmybets
foldmybets: doesn't show hand
foldmybets collected $150.6 from pot
*** SUMMARY ***
Total pot $160.00 | Rake $9.4
Board [9d Ts 4s 5h Ks]
Seat 1: PANCHYOU folded before Flop (didn't bet)
Seat 2: kash1102 folded before Flop (didn't bet)
Seat 3: manny007 folded before Flop (didn't bet)
Seat 4: foldmybets (button) collected ($150.6)
Seat 5: Lucifer999 (small blind) folded before Flop
Seat 6: No username (big blind) folded on the River



PokerStars Game #00327523991: Hold'em No Limit ($50/$100 USD) - 2022/04/30 09:16:17 ET
Table 'Hold'em (Min 25KMax 10K)    69' 6-max Seat #1 is the button
Seat 1: Lucifer999 ($10334.4 in chips) 
Seat 2: Baba_Tilteshwar ($5959.8 in chips) 
Seat 6: tabby20 ($10890.66 in chips) 
Lucifer999: posts small blind $50
Baba_Tilteshwar: posts big blind $100
*** HOLE CARDS ***
Dealt to Lucifer999 [5d Jd]
Lucifer999: calls $50
Baba_Tilteshwar: checks
*** FLOP *** [8s 2c 4h]
Baba_Tilteshwar: checks
Lucifer999: bets $150
Baba_Tilteshwar: folds
Uncalled bet ($150) returned to Lucifer999
Lucifer999: doesn't show hand
Lucifer999 collected $192.2 from pot
*** SUMMARY ***
Total pot $200.00 | Rake $7.8
Board [8s 2c 4h]
Seat 1: Lucifer999 (button) (small blind) collected ($192.2)
Seat 2: Baba_Tilteshwar (big blind) folded on the Flop



PokerStars Game #00327523940: Hold'em No Limit ($25/$50 USD) - 2022/04/30 09:16:00 ET
Table 'Hold'em (Min 1K Max 5K)   216' 6-max Seat #2 is the button
Seat 1: Lucifer999 ($8728.15 in chips) 
Seat 2: rahulh1 ($3757.33 in chips) 
Seat 3: kash1102 ($4850 in chips) 
Seat 5: Avaroni ($5192.5 in chips) 
kash1102: posts small blind $25
Avaroni: posts big blind $50
*** HOLE CARDS ***
Dealt to Lucifer999 [Jd Jc]
Lucifer999: calls $50
rahulh1: raises $86.90 to $136.9
kash1102: folds
Avaroni: folds
Lucifer999: raises $238.10 to $375
rahulh1: calls $238.1
*** FLOP *** [2c 3s 5d]
Lucifer999: bets $500
rahulh1: folds
Uncalled bet ($500) returned to Lucifer999
Lucifer999: doesn't show hand
Lucifer999 collected $783.75 from pot
*** SUMMARY ***
Total pot $825.00 | Rake $41.25
Board [2c 3s 5d]
Seat 1: Lucifer999 collected ($783.75)
Seat 2: rahulh1 (button) folded on the Flop
Seat 3: kash1102 (small blind) folded before Flop
Seat 5: Avaroni (big blind) folded before Flop



PokerStars Game #00327524011: Hold'em No Limit ($10/$25 USD) - 2022/04/30 09:16:24 ET
Table 'Hold'em (Min 500Max 2500) 1001' 6-max Seat #1 is the button
Seat 1: JaspritBumrah786 ($2281.13 in chips) 
Seat 2: spaceman47157 ($2433.75 in chips) 
Seat 3: Mukesh_19 ($695.53 in chips) 
Seat 5: Lucifer999 ($4531 in chips) 
Seat 6: spidy02 ($3911.18 in chips) 
spaceman47157: posts small blind $10
Mukesh_19: posts big blind $25
*** HOLE CARDS ***
Dealt to Lucifer999 [Ac 5d]
Lucifer999: folds
spidy02: folds
JaspritBumrah786: folds
spaceman47157: raises $25.00 to $50
Mukesh_19: calls $25
*** FLOP *** [3s 7c 7h]
spaceman47157: checks
Mukesh_19: bets $93.75
spaceman47157: calls $93.75
*** TURN *** [3s 7c 7h] [Qs]
spaceman47157: bets $270.44
Mukesh_19: calls $270.44
*** RIVER *** [3s 7c 7h Qs] [9h]
spaceman47157: bets $779.91
Mukesh_19: calls $281.34
Uncalled bet ($498.57) returned to spaceman47157
*** SHOW DOWN ***
spaceman47157: shows [8d 7d] (Three of a kind, 777)
Mukesh_19: shows [As 3c] (Two pairs, 7733)
spaceman47157 collected $1313.04 from pot
*** SUMMARY ***
Total pot $1391.06 | Rake $78.02
Board [3s 7c 7h Qs 9h]
Seat 1: JaspritBumrah786 (button) folded before Flop (didn't bet)
Seat 2: spaceman47157  (small blind) showed [8d 7d] and won ($1313.04) with Three of a kind, 777
Seat 3: Mukesh_19 (big blind) showed [As 3c] and lost with Two pairs, 7733
Seat 5: Lucifer999 folded before Flop (didn't bet)
Seat 6: spidy02 folded before Flop (didn't bet)



PokerStars Game #00327524061: Hold'em No Limit ($10/$25 USD) - 2022/04/30 09:16:39 ET
Table 'Hold'em (Min 500Max 2500)  1282' 6-max Seat #5 is the button
Seat 1: PANCHYOU ($793.81 in chips) 
Seat 2: kash1102 ($3356.51 in chips) 
Seat 3: manny007 ($1829.06 in chips) 
Seat 4: foldmybets ($2715.6 in chips) 
Seat 5: Lucifer999 ($2758.07 in chips) 
Seat 6: No username ($1585.97 in chips) 
No username: posts small blind $10
PANCHYOU: posts big blind $25
*** HOLE CARDS ***
Dealt to Lucifer999 [Jh Qh]
kash1102: folds
manny007: calls $25
foldmybets: folds
Lucifer999: raises $85.00 to $110
No username: folds
PANCHYOU: folds
manny007: calls $85
*** FLOP *** [4c 7s 6d]
manny007: bets $239.62
Lucifer999: folds
Uncalled bet ($239.62) returned to manny007
manny007: doesn't show hand
manny007 collected $239.62 from pot
*** SUMMARY ***
Total pot $255.00 | Rake $15.38
Board [4c 7s 6d]
Seat 1: PANCHYOU (big blind) folded before Flop
Seat 2: kash1102 folded before Flop (didn't bet)
Seat 3: manny007 collected ($239.62)
Seat 4: foldmybets folded before Flop (didn't bet)
Seat 5: Lucifer999 (button) folded on the Flop
Seat 6: No username (small blind) folded before Flop



PokerStars Game #00327524098: Hold'em No Limit ($50/$100 USD) - 2022/04/30 09:16:49 ET
Table 'Hold'em (Min 25KMax 10K)    69' 6-max Seat #2 is the button
Seat 1: Lucifer999 ($10426.6 in chips) 
Seat 2: Baba_Tilteshwar ($5859.8 in chips) 
Seat 6: tabby20 ($10890.66 in chips) 
tabby20: posts small blind $50
Lucifer999: posts big blind $100
*** HOLE CARDS ***
Dealt to Lucifer999 [2c 2s]
Baba_Tilteshwar: raises $200.00 to $300
tabby20: folds
Lucifer999: calls $200
*** FLOP *** [4h 5c 5h]
Lucifer999: checks
Baba_Tilteshwar: bets $250
Lucifer999: calls $250
*** TURN *** [4h 5c 5h] [6d]
Lucifer999: checks
Baba_Tilteshwar: bets $400
Lucifer999: calls $400
*** RIVER *** [4h 5c 5h 6d] [7h]
Lucifer999: checks
Baba_Tilteshwar: bets $1032.1
Lucifer999: folds
Uncalled bet ($1032.1) returned to Baba_Tilteshwar
Baba_Tilteshwar: doesn't show hand
Baba_Tilteshwar collected $1864.2 from pot
*** SUMMARY ***
Total pot $1950.00 | Rake $85.8
Board [4h 5c 5h 6d 7h]
Seat 1: Lucifer999 (big blind) folded on the River
Seat 2: Baba_Tilteshwar (button) collected ($1864.2)
Seat 6: tabby20 (small blind) folded before Flop



PokerStars Game #00327524099: Hold'em No Limit ($25/$50 USD) - 2022/04/30 09:16:50 ET
Table 'Hold'em (Min 1K Max 5K)   216' 6-max Seat #3 is the button
Seat 1: Lucifer999 ($9136.9 in chips) 
Seat 2: rahulh1 ($3382.33 in chips) 
Seat 3: kash1102 ($4825 in chips) 
Seat 5: Avaroni ($5142.5 in chips) 
Avaroni: posts small blind $25
Lucifer999: posts big blind $50
*** HOLE CARDS ***
Dealt to Lucifer999 [Jc 2c]
rahulh1: folds
kash1102: folds
Avaroni: raises $100.00 to $150
Lucifer999: calls $100
*** FLOP *** [3c 4h Jh]
Avaroni: checks
Lucifer999: bets $200
Avaroni: calls $200
*** TURN *** [3c 4h Jh] [9c]
Avaroni: checks
Lucifer999: bets $500
Avaroni: folds
Uncalled bet ($500) returned to Lucifer999
Lucifer999: doesn't show hand
Lucifer999 collected $665 from pot
*** SUMMARY ***
Total pot $700.00 | Rake $35
Board [3c 4h Jh 9c]
Seat 1: Lucifer999 (big blind) collected ($665)
Seat 2: rahulh1 folded before Flop (didn't bet)
Seat 3: kash1102 (button) folded before Flop (didn't bet)
Seat 5: Avaroni (small blind) folded on the Turn



PokerStars Game #00327524171: Hold'em No Limit ($10/$25 USD) - 2022/04/30 09:17:13 ET
Table 'Hold'em (Min 500Max 2500) 1001' 6-max Seat #2 is the button
Seat 1: JaspritBumrah786 ($2281.13 in chips) 
Seat 2: spaceman47157 ($3051.26 in chips) 
Seat 3: Mukesh_19 ($590.17 in chips) 
Seat 5: Lucifer999 ($4531 in chips) 
Seat 6: spidy02 ($3911.18 in chips) 
Lucifer999: posts small blind $10
spidy02: posts big blind $25
*** HOLE CARDS ***
Dealt to Lucifer999 [8s 5h]
JaspritBumrah786: folds
spaceman47157: calls $25
Lucifer999: folds
spidy02: raises $60.00 to $85
spaceman47157: calls $60
*** FLOP *** [3c 2c 8c]
spidy02: checks
spaceman47157: checks
*** TURN *** [3c 2c 8c] [8d]
spidy02: checks
spaceman47157: bets $84.78
spidy02: folds
Uncalled bet ($84.78) returned to spaceman47157
spaceman47157: doesn't show hand
spaceman47157 collected $169.55 from pot
*** SUMMARY ***
Total pot $180.00 | Rake $10.45
Board [3c 2c 8c 8d]
Seat 1: JaspritBumrah786 folded before Flop (didn't bet)
Seat 2: spaceman47157 (button) collected ($169.55)
Seat 5: Lucifer999 (small blind) folded before Flop
Seat 6: spidy02 (big blind) folded on the Turn



PokerStars Game #00327524270: Hold'em No Limit ($50/$100 USD) - 2022/04/30 09:17:51 ET
Table 'Hold'em (Min 25KMax 10K)    69' 6-max Seat #6 is the button
Seat 1: Lucifer999 ($10000 in chips) 
Seat 2: Baba_Tilteshwar ($6774 in chips) 
Seat 6: tabby20 ($10840.66 in chips) 
Lucifer999: posts small blind $50
Baba_Tilteshwar: posts big blind $100
*** HOLE CARDS ***
Dealt to Lucifer999 [Kh 5c]
tabby20: raises $200.00 to $300
Lucifer999: folds
Baba_Tilteshwar: raises $650.00 to $950
tabby20: folds
Uncalled bet ($650) returned to Baba_Tilteshwar
Baba_Tilteshwar: doesn't show hand
Baba_Tilteshwar collected $650 from pot
*** SUMMARY ***
Total pot $650.00 | Rake $0
Board []
Seat 1: Lucifer999 (small blind) folded before Flop
Seat 2: Baba_Tilteshwar (big blind) collected ($650)
Seat 6: tabby20 (button) folded before Flop



PokerStars Game #00327524278: Hold'em No Limit ($25/$50 USD) - 2022/04/30 09:17:53 ET
Table 'Hold'em (Min 1K Max 5K)   216' 6-max Seat #5 is the button
Seat 1: Lucifer999 ($9451.9 in chips) 
Seat 2: rahulh1 ($3382.33 in chips) 
Seat 3: kash1102 ($4825 in chips) 
Seat 5: Avaroni ($5000 in chips) 
Lucifer999: posts small blind $25
rahulh1: posts big blind $50
*** HOLE CARDS ***
Dealt to Lucifer999 [9h 3s]
kash1102: raises $100.00 to $150
Avaroni: folds
Lucifer999: folds
rahulh1: calls $100
*** FLOP *** [9s Jd Qh]
rahulh1: checks
kash1102: bets $154.38
rahulh1: folds
Uncalled bet ($154.38) returned to kash1102
kash1102: doesn't show hand
kash1102 collected $308.75 from pot
*** SUMMARY ***
Total pot $325.00 | Rake $16.25
Board [9s Jd Qh]
Seat 1: Lucifer999 (small blind) folded before Flop
Seat 2: rahulh1 (big blind) folded on the Flop
Seat 3: kash1102 collected ($308.75)
Seat 5: Avaroni (button) folded before Flop (didn't bet)



PokerStars Game #00327524310: Hold'em No Limit ($10/$25 USD) - 2022/04/30 09:18:04 ET
Table 'Hold'em (Min 500Max 2500) 1001' 6-max Seat #5 is the button
Seat 1: JaspritBumrah786 ($2281.13 in chips) 
Seat 2: spaceman47157 ($3135.81 in chips) 
Seat 3: Mukesh_19 ($590.17 in chips) 
Seat 5: Lucifer999 ($4521 in chips) 
Seat 6: spidy02 ($3826.18 in chips) 
spidy02: posts small blind $10
JaspritBumrah786: posts big blind $25
Mukesh_19: posts small blind $10
*** HOLE CARDS ***
Dealt to Lucifer999 [Jc 6c]
spaceman47157: calls $25
Mukesh_19: raises $85.00 to $110
Lucifer999: folds
spidy02: folds
JaspritBumrah786: folds
spaceman47157: calls $85
*** FLOP *** [Ac 7d Qh]
spaceman47157: checks
Mukesh_19: bets $239.62
spaceman47157: folds
Uncalled bet ($239.62) returned to Mukesh_19
Mukesh_19: doesn't show hand
Mukesh_19 collected $239.62 from pot
*** SUMMARY ***
Total pot $255.00 | Rake $15.38
Board [Ac 7d Qh]
Seat 1: JaspritBumrah786 (big blind) folded before Flop
Seat 2: spaceman47157 folded on the Flop
Seat 3: Mukesh_19 collected ($239.62)
Seat 5: Lucifer999 (button) folded before Flop (didn't bet)
Seat 6: spidy02 (small blind) folded before Flop



PokerStars Game #00327524358: Hold'em No Limit ($50/$100 USD) - 2022/04/30 09:18:20 ET
Table 'Hold'em (Min 25KMax 10K)    69' 6-max Seat #1 is the button
Seat 1: Lucifer999 ($10000 in chips) 
Seat 2: Baba_Tilteshwar ($7124 in chips) 
Seat 6: tabby20 ($10540.66 in chips) 
Baba_Tilteshwar: posts small blind $50
tabby20: posts big blind $100
*** HOLE CARDS ***
Dealt to Lucifer999 [Tc Ah]
Lucifer999: raises $200.00 to $300
Baba_Tilteshwar: calls $250
tabby20: folds
*** FLOP *** [Ts 4d Kh]
Baba_Tilteshwar: checks
Lucifer999: checks
*** TURN *** [Ts 4d Kh] [As]
Baba_Tilteshwar: checks
Lucifer999: bets $500
Baba_Tilteshwar: folds
Uncalled bet ($500) returned to Lucifer999
Lucifer999: doesn't show hand
Lucifer999 collected $669.2 from pot
*** SUMMARY ***
Total pot $700.00 | Rake $30.8
Board [Ts 4d Kh As]
Seat 1: Lucifer999 (button) collected ($669.2)
Seat 2: Baba_Tilteshwar (small blind) folded on the Turn
Seat 6: tabby20 (big blind) folded before Flop



PokerStars Game #00327524485: Hold'em No Limit ($50/$100 USD) - 2022/04/30 09:19:06 ET
Table 'Hold'em (Min 25KMax 10K)    69' 6-max Seat #2 is the button
Seat 1: Lucifer999 ($10369.2 in chips) 
Seat 2: Baba_Tilteshwar ($6824 in chips) 
Seat 3: Pablit0 ($2500 in chips) 
Seat 6: tabby20 ($10440.66 in chips) 
tabby20: posts small blind $50
Lucifer999: posts big blind $100
*** HOLE CARDS ***
Dealt to Lucifer999 [9c Th]
Baba_Tilteshwar: folds
tabby20: folds
Uncalled bet ($50) returned to Lucifer999
Lucifer999: doesn't show hand
Lucifer999 collected $100 from pot
*** SUMMARY ***
Total pot $100.00 | Rake $0
Board []
Seat 1: Lucifer999 (big blind) collected ($100)
Seat 2: Baba_Tilteshwar (button) folded before Flop (didn't bet)
Seat 6: tabby20 (small blind) folded before Flop



PokerStars Game #00327524391: Hold'em No Limit ($25/$50 USD) - 2022/04/30 09:18:31 ET
Table 'Hold'em (Min 1K Max 5K)   216' 6-max Seat #1 is the button
Seat 1: Lucifer999 ($9426.9 in chips) 
Seat 2: rahulh1 ($3232.33 in chips) 
Seat 3: kash1102 ($4983.75 in chips) 
Seat 5: Avaroni ($5000 in chips) 
rahulh1: posts small blind $25
kash1102: posts big blind $50
*** HOLE CARDS ***
Dealt to Lucifer999 [4h 2d]
Avaroni: raises $100.00 to $150
Lucifer999: folds
rahulh1: folds
kash1102: calls $100
*** FLOP *** [3s 8c Jc]
kash1102: checks
Avaroni: checks
*** TURN *** [3s 8c Jc] [9c]
kash1102: checks
Avaroni: checks
*** RIVER *** [3s 8c Jc 9c] [7d]
kash1102: checks
Avaroni: checks
*** SHOW DOWN ***
Avaroni: shows [5d 3d] (Pair, 33)
kash1102: doesn't show hand
Avaroni collected $308.75 from pot
*** SUMMARY ***
Total pot $325.00 | Rake $16.25
Board [3s 8c Jc 9c 7d]
Seat 1: Lucifer999 (button) folded before Flop (didn't bet)
Seat 2: rahulh1 (small blind) folded before Flop
Seat 3: kash1102 (big blind) mucked
Seat 5: Avaroni  showed [5d 3d] and won ($308.75) with Pair, 33



PokerStars Game #00327524173: Hold'em No Limit ($10/$25 USD) - 2022/04/30 09:17:15 ET
Table 'Hold'em (Min 500Max 2500)  1282' 6-max Seat #6 is the button
Seat 1: PANCHYOU ($768.81 in chips) 
Seat 2: kash1102 ($3356.51 in chips) 
Seat 3: manny007 ($1958.68 in chips) 
Seat 4: foldmybets ($2715.6 in chips) 
Seat 5: Lucifer999 ($2648.07 in chips) 
Seat 6: No username ($1575.97 in chips) 
PANCHYOU: posts small blind $10
kash1102: posts big blind $25
*** HOLE CARDS ***
Dealt to Lucifer999 [Td 5d]
manny007: calls $25
foldmybets: folds
Lucifer999: folds
No username: folds
PANCHYOU: calls $15
kash1102: checks
*** FLOP *** [Jh 4s 6s]
PANCHYOU: checks
kash1102: checks
manny007: checks
*** TURN *** [Jh 4s 6s] [2d]
PANCHYOU: checks
kash1102: checks
manny007: checks
*** RIVER *** [Jh 4s 6s 2d] [3h]
PANCHYOU: checks
kash1102: checks
manny007: checks
*** SHOW DOWN ***
PANCHYOU: shows [Ks Qd] (High card, K)
kash1102: doesn't show hand
manny007: doesn't show hand
PANCHYOU collected $71.07 from pot
*** SUMMARY ***
Total pot $75.00 | Rake $3.93
Board [Jh 4s 6s 2d 3h]
Seat 1: PANCHYOU  (small blind) showed [Ks Qd] and won ($71.07) with High card, K
Seat 2: kash1102 (big blind) mucked
Seat 3: manny007 mucked
Seat 4: foldmybets folded before Flop (didn't bet)
Seat 5: Lucifer999 folded before Flop (didn't bet)
Seat 6: No username (button) folded before Flop (didn't bet)



PokerStars Game #00327524446: Hold'em No Limit ($10/$25 USD) - 2022/04/30 09:18:51 ET
Table 'Hold'em (Min 500Max 2500) 1001' 6-max Seat #6 is the button
Seat 1: JaspritBumrah786 ($2256.13 in chips) 
Seat 2: spaceman47157 ($3025.81 in chips) 
Seat 3: Mukesh_19 ($719.79 in chips) 
Seat 4: devi7 ($2500 in chips) 
Seat 5: Lucifer999 ($4521 in chips) 
Seat 6: spidy02 ($3816.18 in chips) 
JaspritBumrah786: posts small blind $10
spaceman47157: posts big blind $25
*** HOLE CARDS ***
Dealt to Lucifer999 [Jh Qs]
Mukesh_19: raises $60.00 to $85
Lucifer999: folds
spidy02: folds
JaspritBumrah786: folds
spaceman47157: calls $60
*** FLOP *** [4c 7s 6c]
spaceman47157: checks
Mukesh_19: bets $169.55
spaceman47157: raises $2771.26 to $2940.81
Mukesh_19: calls $465.24
Uncalled bet ($2306.02) returned to spaceman47157
*** TURN *** [4c 7s 6c] [Ac]
*** RIVER *** [4c 7s 6c Ac] [Qd]
*** SHOW DOWN ***
spaceman47157: shows [7h Jd] (Pair, 77)
Mukesh_19: shows [8h 8s] (Pair, 88)
Mukesh_19 collected $1368.51 from pot
*** SUMMARY ***
Total pot $1449.58 | Rake $81.07
Board [4c 7s 6c Ac Qd]
Seat 1: JaspritBumrah786 (small blind) folded before Flop
Seat 2: spaceman47157 (big blind) showed [7h Jd] and lost with Pair, 77
Seat 3: Mukesh_19  showed [8h 8s] and won ($1368.51) with Pair, 88
Seat 5: Lucifer999 folded before Flop (didn't bet)
Seat 6: spidy02 (button) folded before Flop (didn't bet)



PokerStars Game #00327524523: Hold'em No Limit ($10/$25 USD) - 2022/04/30 09:19:21 ET
Table 'Hold'em (Min 500Max 2500)  1282' 6-max Seat #2 is the button
Seat 1: PANCHYOU ($814.88 in chips) 
Seat 2: kash1102 ($3331.51 in chips) 
Seat 3: manny007 ($1933.68 in chips) 
Seat 4: foldmybets ($2715.6 in chips) 
Seat 5: Lucifer999 ($2648.07 in chips) 
Seat 6: No username ($1575.97 in chips) 
manny007: posts small blind $10
foldmybets: posts big blind $25
*** HOLE CARDS ***
Dealt to Lucifer999 [3c Jh]
Lucifer999: folds
PANCHYOU: folds
kash1102: folds
manny007: calls $15
foldmybets: raises $75.00 to $100
manny007: folds
Uncalled bet ($75) returned to foldmybets
foldmybets: doesn't show hand
foldmybets collected $50 from pot
*** SUMMARY ***
Total pot $50.00 | Rake $0
Board []
Seat 1: PANCHYOU folded before Flop (didn't bet)
Seat 2: kash1102 (button) folded before Flop (didn't bet)
Seat 3: manny007 (small blind) folded before Flop
Seat 4: foldmybets (big blind) collected ($50)
Seat 5: Lucifer999 folded before Flop (didn't bet)



PokerStars Game #00327524521: Hold'em No Limit ($25/$50 USD) - 2022/04/30 09:19:21 ET
Table 'Hold'em (Min 1K Max 5K)   216' 6-max Seat #2 is the button
Seat 1: Lucifer999 ($9426.9 in chips) 
Seat 2: rahulh1 ($3207.33 in chips) 
Seat 3: kash1102 ($4833.75 in chips) 
Seat 5: Avaroni ($5158.75 in chips) 
kash1102: posts small blind $25
Avaroni: posts big blind $50
*** HOLE CARDS ***
Dealt to Lucifer999 [9d 9h]
Lucifer999: calls $50
rahulh1: folds
kash1102: folds
Avaroni: checks
*** FLOP *** [As 6d 7s]
Avaroni: checks
Lucifer999: checks
*** TURN *** [As 6d 7s] [7h]
Avaroni: bets $100
Lucifer999: calls $100
*** RIVER *** [As 6d 7s 7h] [6s]
Avaroni: checks
Lucifer999: checks
*** SHOW DOWN ***
Avaroni: shows [Ks 4c] (Two pairs, 7766)
Lucifer999: shows [9d 9h] (Two pairs, 9977)
Lucifer999 collected $308.75 from pot
*** SUMMARY ***
Total pot $325.00 | Rake $16.25
Board [As 6d 7s 7h 6s]
Seat 1: Lucifer999  showed [9d 9h] and won ($308.75) with Two pairs, 9977
Seat 2: rahulh1 (button) folded before Flop (didn't bet)
Seat 3: kash1102 (small blind) folded before Flop
Seat 5: Avaroni (big blind) showed [Ks 4c] and lost with Two pairs, 7766



PokerStars Game #00327524552: Hold'em No Limit ($10/$25 USD) - 2022/04/30 09:19:30 ET
Table 'Hold'em (Min 500Max 2500) 1001' 6-max Seat #1 is the button
Seat 1: JaspritBumrah786 ($2246.13 in chips) 
Seat 2: spaceman47157 ($2306.02 in chips) 
Seat 3: Mukesh_19 ($1368.51 in chips) 
Seat 4: devi7 ($2500 in chips) 
Seat 5: Lucifer999 ($4521 in chips) 
Seat 6: spidy02 ($3816.18 in chips) 
spaceman47157: posts small blind $10
Mukesh_19: posts big blind $25
*** HOLE CARDS ***
Dealt to Lucifer999 [Qh 3s]
Lucifer999: folds
spidy02: folds
JaspritBumrah786: folds
spaceman47157: calls $15
Mukesh_19: checks
*** FLOP *** [Td 8s 4h]
spaceman47157: checks
Mukesh_19: checks
*** TURN *** [Td 8s 4h] [8h]
spaceman47157: bets $47.38
Mukesh_19: folds
Uncalled bet ($47.38) returned to spaceman47157
spaceman47157: doesn't show hand
spaceman47157 collected $47.38 from pot
*** SUMMARY ***
Total pot $50.00 | Rake $2.62
Board [Td 8s 4h 8h]
Seat 1: JaspritBumrah786 (button) folded before Flop (didn't bet)
Seat 2: spaceman47157 (small blind) collected ($47.38)
Seat 3: Mukesh_19 (big blind) folded on the Turn
Seat 5: Lucifer999 folded before Flop (didn't bet)
Seat 6: spidy02 folded before Flop (didn't bet)



PokerStars Game #00327524506: Hold'em No Limit ($50/$100 USD) - 2022/04/30 09:19:15 ET
Table 'Hold'em (Min 25KMax 10K)    69' 6-max Seat #6 is the button
Seat 1: Lucifer999 ($10419.2 in chips) 
Seat 2: Baba_Tilteshwar ($6824 in chips) 
Seat 3: Pablit0 ($2500 in chips) 
Seat 6: tabby20 ($10390.66 in chips) 
Lucifer999: posts small blind $50
Baba_Tilteshwar: posts big blind $100
*** HOLE CARDS ***
Dealt to Lucifer999 [8d 6d]
Pablit0: checks
tabby20: folds
Lucifer999: calls $50
Baba_Tilteshwar: checks
*** FLOP *** [7c Jd 4d]
Lucifer999: checks
Baba_Tilteshwar: bets $200
Pablit0: calls $200
Lucifer999: calls $200
*** TURN *** [7c Jd 4d] [3d]
Lucifer999: checks
Baba_Tilteshwar: bets $450
Pablit0: folds
Lucifer999: raises $700.00 to $1150
Baba_Tilteshwar: calls $700
*** RIVER *** [7c Jd 4d 3d] [Qh]
Lucifer999: bets $8969.2
Baba_Tilteshwar: folds
Uncalled bet ($8969.2) returned to Lucifer999
Lucifer999: doesn't show hand
Lucifer999 collected $3059.2 from pot
*** SUMMARY ***
Total pot $3200.00 | Rake $140.8
Board [7c Jd 4d 3d Qh]
Seat 1: Lucifer999 (small blind) collected ($3059.2)
Seat 2: Baba_Tilteshwar (big blind) folded on the River
Seat 3: Pablit0 folded on the Turn
Seat 6: tabby20 (button) folded before Flop (didn't bet)



PokerStars Game #00327524608: Hold'em No Limit ($10/$25 USD) - 2022/04/30 09:19:51 ET
Table 'Hold'em (Min 500Max 2500)  1282' 6-max Seat #3 is the button
Seat 1: PANCHYOU ($814.88 in chips) 
Seat 2: kash1102 ($3331.51 in chips) 
Seat 3: manny007 ($1908.68 in chips) 
Seat 4: foldmybets ($2740.6 in chips) 
Seat 5: Lucifer999 ($2648.07 in chips) 
Seat 6: No username ($1575.97 in chips) 
foldmybets: posts small blind $10
Lucifer999: posts big blind $25
*** HOLE CARDS ***
Dealt to Lucifer999 [Ac Qs]
No username: folds
PANCHYOU: folds
kash1102: folds
manny007: raises $34.64 to $59.64
foldmybets: folds
Lucifer999: calls $34.64
*** FLOP *** [7s 8s 3s]
Lucifer999: checks
manny007: checks
*** TURN *** [7s 8s 3s] [As]
Lucifer999: bets $90
manny007: folds
Uncalled bet ($90) returned to Lucifer999
Lucifer999: doesn't show hand
Lucifer999 collected $121.51 from pot
*** SUMMARY ***
Total pot $129.28 | Rake $7.77
Board [7s 8s 3s As]
Seat 1: PANCHYOU folded before Flop (didn't bet)
Seat 2: kash1102 folded before Flop (didn't bet)
Seat 3: manny007 (button) folded on the Turn
Seat 4: foldmybets (small blind) folded before Flop
Seat 5: Lucifer999 (big blind) collected ($121.51)
Seat 6: No username folded before Flop (didn't bet)



PokerStars Game #00327524682: Hold'em No Limit ($25/$50 USD) - 2022/04/30 09:20:19 ET
Table 'Hold'em (Min 1K Max 5K)   216' 6-max Seat #3 is the button
Seat 1: Lucifer999 ($9585.65 in chips) 
Seat 2: rahulh1 ($3207.33 in chips) 
Seat 3: kash1102 ($4808.75 in chips) 
Seat 5: Avaroni ($5008.75 in chips) 
Avaroni: posts small blind $25
Lucifer999: posts big blind $50
*** HOLE CARDS ***
Dealt to Lucifer999 [Kh Ah]
rahulh1: calls $50
kash1102: folds
Avaroni: folds
Lucifer999: raises $150.00 to $200
rahulh1: raises $220.96 to $420.96
Lucifer999: raises $429.04 to $850
rahulh1: calls $429.04
*** FLOP *** [2d 5h 8c]
Lucifer999: checks
rahulh1: bets $1638.75
Lucifer999: raises $1638.75 to $3277.5
rahulh1: calls $718.58
Uncalled bet ($920.17) returned to Lucifer999
*** TURN *** [2d 5h 8c] [Jc]
*** TURN *** [2d 5h 8c] [4s]
*** RIVER *** [2d 5h 8c Jc] [7s]
*** RIVER *** [2d 5h 8c Jc] [Ad]
*** SHOW DOWN ***
Lucifer999: shows [Kh Ah] (Pair, AA)
rahulh1: shows [Qc Qh] (Pair, QQ)
rahulh1 collected $3075.33 from pot
Lucifer999 collected $3075.33 from pot
*** SUMMARY ***
Total pot $6439.66 | Rake $289
Board [2d 5h 8c Jc 7s]
Seat 1: Lucifer999  (big blind) showed [Kh Ah] and won ($3075.33) with Pair, AA
Seat 2: rahulh1  showed [Qc Qh] and won ($3075.33) with Pair, QQ
Seat 3: kash1102 (button) folded before Flop (didn't bet)
Seat 5: Avaroni (small blind) folded before Flop



PokerStars Game #00327524695: Hold'em No Limit ($10/$25 USD) - 2022/04/30 09:20:22 ET
Table 'Hold'em (Min 500Max 2500) 1001' 6-max Seat #2 is the button
Seat 1: JaspritBumrah786 ($2246.13 in chips) 
Seat 2: spaceman47157 ($2328.4 in chips) 
Seat 3: Mukesh_19 ($1343.51 in chips) 
Seat 4: devi7 ($2500 in chips) 
Seat 5: Lucifer999 ($4521 in chips) 
Seat 6: spidy02 ($3816.18 in chips) 
Mukesh_19: posts small blind $10
devi7: posts big blind $25
*** HOLE CARDS ***
Dealt to Lucifer999 [9d 5h]
Lucifer999: folds
spidy02: raises $38.75 to $63.75
JaspritBumrah786: folds
spaceman47157: folds
Mukesh_19: calls $53.75
devi7: folds
*** FLOP *** [Tc 4d 6h]
Mukesh_19: checks
spidy02: bets $71.76
Mukesh_19: folds
Uncalled bet ($71.76) returned to spidy02
spidy02: doesn't show hand
spidy02 collected $143.52 from pot
*** SUMMARY ***
Total pot $152.50 | Rake $8.98
Board [Tc 4d 6h]
Seat 1: JaspritBumrah786 folded before Flop (didn't bet)
Seat 2: spaceman47157 (button) folded before Flop (didn't bet)
Seat 3: Mukesh_19 (small blind) folded on the Flop
Seat 4: devi7 (big blind) folded before Flop
Seat 5: Lucifer999 folded before Flop (didn't bet)
Seat 6: spidy02 collected ($143.52)



PokerStars Game #00327524756: Hold'em No Limit ($10/$25 USD) - 2022/04/30 09:20:42 ET
Table 'Hold'em (Min 500Max 2500)  1282' 6-max Seat #4 is the button
Seat 1: PANCHYOU ($814.88 in chips) 
Seat 2: kash1102 ($3331.51 in chips) 
Seat 3: manny007 ($1849.04 in chips) 
Seat 4: foldmybets ($2730.6 in chips) 
Seat 5: Lucifer999 ($2709.94 in chips) 
Seat 6: No username ($1575.97 in chips) 
Lucifer999: posts small blind $10
No username: posts big blind $25
*** HOLE CARDS ***
Dealt to Lucifer999 [7d Ac]
PANCHYOU: calls $25
kash1102: folds
foldmybets: folds
Lucifer999: folds
No username: checks
*** FLOP *** [8c Tc Jd]
No username: checks
PANCHYOU: checks
*** TURN *** [8c Tc Jd] [Td]
No username: checks
PANCHYOU: checks
*** RIVER *** [8c Tc Jd Td] [8h]
No username: checks
PANCHYOU: bets $56.36
No username: folds
Uncalled bet ($56.36) returned to PANCHYOU
PANCHYOU: doesn't show hand
PANCHYOU collected $56.85 from pot
*** SUMMARY ***
Total pot $60.00 | Rake $3.15
Board [8c Tc Jd Td 8h]
Seat 1: PANCHYOU collected ($56.85)
Seat 2: kash1102 folded before Flop (didn't bet)
Seat 4: foldmybets (button) folded before Flop (didn't bet)
Seat 5: Lucifer999 (small blind) folded before Flop
Seat 6: No username (big blind) folded on the River



PokerStars Game #00327524750: Hold'em No Limit ($50/$100 USD) - 2022/04/30 09:20:40 ET
Table 'Hold'em (Min 25KMax 10K)    69' 6-max Seat #1 is the button
Seat 1: Lucifer999 ($12028.4 in chips) 
Seat 2: Baba_Tilteshwar ($5374 in chips) 
Seat 3: Pablit0 ($2200 in chips) 
Seat 6: tabby20 ($10390.66 in chips) 
Baba_Tilteshwar: posts small blind $50
Pablit0: posts big blind $100
*** HOLE CARDS ***
Dealt to Lucifer999 [As 8d]
tabby20: raises $200.00 to $300
Lucifer999: folds
Baba_Tilteshwar: calls $250
Pablit0: folds
*** FLOP *** [7h Qd 2c]
Baba_Tilteshwar: checks
tabby20: bets $400
Baba_Tilteshwar: calls $400
*** TURN *** [7h Qd 2c] [9h]
Baba_Tilteshwar: checks
tabby20: checks
*** RIVER *** [7h Qd 2c 9h] [7s]
Baba_Tilteshwar: bets $1025.5
tabby20: folds
Uncalled bet ($1025.5) returned to Baba_Tilteshwar
Baba_Tilteshwar: doesn't show hand
Baba_Tilteshwar collected $1434 from pot
*** SUMMARY ***
Total pot $1500.00 | Rake $66
Board [7h Qd 2c 9h 7s]
Seat 1: Lucifer999 (button) folded before Flop (didn't bet)
Seat 2: Baba_Tilteshwar (small blind) collected ($1434)
Seat 3: Pablit0 (big blind) folded before Flop
Seat 6: tabby20 folded on the River



PokerStars Game #00327524862: Hold'em No Limit ($25/$50 USD) - 2022/04/30 09:21:19 ET
Table 'Hold'em (Min 1K Max 5K)   216' 6-max Seat #5 is the button
Seat 1: Lucifer999 ($9453.65 in chips) 
Seat 2: rahulh1 ($3075.33 in chips) 
Seat 3: kash1102 ($4808.75 in chips) 
Seat 5: Avaroni ($5000 in chips) 
Lucifer999: posts small blind $25
rahulh1: posts big blind $50
*** HOLE CARDS ***
Dealt to Lucifer999 [Ac 6h]
kash1102: folds
Avaroni: raises $100.00 to $150
Lucifer999: folds
rahulh1: folds
Uncalled bet ($100) returned to Avaroni
Avaroni: doesn't show hand
Avaroni collected $125 from pot
*** SUMMARY ***
Total pot $125.00 | Rake $0
Board []
Seat 1: Lucifer999 (small blind) folded before Flop
Seat 2: rahulh1 (big blind) folded before Flop
Seat 3: kash1102 folded before Flop (didn't bet)
Seat 5: Avaroni (button) collected ($125)



PokerStars Game #00327524976: Hold'em No Limit ($25/$50 USD) - 2022/04/30 09:21:58 ET
Table 'Hold'em (Min 1K Max 5K)   216' 6-max Seat #1 is the button
Seat 1: Lucifer999 ($9428.65 in chips) 
Seat 2: rahulh1 ($3025.33 in chips) 
Seat 3: kash1102 ($4808.75 in chips) 
Seat 5: Avaroni ($5075 in chips) 
rahulh1: posts small blind $25
kash1102: posts big blind $50
*** HOLE CARDS ***
Dealt to Lucifer999 [5c 8h]
Avaroni: folds
Lucifer999: raises $100.00 to $150
rahulh1: folds
kash1102: folds
Uncalled bet ($100) returned to Lucifer999
Lucifer999: doesn't show hand
Lucifer999 collected $125 from pot
*** SUMMARY ***
Total pot $125.00 | Rake $0
Board []
Seat 1: Lucifer999 (button) collected ($125)
Seat 2: rahulh1 (small blind) folded before Flop
Seat 3: kash1102 (big blind) folded before Flop
Seat 5: Avaroni folded before Flop (didn't bet)



PokerStars Game #00327524897: Hold'em No Limit ($10/$25 USD) - 2022/04/30 09:21:31 ET
Table 'Hold'em (Min 500Max 2500)  1282' 6-max Seat #5 is the button
Seat 1: PANCHYOU ($846.73 in chips) 
Seat 2: kash1102 ($3331.51 in chips) 
Seat 3: manny007 ($1849.04 in chips) 
Seat 4: foldmybets ($2730.6 in chips) 
Seat 5: Lucifer999 ($2699.94 in chips) 
Seat 6: No username ($1550.97 in chips) 
No username: posts small blind $10
kash1102: posts big blind $25
*** HOLE CARDS ***
Dealt to Lucifer999 [Jd 9c]
foldmybets: folds
Lucifer999: raises $55.00 to $80
No username: calls $70
kash1102: folds
*** FLOP *** [As Ad Js]
No username: checks
Lucifer999: checks
*** TURN *** [As Ad Js] [2d]
No username: checks
Lucifer999: checks
*** RIVER *** [As Ad Js 2d] [Ah]
No username: checks
Lucifer999: bets $130
No username: folds
Uncalled bet ($130) returned to Lucifer999
Lucifer999: doesn't show hand
Lucifer999 collected $174.29 from pot
*** SUMMARY ***
Total pot $185.00 | Rake $10.71
Board [As Ad Js 2d Ah]
Seat 2: kash1102 (big blind) folded before Flop
Seat 4: foldmybets folded before Flop (didn't bet)
Seat 5: Lucifer999 (button) collected ($174.29)
Seat 6: No username (small blind) folded on the River



PokerStars Game #00327525060: Hold'em No Limit ($10/$25 USD) - 2022/04/30 09:22:30 ET
Table 'Hold'em (Min 500Max 2500)  1282' 6-max Seat #6 is the button
Seat 1: PANCHYOU ($846.73 in chips) 
Seat 2: kash1102 ($3306.51 in chips) 
Seat 3: manny007 ($1849.04 in chips) 
Seat 4: foldmybets ($2730.6 in chips) 
Seat 5: Lucifer999 ($2794.23 in chips) 
Seat 6: No username ($1470.97 in chips) 
kash1102: posts small blind $10
foldmybets: posts big blind $25
*** HOLE CARDS ***
Dealt to Lucifer999 [Ah Kc]
Lucifer999: folds
No username: folds
kash1102: folds
Uncalled bet ($15) returned to foldmybets
foldmybets: doesn't show hand
foldmybets collected $20 from pot
*** SUMMARY ***
Total pot $20.00 | Rake $0
Board []
Seat 2: kash1102 (small blind) folded before Flop
Seat 4: foldmybets (big blind) collected ($20)
Seat 5: Lucifer999 folded before Flop (didn't bet)
Seat 6: No username (button) folded before Flop (didn't bet)



PokerStars Game #00327524893: Hold'em No Limit ($10/$25 USD) - 2022/04/30 09:21:31 ET
Table 'Hold'em (Min 500Max 2500) 1001' 6-max Seat #3 is the button
Seat 1: JaspritBumrah786 ($2246.13 in chips) 
Seat 2: spaceman47157 ($2328.4 in chips) 
Seat 3: Mukesh_19 ($1279.76 in chips) 
Seat 4: devi7 ($2475 in chips) 
Seat 5: Lucifer999 ($4521 in chips) 
Seat 6: spidy02 ($3895.95 in chips) 
devi7: posts small blind $10
Lucifer999: posts big blind $25
*** HOLE CARDS ***
Dealt to Lucifer999 [3h Kd]
spidy02: calls $25
JaspritBumrah786: calls $25
spaceman47157: calls $25
Mukesh_19: calls $25
devi7: folds
Lucifer999: checks
*** FLOP *** [Qh 5c Th]
Lucifer999: checks
spidy02: checks
JaspritBumrah786: checks
spaceman47157: checks
Mukesh_19: checks
*** TURN *** [Qh 5c Th] [7h]
Lucifer999: checks
spidy02: checks
JaspritBumrah786: checks
spaceman47157: checks
Mukesh_19: checks
*** RIVER *** [Qh 5c Th 7h] [Ac]
Lucifer999: checks
spidy02: checks
JaspritBumrah786: checks
spaceman47157: folds
Mukesh_19: checks
*** SHOW DOWN ***
Lucifer999: shows [3h Kd] (High card, A)
spidy02: shows [Tc Js] (Pair, TT)
JaspritBumrah786: doesn't show hand
Mukesh_19: doesn't show hand
spidy02 collected $126.92 from pot
*** SUMMARY ***
Total pot $135.00 | Rake $8.08
Board [Qh 5c Th 7h Ac]
Seat 1: JaspritBumrah786 mucked
Seat 2: spaceman47157 folded on the River
Seat 3: Mukesh_19 (button) mucked
Seat 4: devi7 (small blind) folded before Flop
Seat 5: Lucifer999 (big blind) showed [3h Kd] and lost with High card, A
Seat 6: spidy02  showed [Tc Js] and won ($126.92) with Pair, TT



PokerStars Game #00327525057: Hold'em No Limit ($25/$50 USD) - 2022/04/30 09:22:28 ET
Table 'Hold'em (Min 1K Max 5K)   216' 6-max Seat #2 is the button
Seat 1: Lucifer999 ($9503.65 in chips) 
Seat 2: rahulh1 ($3000.33 in chips) 
Seat 3: kash1102 ($4758.75 in chips) 
Seat 5: Avaroni ($5075 in chips) 
kash1102: posts small blind $25
Avaroni: posts big blind $50
*** HOLE CARDS ***
Dealt to Lucifer999 [Td 7d]
Lucifer999: raises $100.00 to $150
rahulh1: folds
kash1102: folds
Avaroni: folds
Uncalled bet ($100) returned to Lucifer999
Lucifer999: doesn't show hand
Lucifer999 collected $125 from pot
*** SUMMARY ***
Total pot $125.00 | Rake $0
Board []
Seat 1: Lucifer999 collected ($125)
Seat 2: rahulh1 (button) folded before Flop (didn't bet)
Seat 3: kash1102 (small blind) folded before Flop
Seat 5: Avaroni (big blind) folded before Flop



PokerStars Game #00327524944: Hold'em No Limit ($50/$100 USD) - 2022/04/30 09:21:46 ET
Table 'Hold'em (Min 25KMax 10K)    69' 6-max Seat #2 is the button
Seat 1: Lucifer999 ($12028.4 in chips) 
Seat 2: Baba_Tilteshwar ($6108 in chips) 
Seat 3: Pablit0 ($2100 in chips) 
Seat 4: vinuth ($11380.81 in chips) 
Seat 6: tabby20 ($10000 in chips) 
Pablit0: posts small blind $50
vinuth: posts big blind $100
*** HOLE CARDS ***
Dealt to Lucifer999 [Kh 5h]
tabby20: folds
Lucifer999: folds
Baba_Tilteshwar: calls $100
Pablit0: calls $50
vinuth: checks
*** FLOP *** [6c Js 6d]
Pablit0: checks
vinuth: checks
Baba_Tilteshwar: bets $150
Pablit0: calls $150
vinuth: folds
*** TURN *** [6c Js 6d] [4c]
Pablit0: bets $286.8
Baba_Tilteshwar: calls $286.8
*** RIVER *** [6c Js 6d 4c] [5c]
Pablit0: checks
Baba_Tilteshwar: bets $1121.99
Pablit0: raises $441.21 to $1563.2
Baba_Tilteshwar: folds
Uncalled bet ($441.21) returned to Pablit0
Pablit0: doesn't show hand
Pablit0 collected $3267.24 from pot
*** SUMMARY ***
Total pot $3417.58 | Rake $150.34
Board [6c Js 6d 4c 5c]
Seat 1: Lucifer999 folded before Flop (didn't bet)
Seat 2: Baba_Tilteshwar (button) folded on the River
Seat 3: Pablit0 (small blind) collected ($3267.24)
Seat 4: vinuth (big blind) folded on the Flop
Seat 6: tabby20 folded before Flop (didn't bet)



PokerStars Game #00327525118: Hold'em No Limit ($10/$25 USD) - 2022/04/30 09:22:51 ET
Table 'Hold'em (Min 500Max 2500)  1282' 6-max Seat #2 is the button
Seat 1: PANCHYOU ($846.73 in chips) 
Seat 2: kash1102 ($3296.51 in chips) 
Seat 3: manny007 ($1849.04 in chips) 
Seat 4: foldmybets ($2740.6 in chips) 
Seat 5: Lucifer999 ($2794.23 in chips) 
Seat 6: No username ($1470.97 in chips) 
foldmybets: posts small blind $10
Lucifer999: posts big blind $25
*** HOLE CARDS ***
Dealt to Lucifer999 [5c Qc]
No username: folds
kash1102: folds
foldmybets: folds
Uncalled bet ($15) returned to Lucifer999
Lucifer999: doesn't show hand
Lucifer999 collected $20 from pot
*** SUMMARY ***
Total pot $20.00 | Rake $0
Board []
Seat 2: kash1102 (button) folded before Flop (didn't bet)
Seat 4: foldmybets (small blind) folded before Flop
Seat 5: Lucifer999 (big blind) collected ($20)
Seat 6: No username folded before Flop (didn't bet)



PokerStars Game #00327525127: Hold'em No Limit ($25/$50 USD) - 2022/04/30 09:22:54 ET
Table 'Hold'em (Min 1K Max 5K)   216' 6-max Seat #3 is the button
Seat 1: Lucifer999 ($9578.65 in chips) 
Seat 2: rahulh1 ($3000.33 in chips) 
Seat 3: kash1102 ($4733.75 in chips) 
Seat 5: Avaroni ($5025 in chips) 
Avaroni: posts small blind $25
Lucifer999: posts big blind $50
*** HOLE CARDS ***
Dealt to Lucifer999 [5s 3c]
rahulh1: folds
kash1102: folds
Avaroni: raises $100.00 to $150
Lucifer999: folds
Uncalled bet ($100) returned to Avaroni
Avaroni: doesn't show hand
Avaroni collected $100 from pot
*** SUMMARY ***
Total pot $100.00 | Rake $0
Board []
Seat 1: Lucifer999 (big blind) folded before Flop
Seat 2: rahulh1 folded before Flop (didn't bet)
Seat 3: kash1102 (button) folded before Flop (didn't bet)
Seat 5: Avaroni (small blind) collected ($100)



PokerStars Game #00327525158: Hold'em No Limit ($10/$25 USD) - 2022/04/30 09:23:03 ET
Table 'Hold'em (Min 500Max 2500)  1282' 6-max Seat #4 is the button
Seat 1: PANCHYOU ($846.73 in chips) 
Seat 2: kash1102 ($3296.51 in chips) 
Seat 3: manny007 ($1849.04 in chips) 
Seat 4: foldmybets ($2730.6 in chips) 
Seat 5: Lucifer999 ($2804.23 in chips) 
Seat 6: No username ($1470.97 in chips) 
Lucifer999: posts small blind $10
No username: posts big blind $25
*** HOLE CARDS ***
Dealt to Lucifer999 [5s 8s]
kash1102: folds
foldmybets: folds
Lucifer999: folds
Uncalled bet ($15) returned to No username
No username: doesn't show hand
No username collected $20 from pot
*** SUMMARY ***
Total pot $20.00 | Rake $0
Board []
Seat 2: kash1102 folded before Flop (didn't bet)
Seat 4: foldmybets (button) folded before Flop (didn't bet)
Seat 5: Lucifer999 (small blind) folded before Flop
Seat 6: No username (big blind) collected ($20)



PokerStars Game #00327525137: Hold'em No Limit ($50/$100 USD) - 2022/04/30 09:22:57 ET
Table 'Hold'em (Min 25KMax 10K)    69' 6-max Seat #3 is the button
Seat 1: Lucifer999 ($12028.4 in chips) 
Seat 2: Baba_Tilteshwar ($4449.21 in chips) 
Seat 3: Pablit0 ($3708.45 in chips) 
Seat 4: vinuth ($11280.81 in chips) 
Seat 6: tabby20 ($10000 in chips) 
vinuth: posts small blind $50
tabby20: posts big blind $100
*** HOLE CARDS ***
Dealt to Lucifer999 [Kh 3s]
Lucifer999: folds
Baba_Tilteshwar: folds
Pablit0: calls $100
vinuth: raises $250.00 to $350
tabby20: folds
Pablit0: folds
Uncalled bet ($250) returned to vinuth
vinuth: doesn't show hand
vinuth collected $300 from pot
*** SUMMARY ***
Total pot $300.00 | Rake $0
Board []
Seat 1: Lucifer999 folded before Flop (didn't bet)
Seat 2: Baba_Tilteshwar folded before Flop (didn't bet)
Seat 3: Pablit0 (button) folded before Flop
Seat 4: vinuth (small blind) collected ($300)
Seat 6: tabby20 (big blind) folded before Flop



PokerStars Game #00327525119: Hold'em No Limit ($10/$25 USD) - 2022/04/30 09:22:52 ET
Table 'Hold'em (Min 500Max 2500) 1001' 6-max Seat #4 is the button
Seat 1: JaspritBumrah786 ($2221.13 in chips) 
Seat 2: spaceman47157 ($2303.4 in chips) 
Seat 3: Mukesh_19 ($1254.76 in chips) 
Seat 4: devi7 ($2465 in chips) 
Seat 5: Lucifer999 ($4496 in chips) 
Seat 6: spidy02 ($3997.87 in chips) 
Lucifer999: posts small blind $10
spidy02: posts big blind $25
*** HOLE CARDS ***
Dealt to Lucifer999 [Ac 4c]
JaspritBumrah786: folds
spaceman47157: calls $25
Mukesh_19: calls $25
devi7: folds
Lucifer999: raises $115.00 to $140
spidy02: folds
spaceman47157: folds
Mukesh_19: folds
Uncalled bet ($115) returned to Lucifer999
Lucifer999: doesn't show hand
Lucifer999 collected $100 from pot
*** SUMMARY ***
Total pot $100.00 | Rake $0
Board []
Seat 1: JaspritBumrah786 folded before Flop (didn't bet)
Seat 2: spaceman47157 folded before Flop
Seat 3: Mukesh_19 folded before Flop
Seat 4: devi7 (button) folded before Flop (didn't bet)
Seat 5: Lucifer999 (small blind) collected ($100)
Seat 6: spidy02 (big blind) folded before Flop



PokerStars Game #00327525221: Hold'em No Limit ($10/$25 USD) - 2022/04/30 09:23:27 ET
Table 'Hold'em (Min 500Max 2500)  1282' 6-max Seat #5 is the button
Seat 1: PANCHYOU ($846.73 in chips) 
Seat 2: kash1102 ($3296.51 in chips) 
Seat 3: manny007 ($1849.04 in chips) 
Seat 4: foldmybets ($2730.6 in chips) 
Seat 5: Lucifer999 ($2794.23 in chips) 
Seat 6: No username ($1480.97 in chips) 
No username: posts small blind $10
PANCHYOU: posts big blind $25
*** HOLE CARDS ***
Dealt to Lucifer999 [6d Ac]
kash1102: folds
foldmybets: folds
Lucifer999: folds
No username: folds
Uncalled bet ($15) returned to PANCHYOU
PANCHYOU: doesn't show hand
PANCHYOU collected $20 from pot
*** SUMMARY ***
Total pot $20.00 | Rake $0
Board []
Seat 1: PANCHYOU (big blind) collected ($20)
Seat 2: kash1102 folded before Flop (didn't bet)
Seat 4: foldmybets folded before Flop (didn't bet)
Seat 5: Lucifer999 (button) folded before Flop (didn't bet)
Seat 6: No username (small blind) folded before Flop



PokerStars Game #00327525175: Hold'em No Limit ($25/$50 USD) - 2022/04/30 09:23:09 ET
Table 'Hold'em (Min 1K Max 5K)   216' 6-max Seat #5 is the button
Seat 1: Lucifer999 ($9528.65 in chips) 
Seat 2: rahulh1 ($3000.33 in chips) 
Seat 3: kash1102 ($4733.75 in chips) 
Seat 5: Avaroni ($5075 in chips) 
Lucifer999: posts small blind $25
rahulh1: posts big blind $50
*** HOLE CARDS ***
Dealt to Lucifer999 [Qs Qd]
kash1102: folds
Avaroni: raises $100.00 to $150
Lucifer999: calls $125
rahulh1: folds
*** FLOP *** [Qh 9h 5s]
Lucifer999: checks
Avaroni: checks
*** TURN *** [Qh 9h 5s] [2c]
Lucifer999: bets $300
Avaroni: calls $300
*** RIVER *** [Qh 9h 5s 2c] [3h]
Lucifer999: checks
Avaroni: bets $350
Lucifer999: calls $350
*** SHOW DOWN ***
Avaroni: shows [2s 9s] (Two pairs, 9922)
Lucifer999: shows [Qs Qd] (Three of a kind, QQQ)
Lucifer999 collected $1567.5 from pot
*** SUMMARY ***
Total pot $1650.00 | Rake $82.5
Board [Qh 9h 5s 2c 3h]
Seat 1: Lucifer999  (small blind) showed [Qs Qd] and won ($1567.5) with Three of a kind, QQQ
Seat 2: rahulh1 (big blind) folded before Flop
Seat 3: kash1102 folded before Flop (didn't bet)
Seat 5: Avaroni (button) showed [2s 9s] and lost with Two pairs, 9922



PokerStars Game #00327525224: Hold'em No Limit ($50/$100 USD) - 2022/04/30 09:23:29 ET
Table 'Hold'em (Min 25KMax 10K)    69' 6-max Seat #4 is the button
Seat 1: Lucifer999 ($12028.4 in chips) 
Seat 2: Baba_Tilteshwar ($4539.21 in chips) 
Seat 3: Pablit0 ($3608.45 in chips) 
Seat 4: vinuth ($11480.81 in chips) 
Seat 6: tabby20 ($10000 in chips) 
tabby20: posts small blind $50
Lucifer999: posts big blind $100
*** HOLE CARDS ***
Dealt to Lucifer999 [3h Ac]
Baba_Tilteshwar: raises $150.00 to $250
Pablit0: folds
vinuth: calls $250
tabby20: folds
Lucifer999: folds
*** FLOP *** [Qd 5h 2h]
Baba_Tilteshwar: bets $350
vinuth: calls $350
*** TURN *** [Qd 5h 2h] [6d]
Baba_Tilteshwar: bets $550
vinuth: calls $550
*** RIVER *** [Qd 5h 2h 6d] [Qc]
Baba_Tilteshwar: bets $1321.1
vinuth: calls $1321.1
*** SHOW DOWN ***
Baba_Tilteshwar: shows [9d Ad] (Pair, QQ)
vinuth: shows [9s 9c] (Two pairs, QQ99)
vinuth collected $4868.16 from pot
*** SUMMARY ***
Total pot $5092.20 | Rake $224.04
Board [Qd 5h 2h 6d Qc]
Seat 1: Lucifer999 (big blind) folded before Flop
Seat 2: Baba_Tilteshwar showed [9d Ad] and lost with Pair, QQ
Seat 3: Pablit0 folded before Flop (didn't bet)
Seat 4: vinuth  (button) showed [9s 9c] and won ($4868.16) with Two pairs, QQ99
Seat 6: tabby20 (small blind) folded before Flop



PokerStars Game #00327525339: Hold'em No Limit ($25/$50 USD) - 2022/04/30 09:24:11 ET
Table 'Hold'em (Min 1K Max 5K)   216' 6-max Seat #1 is the button
Seat 1: Lucifer999 ($10296.15 in chips) 
Seat 2: rahulh1 ($2950.33 in chips) 
Seat 3: kash1102 ($4733.75 in chips) 
Seat 5: Avaroni ($5000 in chips) 
rahulh1: posts small blind $25
kash1102: posts big blind $50
*** HOLE CARDS ***
Dealt to Lucifer999 [3h Ah]
Avaroni: raises $100.00 to $150
Lucifer999: folds
rahulh1: folds
kash1102: folds
Uncalled bet ($100) returned to Avaroni
Avaroni: doesn't show hand
Avaroni collected $125 from pot
*** SUMMARY ***
Total pot $125.00 | Rake $0
Board []
Seat 1: Lucifer999 (button) folded before Flop (didn't bet)
Seat 2: rahulh1 (small blind) folded before Flop
Seat 3: kash1102 (big blind) folded before Flop
Seat 5: Avaroni collected ($125)



PokerStars Game #00327525310: Hold'em No Limit ($10/$25 USD) - 2022/04/30 09:23:58 ET
Table 'Hold'em (Min 500Max 2500)  1282' 6-max Seat #6 is the button
Seat 1: PANCHYOU ($856.73 in chips) 
Seat 2: kash1102 ($3296.51 in chips) 
Seat 3: manny007 ($1849.04 in chips) 
Seat 4: foldmybets ($2730.6 in chips) 
Seat 5: Lucifer999 ($2794.23 in chips) 
Seat 6: No username ($1470.97 in chips) 
PANCHYOU: posts small blind $10
kash1102: posts big blind $25
*** HOLE CARDS ***
Dealt to Lucifer999 [8d 8s]
foldmybets: folds
Lucifer999: raises $55.00 to $80
No username: raises $195.00 to $275
PANCHYOU: folds
kash1102: folds
Lucifer999: raises $2519.23 to $2794.23
No username: calls $1195.97
Uncalled bet ($1323.26) returned to Lucifer999
*** FLOP *** [Jh 9s 2c]
*** TURN *** [Jh 9s 2c] [7h]
*** RIVER *** [Jh 9s 2c 7h] [3d]
*** SHOW DOWN ***
Lucifer999: shows [8d 8s] (Pair, 88)
No username: shows [Ac Td] (High card, A)
Lucifer999 collected $2815.7 from pot
*** SUMMARY ***
Total pot $2976.94 | Rake $161.24
Board [Jh 9s 2c 7h 3d]
Seat 1: PANCHYOU (small blind) folded before Flop
Seat 2: kash1102 (big blind) folded before Flop
Seat 4: foldmybets folded before Flop (didn't bet)
Seat 5: Lucifer999  showed [8d 8s] and won ($2815.7) with Pair, 88
Seat 6: No username (button) showed [Ac Td] and lost with High card, A



PokerStars Game #00327525402: Hold'em No Limit ($25/$50 USD) - 2022/04/30 09:24:37 ET
Table 'Hold'em (Min 1K Max 5K)   216' 6-max Seat #2 is the button
Seat 1: Lucifer999 ($10296.15 in chips) 
Seat 2: rahulh1 ($2925.33 in chips) 
Seat 3: kash1102 ($4683.75 in chips) 
Seat 5: Avaroni ($5075 in chips) 
kash1102: posts small blind $25
Avaroni: posts big blind $50
*** HOLE CARDS ***
Dealt to Lucifer999 [5h Td]
Lucifer999: folds
rahulh1: folds
kash1102: raises $125.00 to $175
Avaroni: folds
Uncalled bet ($125) returned to kash1102
kash1102: doesn't show hand
kash1102 collected $100 from pot
*** SUMMARY ***
Total pot $100.00 | Rake $0
Board []
Seat 1: Lucifer999 folded before Flop (didn't bet)
Seat 2: rahulh1 (button) folded before Flop (didn't bet)
Seat 3: kash1102 (small blind) collected ($100)
Seat 5: Avaroni (big blind) folded before Flop



PokerStars Game #00327525440: Hold'em No Limit ($10/$25 USD) - 2022/04/30 09:24:49 ET
Table 'Hold'em (Min 500Max 2500)  1282' 6-max Seat #1 is the button
Seat 1: PANCHYOU ($846.73 in chips) 
Seat 2: kash1102 ($3271.51 in chips) 
Seat 3: manny007 ($1849.04 in chips) 
Seat 4: foldmybets ($2730.6 in chips) 
Seat 5: Lucifer999 ($4138.96 in chips) 
Seat 6: No username ($1300 in chips) 
kash1102: posts small blind $10
foldmybets: posts big blind $25
*** HOLE CARDS ***
Dealt to Lucifer999 [9h Kh]
Lucifer999: raises $55.00 to $80
PANCHYOU: folds
kash1102: folds
foldmybets: folds
Uncalled bet ($55) returned to Lucifer999
Lucifer999: doesn't show hand
Lucifer999 collected $60 from pot
*** SUMMARY ***
Total pot $60.00 | Rake $0
Board []
Seat 1: PANCHYOU (button) folded before Flop (didn't bet)
Seat 2: kash1102 (small blind) folded before Flop
Seat 4: foldmybets (big blind) folded before Flop
Seat 5: Lucifer999 collected ($60)



PokerStars Game #00327525281: Hold'em No Limit ($10/$25 USD) - 2022/04/30 09:23:48 ET
Table 'Hold'em (Min 500Max 2500) 1001' 6-max Seat #5 is the button
Seat 1: JaspritBumrah786 ($2221.13 in chips) 
Seat 2: spaceman47157 ($2278.4 in chips) 
Seat 3: Mukesh_19 ($1229.76 in chips) 
Seat 4: devi7 ($2465 in chips) 
Seat 5: Lucifer999 ($4571 in chips) 
Seat 6: spidy02 ($3972.87 in chips) 
spidy02: posts small blind $10
JaspritBumrah786: posts big blind $25
*** HOLE CARDS ***
Dealt to Lucifer999 [6d Ac]
spaceman47157: calls $25
Mukesh_19: calls $25
devi7: folds
Lucifer999: folds
spidy02: calls $15
JaspritBumrah786: checks
*** FLOP *** [3h 5s 8h]
spidy02: checks
JaspritBumrah786: checks
spaceman47157: bets $93.75
Mukesh_19: calls $93.75
spidy02: calls $93.75
JaspritBumrah786: folds
*** TURN *** [3h 5s 8h] [Kd]
spidy02: checks
spaceman47157: checks
Mukesh_19: bets $358.25
spidy02: folds
spaceman47157: calls $358.25
*** RIVER *** [3h 5s 8h Kd] [2s]
spaceman47157: checks
Mukesh_19: bets $517.58
spaceman47157: calls $517.58
*** SHOW DOWN ***
Mukesh_19: shows [6h Kh] (Pair, KK)
spaceman47157: shows [2h 5h] (Two pairs, 5522)
spaceman47157 collected $2015.98 from pot
*** SUMMARY ***
Total pot $2132.91 | Rake $116.93
Board [3h 5s 8h Kd 2s]
Seat 1: JaspritBumrah786 (big blind) folded on the Flop
Seat 2: spaceman47157  showed [2h 5h] and won ($2015.98) with Two pairs, 5522
Seat 3: Mukesh_19 showed [6h Kh] and lost with Pair, KK
Seat 4: devi7 folded before Flop (didn't bet)
Seat 5: Lucifer999 (button) folded before Flop (didn't bet)
Seat 6: spidy02 (small blind) folded on the Turn



PokerStars Game #00327525400: Hold'em No Limit ($50/$100 USD) - 2022/04/30 09:24:36 ET
Table 'Hold'em (Min 25KMax 10K)    69' 6-max Seat #6 is the button
Seat 1: Lucifer999 ($11928.4 in chips) 
Seat 3: Pablit0 ($3608.45 in chips) 
Seat 4: vinuth ($13877.87 in chips) 
Seat 6: tabby20 ($10000 in chips) 
Lucifer999: posts small blind $50
Pablit0: posts big blind $100
*** HOLE CARDS ***
Dealt to Lucifer999 [6d Ks]
vinuth: folds
tabby20: raises $200.00 to $300
Lucifer999: folds
Pablit0: calls $200
*** FLOP *** [Jh Ts 4d]
Pablit0: checks
tabby20: checks
*** TURN *** [Jh Ts 4d] [7c]
Pablit0: bets $359
tabby20: calls $359
*** RIVER *** [Jh Ts 4d 7c] [9s]
Pablit0: checks
tabby20: checks
*** SHOW DOWN ***
Pablit0: shows [Qs Js] (Pair, JJ)
tabby20: doesn't show hand
Pablit0 collected $1307.81 from pot
*** SUMMARY ***
Total pot $1368.00 | Rake $60.19
Board [Jh Ts 4d 7c 9s]
Seat 1: Lucifer999 (small blind) folded before Flop
Seat 3: Pablit0  (big blind) showed [Qs Js] and won ($1307.81) with Pair, JJ
Seat 4: vinuth folded before Flop (didn't bet)
Seat 6: tabby20 (button) mucked



PokerStars Game #00327525497: Hold'em No Limit ($10/$25 USD) - 2022/04/30 09:25:15 ET
Table 'Hold'em (Min 500Max 2500)  1282' 6-max Seat #2 is the button
Seat 1: PANCHYOU ($846.73 in chips) 
Seat 2: kash1102 ($3261.51 in chips) 
Seat 3: manny007 ($1849.04 in chips) 
Seat 4: foldmybets ($2705.6 in chips) 
Seat 5: Lucifer999 ($4173.96 in chips) 
Seat 6: No username ($1300 in chips) 
foldmybets: posts small blind $10
Lucifer999: posts big blind $25
*** HOLE CARDS ***
Dealt to Lucifer999 [8h 6s]
No username: folds
PANCHYOU: folds
kash1102: folds
foldmybets: raises $50.00 to $75
Lucifer999: folds
Uncalled bet ($50) returned to foldmybets
foldmybets: doesn't show hand
foldmybets collected $50 from pot
*** SUMMARY ***
Total pot $50.00 | Rake $0
Board []
Seat 1: PANCHYOU folded before Flop (didn't bet)
Seat 2: kash1102 (button) folded before Flop (didn't bet)
Seat 4: foldmybets (small blind) collected ($50)
Seat 5: Lucifer999 (big blind) folded before Flop
Seat 6: No username folded before Flop (didn't bet)



PokerStars Game #00327525465: Hold'em No Limit ($25/$50 USD) - 2022/04/30 09:25:01 ET
Table 'Hold'em (Min 1K Max 5K)   216' 6-max Seat #3 is the button
Seat 1: Lucifer999 ($10296.15 in chips) 
Seat 2: rahulh1 ($2925.33 in chips) 
Seat 3: kash1102 ($4733.75 in chips) 
Seat 5: Avaroni ($5025 in chips) 
Avaroni: posts small blind $25
Lucifer999: posts big blind $50
*** HOLE CARDS ***
Dealt to Lucifer999 [7c 3c]
rahulh1: folds
kash1102: folds
Avaroni: raises $100.00 to $150
Lucifer999: calls $100
*** FLOP *** [Jc 4c Ks]
Avaroni: bets $250
Lucifer999: calls $250
*** TURN *** [Jc 4c Ks] [2d]
Avaroni: bets $700
Lucifer999: calls $700
*** RIVER *** [Jc 4c Ks 2d] [Qc]
Avaroni: bets $2090
Lucifer999: raises $2090.00 to $4180
Avaroni: folds
Uncalled bet ($2090) returned to Lucifer999
Lucifer999: doesn't show hand
Lucifer999 collected $6091 from pot
*** SUMMARY ***
Total pot $6380.00 | Rake $289
Board [Jc 4c Ks 2d Qc]
Seat 1: Lucifer999 (big blind) collected ($6091)
Seat 2: rahulh1 folded before Flop (didn't bet)
Seat 3: kash1102 (button) folded before Flop (didn't bet)
Seat 5: Avaroni (small blind) folded on the River



PokerStars Game #00327525520: Hold'em No Limit ($10/$25 USD) - 2022/04/30 09:25:23 ET
Table 'Hold'em (Min 500Max 2500) 1001' 6-max Seat #6 is the button
Seat 1: JaspritBumrah786 ($2196.13 in chips) 
Seat 2: spaceman47157 ($3299.8 in chips) 
Seat 3: Mukesh_19 ($235.18 in chips) 
Seat 4: devi7 ($2465 in chips) 
Seat 5: Lucifer999 ($4571 in chips) 
Seat 6: spidy02 ($3854.12 in chips) 
JaspritBumrah786: posts small blind $10
spaceman47157: posts big blind $25
*** HOLE CARDS ***
Dealt to Lucifer999 [Ks 2c]
Mukesh_19: raises $210.18 to $235.18
devi7: folds
Lucifer999: folds
spidy02: folds
JaspritBumrah786: folds
spaceman47157: calls $210.18
*** FLOP *** [Qc 3d 3c]
*** TURN *** [Qc 3d 3c] [2h]
*** RIVER *** [Qc 3d 3c 2h] [Js]
*** SHOW DOWN ***
spaceman47157: shows [Ah 6h] (Pair, 33)
Mukesh_19: shows [Td 9h] (Pair, 33)
spaceman47157 collected $451.16 from pot
*** SUMMARY ***
Total pot $480.36 | Rake $29.2
Board [Qc 3d 3c 2h Js]
Seat 1: JaspritBumrah786 (small blind) folded before Flop
Seat 2: spaceman47157  (big blind) showed [Ah 6h] and won ($451.16) with Pair, 33
Seat 3: Mukesh_19 showed [Td 9h] and lost with Pair, 33
Seat 4: devi7 folded before Flop (didn't bet)
Seat 5: Lucifer999 folded before Flop (didn't bet)
Seat 6: spidy02 (button) folded before Flop (didn't bet)



PokerStars Game #00327525571: Hold'em No Limit ($10/$25 USD) - 2022/04/30 09:25:43 ET
Table 'Hold'em (Min 500Max 2500)  1282' 6-max Seat #4 is the button
Seat 1: PANCHYOU ($846.73 in chips) 
Seat 2: kash1102 ($3261.51 in chips) 
Seat 3: manny007 ($4349.04 in chips) 
Seat 4: foldmybets ($2730.6 in chips) 
Seat 5: Lucifer999 ($4148.96 in chips) 
Seat 6: No username ($1300 in chips) 
Lucifer999: posts small blind $10
No username: posts big blind $25
*** HOLE CARDS ***
Dealt to Lucifer999 [9d 4h]
PANCHYOU: folds
kash1102: folds
foldmybets: folds
Lucifer999: folds
Uncalled bet ($15) returned to No username
No username: doesn't show hand
No username collected $20 from pot
*** SUMMARY ***
Total pot $20.00 | Rake $0
Board []
Seat 1: PANCHYOU folded before Flop (didn't bet)
Seat 2: kash1102 folded before Flop (didn't bet)
Seat 4: foldmybets (button) folded before Flop (didn't bet)
Seat 5: Lucifer999 (small blind) folded before Flop
Seat 6: No username (big blind) collected ($20)



PokerStars Game #00327525639: Hold'em No Limit ($10/$25 USD) - 2022/04/30 09:26:10 ET
Table 'Hold'em (Min 500Max 2500)  1282' 6-max Seat #5 is the button
Seat 1: PANCHYOU ($846.73 in chips) 
Seat 2: kash1102 ($3261.51 in chips) 
Seat 3: devi7 ($2500 in chips) 
Seat 4: foldmybets ($2730.6 in chips) 
Seat 5: Lucifer999 ($4138.96 in chips) 
Seat 6: No username ($1310 in chips) 
No username: posts small blind $10
PANCHYOU: posts big blind $25
*** HOLE CARDS ***
Dealt to Lucifer999 [Jd Kd]
kash1102: folds
foldmybets: folds
Lucifer999: raises $55.00 to $80
No username: calls $70
PANCHYOU: folds
*** FLOP *** [8h 4s Qc]
No username: checks
Lucifer999: bets $130
No username: calls $130
*** TURN *** [8h 4s Qc] [Ah]
No username: checks
Lucifer999: checks
*** RIVER *** [8h 4s Qc Ah] [Jh]
No username: checks
Lucifer999: checks
*** SHOW DOWN ***
Lucifer999: shows [Jd Kd] (Pair, JJ)
No username: doesn't show hand
Lucifer999 collected $417.64 from pot
*** SUMMARY ***
Total pot $445.00 | Rake $27.36
Board [8h 4s Qc Ah Jh]
Seat 1: PANCHYOU (big blind) folded before Flop
Seat 2: kash1102 folded before Flop (didn't bet)
Seat 4: foldmybets folded before Flop (didn't bet)
Seat 5: Lucifer999  (button) showed [Jd Kd] and won ($417.64) with Pair, JJ
Seat 6: No username (small blind) mucked



PokerStars Game #00327525630: Hold'em No Limit ($10/$25 USD) - 2022/04/30 09:26:07 ET
Table 'Hold'em (Min 500Max 2500) 1001' 6-max Seat #1 is the button
Seat 1: JaspritBumrah786 ($2186.13 in chips) 
Seat 2: spaceman47157 ($3515.78 in chips) 
Seat 3: Mukesh_19 ($500 in chips) 
Seat 4: devi7 ($2465 in chips) 
Seat 5: Lucifer999 ($4571 in chips) 
Seat 6: spidy02 ($3854.12 in chips) 
spaceman47157: posts small blind $10
devi7: posts big blind $25
*** HOLE CARDS ***
Dealt to Lucifer999 [7h Ac]
Lucifer999: folds
spidy02: raises $25.00 to $50
JaspritBumrah786: folds
spaceman47157: folds
devi7: calls $25
*** FLOP *** [6s 8d 2d]
devi7: checks
spidy02: checks
*** TURN *** [6s 8d 2d] [Ks]
devi7: bets $100
spidy02: folds
Uncalled bet ($100) returned to devi7
devi7: doesn't show hand
devi7 collected $103.23 from pot
*** SUMMARY ***
Total pot $110.00 | Rake $6.77
Board [6s 8d 2d Ks]
Seat 1: JaspritBumrah786 (button) folded before Flop (didn't bet)
Seat 2: spaceman47157 (small blind) folded before Flop
Seat 4: devi7 (big blind) collected ($103.23)
Seat 5: Lucifer999 folded before Flop (didn't bet)
Seat 6: spidy02 folded on the Turn



PokerStars Game #00327525604: Hold'em No Limit ($25/$50 USD) - 2022/04/30 09:25:54 ET
Table 'Hold'em (Min 1K Max 5K)   216' 6-max Seat #5 is the button
Seat 1: Lucifer999 ($13197.15 in chips) 
Seat 2: rahulh1 ($2925.33 in chips) 
Seat 3: kash1102 ($4733.75 in chips) 
Seat 5: Avaroni ($5000 in chips) 
Lucifer999: posts small blind $25
rahulh1: posts big blind $50
*** HOLE CARDS ***
Dealt to Lucifer999 [Qs 8d]
kash1102: folds
Avaroni: raises $100.00 to $150
Lucifer999: folds
rahulh1: calls $100
*** FLOP *** [9d 2d 9c]
rahulh1: checks
Avaroni: bets $200
rahulh1: calls $200
*** TURN *** [9d 2d 9c] [5s]
rahulh1: checks
Avaroni: bets $525
rahulh1: raises $525.00 to $1050
Avaroni: calls $525
*** RIVER *** [9d 2d 9c 5s] [3c]
rahulh1: bets $856.58
Avaroni: calls $856.58
*** SHOW DOWN ***
rahulh1: shows [9h Ad] (Three of a kind, 999)
Avaroni: shows [Ac 9s] (Three of a kind, 999)
rahulh1 collected $2155.63 from pot
Avaroni collected $2155.63 from pot
*** SUMMARY ***
Total pot $4538.16 | Rake $226.9
Board [9d 2d 9c 5s 3c]
Seat 1: Lucifer999 (small blind) folded before Flop
Seat 2: rahulh1  (big blind) showed [9h Ad] and won ($2155.63) with Three of a kind, 999
Seat 3: kash1102 folded before Flop (didn't bet)
Seat 5: Avaroni  (button) showed [Ac 9s] and won ($2155.63) with Three of a kind, 999



PokerStars Game #00327525544: Hold'em No Limit ($50/$100 USD) - 2022/04/30 09:25:33 ET
Table 'Hold'em (Min 25KMax 10K)    69' 6-max Seat #1 is the button
Seat 1: Lucifer999 ($11878.4 in chips) 
Seat 2: Mangs ($2500 in chips) 
Seat 3: Pablit0 ($4257.26 in chips) 
Seat 4: vinuth ($13877.87 in chips) 
Seat 6: tabby20 ($10000 in chips) 
vinuth: posts small blind $50
tabby20: posts big blind $100
*** HOLE CARDS ***
Dealt to Lucifer999 [Ks Ad]
Lucifer999: calls $100
vinuth: folds
tabby20: checks
*** FLOP *** [4h 8s Kd]
tabby20: checks
Lucifer999: checks
*** TURN *** [4h 8s Kd] [3h]
tabby20: checks
Lucifer999: bets $200
tabby20: calls $200
*** RIVER *** [4h 8s Kd 3h] [3d]
tabby20: checks
Lucifer999: bets $300
tabby20: calls $300
*** SHOW DOWN ***
Lucifer999: shows [Ks Ad] (Two pairs, KK33)
tabby20: doesn't show hand
Lucifer999 collected $1195 from pot
*** SUMMARY ***
Total pot $1250.00 | Rake $55
Board [4h 8s Kd 3h 3d]
Seat 1: Lucifer999  (button) showed [Ks Ad] and won ($1195) with Two pairs, KK33
Seat 4: vinuth (small blind) folded before Flop
Seat 6: tabby20 (big blind) mucked



PokerStars Game #00327525796: Hold'em No Limit ($10/$25 USD) - 2022/04/30 09:27:12 ET
Table 'Hold'em (Min 500Max 2500)  1282' 6-max Seat #6 is the button
Seat 1: PANCHYOU ($821.73 in chips) 
Seat 2: kash1102 ($3261.51 in chips) 
Seat 3: devi7 ($2500 in chips) 
Seat 4: foldmybets ($2730.6 in chips) 
Seat 5: Lucifer999 ($4346.6 in chips) 
Seat 6: No username ($1100 in chips) 
PANCHYOU: posts small blind $10
kash1102: posts big blind $25
*** HOLE CARDS ***
Dealt to Lucifer999 [Ah Qd]
foldmybets: folds
Lucifer999: folds
No username: raises $60.00 to $85
PANCHYOU: folds
kash1102: folds
Uncalled bet ($60) returned to No username
No username: doesn't show hand
No username collected $60 from pot
*** SUMMARY ***
Total pot $60.00 | Rake $0
Board []
Seat 1: PANCHYOU (small blind) folded before Flop
Seat 2: kash1102 (big blind) folded before Flop
Seat 4: foldmybets folded before Flop (didn't bet)
Seat 5: Lucifer999 folded before Flop (didn't bet)
Seat 6: No username (button) collected ($60)



PokerStars Game #00327525864: Hold'em No Limit ($50/$100 USD) - 2022/04/30 09:27:35 ET
Table 'Hold'em (Min 25KMax 10K)    69' 6-max Seat #6 is the button
Seat 1: Lucifer999 ($12473.4 in chips) 
Seat 2: Mangs ($2500 in chips) 
Seat 4: vinuth ($13827.87 in chips) 
Seat 6: tabby20 ($10000 in chips) 
Lucifer999: posts small blind $50
Mangs: posts big blind $100
*** HOLE CARDS ***
Dealt to Lucifer999 [5c Ad]
tabby20: folds
Lucifer999: raises $200.00 to $300
Mangs: folds
Uncalled bet ($200) returned to Lucifer999
Lucifer999: doesn't show hand
Lucifer999 collected $200 from pot
*** SUMMARY ***
Total pot $200.00 | Rake $0
Board []
Seat 1: Lucifer999 (small blind) collected ($200)
Seat 2: Mangs (big blind) folded before Flop
Seat 6: tabby20 (button) folded before Flop (didn't bet)



PokerStars Game #00327525808: Hold'em No Limit ($25/$50 USD) - 2022/04/30 09:27:17 ET
Table 'Hold'em (Min 1K Max 5K)   216' 6-max Seat #1 is the button
Seat 1: Lucifer999 ($13172.15 in chips) 
Seat 2: rahulh1 ($2824.38 in chips) 
Seat 3: kash1102 ($4733.75 in chips) 
Seat 5: Avaroni ($5000 in chips) 
Seat 6: manny007 ($1849.04 in chips) 
rahulh1: posts small blind $25
kash1102: posts big blind $50
manny007: posts big blind $50
*** HOLE CARDS ***
Dealt to Lucifer999 [Jc Ac]
Avaroni: raises $125.00 to $175
manny007: calls $125
Lucifer999: raises $725.00 to $900
rahulh1: folds
kash1102: folds
Avaroni: folds
manny007: calls $725
*** FLOP *** [Td As 8c]
manny007: checks
Lucifer999: bets $1950
manny007: folds
Uncalled bet ($1950) returned to Lucifer999
Lucifer999: doesn't show hand
Lucifer999 collected $1947.5 from pot
*** SUMMARY ***
Total pot $2050.00 | Rake $102.5
Board [Td As 8c]
Seat 1: Lucifer999 (button) collected ($1947.5)
Seat 2: rahulh1 (small blind) folded before Flop
Seat 3: kash1102 (big blind) folded before Flop
Seat 5: Avaroni folded before Flop
Seat 6: manny007 folded on the Flop



PokerStars Game #00327525936: Hold'em No Limit ($50/$100 USD) - 2022/04/30 09:28:03 ET
Table 'Hold'em (Min 25KMax 10K)    69' 6-max Seat #1 is the button
Seat 1: Lucifer999 ($12573.4 in chips) 
Seat 2: Mangs ($2400 in chips) 
Seat 4: vinuth ($13827.87 in chips) 
Seat 6: tabby20 ($10000 in chips) 
Mangs: posts small blind $50
tabby20: posts big blind $100
*** HOLE CARDS ***
Dealt to Lucifer999 [4d 8c]
Lucifer999: folds
Mangs: raises $150.00 to $250
tabby20: folds
Uncalled bet ($150) returned to Mangs
Mangs: doesn't show hand
Mangs collected $200 from pot
*** SUMMARY ***
Total pot $200.00 | Rake $0
Board []
Seat 1: Lucifer999 (button) folded before Flop (didn't bet)
Seat 2: Mangs (small blind) collected ($200)
Seat 6: tabby20 (big blind) folded before Flop



PokerStars Game #00327525903: Hold'em No Limit ($10/$25 USD) - 2022/04/30 09:27:48 ET
Table 'Hold'em (Min 500Max 2500)  1282' 6-max Seat #1 is the button
Seat 1: PANCHYOU ($811.73 in chips) 
Seat 2: kash1102 ($3236.51 in chips) 
Seat 3: devi7 ($2500 in chips) 
Seat 4: foldmybets ($2730.6 in chips) 
Seat 5: Lucifer999 ($4346.6 in chips) 
Seat 6: No username ($1135 in chips) 
kash1102: posts small blind $10
devi7: posts big blind $25
*** HOLE CARDS ***
Dealt to Lucifer999 [Ks 3c]
foldmybets: folds
Lucifer999: folds
No username: raises $38.75 to $63.75
PANCHYOU: raises $115.94 to $179.69
kash1102: folds
devi7: folds
No username: calls $115.94
*** FLOP *** [4s Ac 5h]
No username: checks
PANCHYOU: bets $125
No username: folds
Uncalled bet ($125) returned to PANCHYOU
PANCHYOU: doesn't show hand
PANCHYOU collected $370.7 from pot
*** SUMMARY ***
Total pot $394.38 | Rake $23.68
Board [4s Ac 5h]
Seat 1: PANCHYOU (button) collected ($370.7)
Seat 2: kash1102 (small blind) folded before Flop
Seat 3: devi7 (big blind) folded before Flop
Seat 4: foldmybets folded before Flop (didn't bet)
Seat 5: Lucifer999 folded before Flop (didn't bet)
Seat 6: No username folded on the Flop



PokerStars Game #00327525807: Hold'em No Limit ($10/$25 USD) - 2022/04/30 09:27:17 ET
Table 'Hold'em (Min 500Max 2500) 1001' 6-max Seat #2 is the button
Seat 1: JaspritBumrah786 ($2186.13 in chips) 
Seat 2: spaceman47157 ($3505.78 in chips) 
Seat 3: allthebest ($500 in chips) 
Seat 4: devi7 ($2518.23 in chips) 
Seat 5: Lucifer999 ($4571 in chips) 
Seat 6: spidy02 ($3804.12 in chips) 
devi7: posts small blind $10
Lucifer999: posts big blind $25
*** HOLE CARDS ***
Dealt to Lucifer999 [Tc 2c]
spidy02: raises $38.75 to $63.75
JaspritBumrah786: calls $63.75
spaceman47157: folds
devi7: folds
Lucifer999: folds
*** FLOP *** [9h 3d 4h]
spidy02: checks
JaspritBumrah786: bets $125
spidy02: folds
Uncalled bet ($125) returned to JaspritBumrah786
JaspritBumrah786: doesn't show hand
JaspritBumrah786 collected $153 from pot
*** SUMMARY ***
Total pot $162.50 | Rake $9.5
Board [9h 3d 4h]
Seat 1: JaspritBumrah786 collected ($153)
Seat 2: spaceman47157 (button) folded before Flop (didn't bet)
Seat 4: devi7 (small blind) folded before Flop
Seat 5: Lucifer999 (big blind) folded before Flop
Seat 6: spidy02 folded on the Flop



PokerStars Game #00327525998: Hold'em No Limit ($50/$100 USD) - 2022/04/30 09:28:27 ET
Table 'Hold'em (Min 25KMax 10K)    69' 6-max Seat #2 is the button
Seat 1: Lucifer999 ($12573.4 in chips) 
Seat 2: Mangs ($2500 in chips) 
Seat 4: vinuth ($13827.87 in chips) 
Seat 5: shishir1511 ($5892.99 in chips) 
Seat 6: tabby20 ($10000 in chips) 
tabby20: posts small blind $50
Lucifer999: posts big blind $100
*** HOLE CARDS ***
Dealt to Lucifer999 [9d Qh]
Mangs: raises $200.00 to $300
tabby20: folds
Lucifer999: folds
Uncalled bet ($200) returned to Mangs
Mangs: doesn't show hand
Mangs collected $250 from pot
*** SUMMARY ***
Total pot $250.00 | Rake $0
Board []
Seat 1: Lucifer999 (big blind) folded before Flop
Seat 2: Mangs (button) collected ($250)
Seat 6: tabby20 (small blind) folded before Flop



PokerStars Game #00327525957: Hold'em No Limit ($25/$50 USD) - 2022/04/30 09:28:12 ET
Table 'Hold'em (Min 1K Max 5K)   216' 6-max Seat #2 is the button
Seat 1: Lucifer999 ($14219.65 in chips) 
Seat 2: rahulh1 ($2799.38 in chips) 
Seat 3: kash1102 ($4683.75 in chips) 
Seat 5: Avaroni ($5000 in chips) 
Seat 6: manny007 ($949.04 in chips) 
kash1102: posts small blind $25
Avaroni: posts big blind $50
*** HOLE CARDS ***
Dealt to Lucifer999 [5s As]
manny007: calls $50
Lucifer999: calls $50
rahulh1: raises $125.58 to $175.58
kash1102: folds
Avaroni: folds
manny007: raises $325.73 to $501.31
Lucifer999: raises $13718.34 to $14219.65
rahulh1: folds
manny007: calls $447.73
Uncalled bet ($13270.61) returned to Lucifer999
*** FLOP *** [3d Ac Ah]
*** FLOP *** [Ks 8d 9d]
*** TURN *** [3d Ac Ah] [Jc]
*** TURN *** [3d Ac Ah] [Kc]
*** RIVER *** [3d Ac Ah Jc] [8h]
*** RIVER *** [3d Ac Ah Jc] [4s]
*** SHOW DOWN ***
Lucifer999: shows [5s As] (Pair, KK)
manny007: shows [Jd Qd] (Pair, KK)
Lucifer999 collected $1020.63 from pot
Lucifer999 collected $1020.63 from pot
*** SUMMARY ***
Total pot $2148.66 | Rake $107.4
Board [3d Ac Ah Jc 8h]
Seat 1: Lucifer999  showed [5s As] and won ($1020.63) with Pair, KK
Seat 2: rahulh1 (button) folded before Flop
Seat 3: kash1102 (small blind) folded before Flop
Seat 5: Avaroni (big blind) folded before Flop
Seat 6: manny007 showed [Jd Qd] and lost with Pair, KK



PokerStars Game #00327526068: Hold'em No Limit ($10/$25 USD) - 2022/04/30 09:28:50 ET
Table 'Hold'em (Min 500Max 2500) 1001' 6-max Seat #4 is the button
Seat 1: JaspritBumrah786 ($2303 in chips) 
Seat 2: spaceman47157 ($3505.78 in chips) 
Seat 3: allthebest ($500 in chips) 
Seat 4: devi7 ($2508.23 in chips) 
Seat 5: Lucifer999 ($4546 in chips) 
Seat 6: spidy02 ($3740.37 in chips) 
Lucifer999: posts small blind $10
spidy02: posts big blind $25
*** HOLE CARDS ***
Dealt to Lucifer999 [6h Jh]
JaspritBumrah786: folds
spaceman47157: folds
devi7: raises $50.00 to $75
Lucifer999: folds
spidy02: calls $50
*** FLOP *** [5c 3h 3d]
spidy02: checks
devi7: bets $75
spidy02: folds
Uncalled bet ($75) returned to devi7
devi7: doesn't show hand
devi7 collected $150.6 from pot
*** SUMMARY ***
Total pot $160.00 | Rake $9.4
Board [5c 3h 3d]
Seat 1: JaspritBumrah786 folded before Flop (didn't bet)
Seat 2: spaceman47157 folded before Flop (didn't bet)
Seat 4: devi7 (button) collected ($150.6)
Seat 5: Lucifer999 (small blind) folded before Flop
Seat 6: spidy02 (big blind) folded on the Flop



PokerStars Game #00327526073: Hold'em No Limit ($50/$100 USD) - 2022/04/30 09:28:51 ET
Table 'Hold'em (Min 25KMax 10K)    69' 6-max Seat #6 is the button
Seat 1: Lucifer999 ($12473.4 in chips) 
Seat 2: Mangs ($2650 in chips) 
Seat 4: vinuth ($13827.87 in chips) 
Seat 5: shishir1511 ($5892.99 in chips) 
Seat 6: tabby20 ($10000 in chips) 
Lucifer999: posts small blind $50
Mangs: posts big blind $100
shishir1511: posts big blind $100
*** HOLE CARDS ***
Dealt to Lucifer999 [2h 5h]
vinuth: checks
shishir1511: checks
tabby20: raises $500.00 to $600
Lucifer999: folds
Mangs: folds
vinuth: folds
shishir1511: folds
Uncalled bet ($500) returned to tabby20
tabby20: doesn't show hand
tabby20 collected $500 from pot
*** SUMMARY ***
Total pot $500.00 | Rake $0
Board []
Seat 1: Lucifer999 (small blind) folded before Flop
Seat 2: Mangs (big blind) folded before Flop
Seat 4: vinuth folded before Flop (didn't bet)
Seat 5: shishir1511 folded before Flop
Seat 6: tabby20 (button) collected ($500)



PokerStars Game #00327526037: Hold'em No Limit ($10/$25 USD) - 2022/04/30 09:28:41 ET
Table 'Hold'em (Min 500Max 2500)  1282' 6-max Seat #2 is the button
Seat 1: PANCHYOU ($1002.74 in chips) 
Seat 2: kash1102 ($3226.51 in chips) 
Seat 3: devi7 ($2475 in chips) 
Seat 4: foldmybets ($2730.6 in chips) 
Seat 5: Lucifer999 ($4346.6 in chips) 
Seat 6: No username ($955.31 in chips) 
devi7: posts small blind $10
foldmybets: posts big blind $25
*** HOLE CARDS ***
Dealt to Lucifer999 [Qs Kh]
Lucifer999: raises $55.00 to $80
No username: calls $80
PANCHYOU: folds
kash1102: folds
devi7: folds
foldmybets: calls $55
*** FLOP *** [4c 8d 9h]
foldmybets: checks
Lucifer999: checks
No username: checks
*** TURN *** [4c 8d 9h] [4h]
foldmybets: bets $175
Lucifer999: folds
No username: calls $175
*** RIVER *** [4c 8d 9h 4h] [6d]
foldmybets: bets $2475.6
No username: calls $700.31
Uncalled bet ($1775.29) returned to foldmybets
*** SHOW DOWN ***
foldmybets: shows [3h 3c] (Two pairs, 4433)
No username: shows [Ac Qd] (Pair, 44)
foldmybets collected $1890.62 from pot
*** SUMMARY ***
Total pot $2000.62 | Rake $110
Board [4c 8d 9h 4h 6d]
Seat 1: PANCHYOU folded before Flop (didn't bet)
Seat 2: kash1102 (button) folded before Flop (didn't bet)
Seat 3: devi7 (small blind) folded before Flop
Seat 4: foldmybets  (big blind) showed [3h 3c] and won ($1890.62) with Two pairs, 4433
Seat 5: Lucifer999 folded on the Turn
Seat 6: No username showed [Ac Qd] and lost with Pair, 44



PokerStars Game #00327526080: Hold'em No Limit ($25/$50 USD) - 2022/04/30 09:28:54 ET
Table 'Hold'em (Min 1K Max 5K)   216' 6-max Seat #3 is the button
Seat 1: Lucifer999 ($15311.87 in chips) 
Seat 2: rahulh1 ($2623.8 in chips) 
Seat 3: kash1102 ($4658.75 in chips) 
Seat 5: Avaroni ($5000 in chips) 
Avaroni: posts small blind $25
Lucifer999: posts big blind $50
*** HOLE CARDS ***
Dealt to Lucifer999 [Jd 6d]
rahulh1: folds
kash1102: folds
Avaroni: raises $100.00 to $150
Lucifer999: calls $100
*** FLOP *** [9d 7h Js]
Avaroni: checks
Lucifer999: checks
*** TURN *** [9d 7h Js] [4h]
Avaroni: bets $250
Lucifer999: calls $250
*** RIVER *** [9d 7h Js 4h] [3c]
Avaroni: checks
Lucifer999: bets $550
Avaroni: calls $550
*** SHOW DOWN ***
Lucifer999: shows [Jd 6d] (Pair, JJ)
Avaroni: doesn't show hand
Lucifer999 collected $1805 from pot
*** SUMMARY ***
Total pot $1900.00 | Rake $95
Board [9d 7h Js 4h 3c]
Seat 1: Lucifer999  (big blind) showed [Jd 6d] and won ($1805) with Pair, JJ
Seat 2: rahulh1 folded before Flop (didn't bet)
Seat 3: kash1102 (button) folded before Flop (didn't bet)
Seat 5: Avaroni (small blind) mucked



PokerStars Game #00327526232: Hold'em No Limit ($10/$25 USD) - 2022/04/30 09:29:47 ET
Table 'Hold'em (Min 500Max 2500)  1282' 6-max Seat #3 is the button
Seat 1: PANCHYOU ($1002.74 in chips) 
Seat 2: kash1102 ($3226.51 in chips) 
Seat 3: devi7 ($2465 in chips) 
Seat 4: foldmybets ($3665.91 in chips) 
Seat 5: Lucifer999 ($4266.6 in chips) 
foldmybets: posts small blind $10
Lucifer999: posts big blind $25
*** HOLE CARDS ***
Dealt to Lucifer999 [Tc 5s]
PANCHYOU: raises $55.00 to $80
kash1102: folds
devi7: folds
foldmybets: folds
Lucifer999: folds
Uncalled bet ($55) returned to PANCHYOU
PANCHYOU: doesn't show hand
PANCHYOU collected $60 from pot
*** SUMMARY ***
Total pot $60.00 | Rake $0
Board []
Seat 1: PANCHYOU collected ($60)
Seat 2: kash1102 folded before Flop (didn't bet)
Seat 3: devi7 (button) folded before Flop (didn't bet)
Seat 4: foldmybets (small blind) folded before Flop
Seat 5: Lucifer999 (big blind) folded before Flop



PokerStars Game #00327526217: Hold'em No Limit ($50/$100 USD) - 2022/04/30 09:29:41 ET
Table 'Hold'em (Min 25KMax 10K)    69' 6-max Seat #1 is the button
Seat 1: Lucifer999 ($12423.4 in chips) 
Seat 2: Mangs ($2550 in chips) 
Seat 4: vinuth ($13677.87 in chips) 
Seat 5: shishir1511 ($5792.99 in chips) 
Seat 6: tabby20 ($10400 in chips) 
Mangs: posts small blind $50
vinuth: posts big blind $100
*** HOLE CARDS ***
Dealt to Lucifer999 [8d Qh]
shishir1511: folds
tabby20: raises $200.00 to $300
Lucifer999: folds
Mangs: folds
vinuth: folds
Uncalled bet ($200) returned to tabby20
tabby20: doesn't show hand
tabby20 collected $250 from pot
*** SUMMARY ***
Total pot $250.00 | Rake $0
Board []
Seat 1: Lucifer999 (button) folded before Flop (didn't bet)
Seat 2: Mangs (small blind) folded before Flop
Seat 4: vinuth (big blind) folded before Flop
Seat 5: shishir1511 folded before Flop (didn't bet)
Seat 6: tabby20 collected ($250)



PokerStars Game #00327526322: Hold'em No Limit ($10/$25 USD) - 2022/04/30 09:30:14 ET
Table 'Hold'em (Min 500Max 2500)  1282' 6-max Seat #4 is the button
Seat 1: PANCHYOU ($1037.74 in chips) 
Seat 2: kash1102 ($3226.51 in chips) 
Seat 3: devi7 ($2465 in chips) 
Seat 4: foldmybets ($3655.91 in chips) 
Seat 5: Lucifer999 ($4241.6 in chips) 
Lucifer999: posts small blind $10
devi7: posts big blind $25
*** HOLE CARDS ***
Dealt to Lucifer999 [6d Qs]
foldmybets: folds
Lucifer999: folds
Uncalled bet ($15) returned to devi7
devi7: doesn't show hand
devi7 collected $20 from pot
*** SUMMARY ***
Total pot $20.00 | Rake $0
Board []
Seat 3: devi7 (big blind) collected ($20)
Seat 4: foldmybets (button) folded before Flop (didn't bet)
Seat 5: Lucifer999 (small blind) folded before Flop



PokerStars Game #00327526205: Hold'em No Limit ($10/$25 USD) - 2022/04/30 09:29:38 ET
Table 'Hold'em (Min 500Max 2500) 1001' 6-max Seat #5 is the button
Seat 1: JaspritBumrah786 ($2303 in chips) 
Seat 2: fishfry123 ($1094.16 in chips) 
Seat 3: allthebest ($500 in chips) 
Seat 4: devi7 ($2583.83 in chips) 
Seat 5: Lucifer999 ($4536 in chips) 
Seat 6: spidy02 ($3665.37 in chips) 
spidy02: posts small blind $10
JaspritBumrah786: posts big blind $25
*** HOLE CARDS ***
Dealt to Lucifer999 [6h Qh]
devi7: folds
Lucifer999: folds
spidy02: calls $15
JaspritBumrah786: checks
*** FLOP *** [5d 2c Jc]
spidy02: checks
JaspritBumrah786: checks
*** TURN *** [5d 2c Jc] [7d]
spidy02: checks
JaspritBumrah786: checks
*** RIVER *** [5d 2c Jc 7d] [5s]
spidy02: checks
JaspritBumrah786: checks
*** SHOW DOWN ***
spidy02: shows [9h Kc] (Pair, 55)
JaspritBumrah786: shows [2s Qd] (Two pairs, 5522)
JaspritBumrah786 collected $47.38 from pot
*** SUMMARY ***
Total pot $50.00 | Rake $2.62
Board [5d 2c Jc 7d 5s]
Seat 1: JaspritBumrah786  (big blind) showed [2s Qd] and won ($47.38) with Two pairs, 5522
Seat 4: devi7 folded before Flop (didn't bet)
Seat 5: Lucifer999 (button) folded before Flop (didn't bet)
Seat 6: spidy02 (small blind) showed [9h Kc] and lost with Pair, 55



PokerStars Game #00327526242: Hold'em No Limit ($25/$50 USD) - 2022/04/30 09:29:51 ET
Table 'Hold'em (Min 1K Max 5K)   216' 6-max Seat #5 is the button
Seat 1: Lucifer999 ($16166.87 in chips) 
Seat 2: rahulh1 ($2623.8 in chips) 
Seat 3: kash1102 ($4658.75 in chips) 
Seat 5: Avaroni ($5000 in chips) 
Lucifer999: posts small blind $25
rahulh1: posts big blind $50
*** HOLE CARDS ***
Dealt to Lucifer999 [Js 8c]
kash1102: raises $100.00 to $150
Avaroni: folds
Lucifer999: folds
rahulh1: calls $100
*** FLOP *** [Ks 9h 3d]
rahulh1: checks
kash1102: bets $154.38
rahulh1: calls $154.38
*** TURN *** [Ks 9h 3d] [5d]
rahulh1: checks
kash1102: bets $885.1
rahulh1: folds
Uncalled bet ($885.1) returned to kash1102
kash1102: doesn't show hand
kash1102 collected $602.11 from pot
*** SUMMARY ***
Total pot $633.76 | Rake $31.65
Board [Ks 9h 3d 5d]
Seat 1: Lucifer999 (small blind) folded before Flop
Seat 2: rahulh1 (big blind) folded on the Turn
Seat 3: kash1102 collected ($602.11)
Seat 5: Avaroni (button) folded before Flop (didn't bet)



PokerStars Game #00327526357: Hold'em No Limit ($10/$25 USD) - 2022/04/30 09:30:25 ET
Table 'Hold'em (Min 500Max 2500)  1282' 6-max Seat #5 is the button
Seat 2: kash1102 ($3226.51 in chips) 
Seat 3: devi7 ($2475 in chips) 
Seat 4: foldmybets ($3655.91 in chips) 
Seat 5: Lucifer999 ($4231.6 in chips) 
devi7: posts small blind $10
foldmybets: posts big blind $25
*** HOLE CARDS ***
Dealt to Lucifer999 [3s 9c]
Lucifer999: folds
devi7: raises $55.00 to $80
foldmybets: folds
Uncalled bet ($55) returned to devi7
devi7: doesn't show hand
devi7 collected $50 from pot
*** SUMMARY ***
Total pot $50.00 | Rake $0
Board []
Seat 3: devi7 (small blind) collected ($50)
Seat 4: foldmybets (big blind) folded before Flop
Seat 5: Lucifer999 (button) folded before Flop (didn't bet)



PokerStars Game #00327526414: Hold'em No Limit ($25/$50 USD) - 2022/04/30 09:30:41 ET
Table 'Hold'em (Min 1K Max 5K)   216' 6-max Seat #1 is the button
Seat 1: Lucifer999 ($16141.87 in chips) 
Seat 2: rahulh1 ($2319.42 in chips) 
Seat 3: kash1102 ($4956.48 in chips) 
Seat 5: Avaroni ($5000 in chips) 
rahulh1: posts small blind $25
Avaroni: posts big blind $50
*** HOLE CARDS ***
Dealt to Lucifer999 [Qd 7s]
Lucifer999: folds
rahulh1: folds
Uncalled bet ($25) returned to Avaroni
Avaroni: doesn't show hand
Avaroni collected $50 from pot
*** SUMMARY ***
Total pot $50.00 | Rake $0
Board []
Seat 1: Lucifer999 (button) folded before Flop (didn't bet)
Seat 2: rahulh1 (small blind) folded before Flop
Seat 5: Avaroni (big blind) collected ($50)



PokerStars Game #00327526373: Hold'em No Limit ($10/$25 USD) - 2022/04/30 09:30:30 ET
Table 'Hold'em (Min 500Max 2500) 1001' 6-max Seat #6 is the button
Seat 1: JaspritBumrah786 ($2325.38 in chips) 
Seat 2: fishfry123 ($1094.16 in chips) 
Seat 3: allthebest ($500 in chips) 
Seat 4: devi7 ($2583.83 in chips) 
Seat 5: Lucifer999 ($4536 in chips) 
Seat 6: spidy02 ($3640.37 in chips) 
JaspritBumrah786: posts small blind $10
fishfry123: posts big blind $25
*** HOLE CARDS ***
Dealt to Lucifer999 [Ad Kd]
devi7: folds
Lucifer999: raises $55.00 to $80
spidy02: folds
JaspritBumrah786: folds
fishfry123: folds
Uncalled bet ($55) returned to Lucifer999
Lucifer999: doesn't show hand
Lucifer999 collected $60 from pot
*** SUMMARY ***
Total pot $60.00 | Rake $0
Board []
Seat 1: JaspritBumrah786 (small blind) folded before Flop
Seat 2: fishfry123 (big blind) folded before Flop
Seat 4: devi7 folded before Flop (didn't bet)
Seat 5: Lucifer999 collected ($60)
Seat 6: spidy02 (button) folded before Flop (didn't bet)



PokerStars Game #00327526342: Hold'em No Limit ($50/$100 USD) - 2022/04/30 09:30:20 ET
Table 'Hold'em (Min 25KMax 10K)    69' 6-max Seat #2 is the button
Seat 1: Lucifer999 ($12423.4 in chips) 
Seat 2: Mangs ($2500 in chips) 
Seat 4: vinuth ($13577.87 in chips) 
Seat 5: shishir1511 ($5792.99 in chips) 
Seat 6: tabby20 ($10550 in chips) 
vinuth: posts small blind $50
shishir1511: posts big blind $100
*** HOLE CARDS ***
Dealt to Lucifer999 [9d 8h]
tabby20: folds
Lucifer999: folds
Mangs: raises $150.00 to $250
vinuth: folds
shishir1511: calls $150
*** FLOP *** [4h 8c 7s]
shishir1511: bets $396.84
Mangs: folds
Uncalled bet ($396.84) returned to shishir1511
shishir1511: doesn't show hand
shishir1511 collected $525.8 from pot
*** SUMMARY ***
Total pot $550.00 | Rake $24.2
Board [4h 8c 7s]
Seat 1: Lucifer999 folded before Flop (didn't bet)
Seat 2: Mangs (button) folded on the Flop
Seat 4: vinuth (small blind) folded before Flop
Seat 5: shishir1511 (big blind) collected ($525.8)
Seat 6: tabby20 folded before Flop (didn't bet)



PokerStars Game #00327526484: Hold'em No Limit ($50/$100 USD) - 2022/04/30 09:31:06 ET
Table 'Hold'em (Min 25KMax 10K)    69' 6-max Seat #4 is the button
Seat 1: Lucifer999 ($12423.4 in chips) 
Seat 2: Mangs ($2250 in chips) 
Seat 4: vinuth ($13527.87 in chips) 
Seat 5: shishir1511 ($6068.79 in chips) 
Seat 6: tabby20 ($10550 in chips) 
shishir1511: posts small blind $50
tabby20: posts big blind $100
*** HOLE CARDS ***
Dealt to Lucifer999 [Js Tc]
Lucifer999: folds
Mangs: folds
vinuth: folds
shishir1511: folds
Uncalled bet ($50) returned to tabby20
tabby20: doesn't show hand
tabby20 collected $100 from pot
*** SUMMARY ***
Total pot $100.00 | Rake $0
Board []
Seat 1: Lucifer999 folded before Flop (didn't bet)
Seat 2: Mangs folded before Flop (didn't bet)
Seat 4: vinuth (button) folded before Flop (didn't bet)
Seat 5: shishir1511 (small blind) folded before Flop
Seat 6: tabby20 (big blind) collected ($100)



PokerStars Game #00327526472: Hold'em No Limit ($10/$25 USD) - 2022/04/30 09:31:02 ET
Table 'Hold'em (Min 500Max 2500) 1001' 6-max Seat #1 is the button
Seat 1: JaspritBumrah786 ($2315.38 in chips) 
Seat 2: fishfry123 ($1069.16 in chips) 
Seat 3: allthebest ($500 in chips) 
Seat 4: devi7 ($2583.83 in chips) 
Seat 5: Lucifer999 ($4571 in chips) 
Seat 6: spidy02 ($3640.37 in chips) 
fishfry123: posts small blind $10
allthebest: posts big blind $25
*** HOLE CARDS ***
Dealt to Lucifer999 [9s 2h]
devi7: folds
Lucifer999: folds
spidy02: folds
JaspritBumrah786: raises $50.00 to $75
fishfry123: folds
allthebest: calls $50
*** FLOP *** [Kh Ks 4h]
allthebest: bets $100
JaspritBumrah786: folds
Uncalled bet ($100) returned to allthebest
allthebest: doesn't show hand
allthebest collected $150.6 from pot
*** SUMMARY ***
Total pot $160.00 | Rake $9.4
Board [Kh Ks 4h]
Seat 1: JaspritBumrah786 (button) folded on the Flop
Seat 2: fishfry123 (small blind) folded before Flop
Seat 3: allthebest (big blind) collected ($150.6)
Seat 4: devi7 folded before Flop (didn't bet)
Seat 5: Lucifer999 folded before Flop (didn't bet)
Seat 6: spidy02 folded before Flop (didn't bet)



PokerStars Game #00327526467: Hold'em No Limit ($25/$50 USD) - 2022/04/30 09:31:01 ET
Table 'Hold'em (Min 1K Max 5K)   216' 6-max Seat #2 is the button
Seat 1: Lucifer999 ($16141.87 in chips) 
Seat 2: rahulh1 ($2294.42 in chips) 
Seat 5: Avaroni ($5025 in chips) 
Avaroni: posts small blind $25
Lucifer999: posts big blind $50
*** HOLE CARDS ***
Dealt to Lucifer999 [9d 6c]
rahulh1: calls $50
Avaroni: folds
Lucifer999: checks
*** FLOP *** [5s Jd Ts]
Lucifer999: checks
rahulh1: checks
*** TURN *** [5s Jd Ts] [Kh]
Lucifer999: checks
rahulh1: checks
*** RIVER *** [5s Jd Ts Kh] [3c]
Lucifer999: bets $100
rahulh1: folds
Uncalled bet ($100) returned to Lucifer999
Lucifer999: doesn't show hand
Lucifer999 collected $118.75 from pot
*** SUMMARY ***
Total pot $125.00 | Rake $6.25
Board [5s Jd Ts Kh 3c]
Seat 1: Lucifer999 (big blind) collected ($118.75)
Seat 2: rahulh1 (button) folded on the River
Seat 5: Avaroni (small blind) folded before Flop



PokerStars Game #00327526437: Hold'em No Limit ($10/$25 USD) - 2022/04/30 09:30:51 ET
Table 'Hold'em (Min 500Max 2500)  1282' 6-max Seat #3 is the button
Seat 3: devi7 ($2500 in chips) 
Seat 4: foldmybets ($3630.91 in chips) 
Seat 5: Lucifer999 ($4231.6 in chips) 
foldmybets: posts small blind $10
Lucifer999: posts big blind $25
*** HOLE CARDS ***
Dealt to Lucifer999 [Qs 9c]
devi7: raises $50.00 to $75
foldmybets: folds
Lucifer999: calls $50
*** FLOP *** [Qh 7d 4c]
Lucifer999: checks
devi7: bets $75
Lucifer999: calls $75
*** TURN *** [Qh 7d 4c] [Ts]
Lucifer999: checks
devi7: bets $193.86
Lucifer999: calls $193.86
*** RIVER *** [Qh 7d 4c Ts] [4h]
Lucifer999: checks
devi7: bets $661.13
Lucifer999: calls $661.13
*** SHOW DOWN ***
devi7: shows [Tc Th] (Full house, TTT44)
Lucifer999: doesn't show hand
devi7 collected $1913.99 from pot
*** SUMMARY ***
Total pot $2019.98 | Rake $105.99
Board [Qh 7d 4c Ts 4h]
Seat 3: devi7  (button) showed [Tc Th] and won ($1913.99) with Full house, TTT44
Seat 4: foldmybets (small blind) folded before Flop
Seat 5: Lucifer999 (big blind) mucked



PokerStars Game #00327526583: Hold'em No Limit ($10/$25 USD) - 2022/04/30 09:31:37 ET
Table 'Hold'em (Min 500Max 2500) 1001' 6-max Seat #2 is the button
Seat 1: JaspritBumrah786 ($2240.38 in chips) 
Seat 2: fishfry123 ($1059.16 in chips) 
Seat 3: allthebest ($575.6 in chips) 
Seat 4: devi7 ($2583.83 in chips) 
Seat 5: Lucifer999 ($4571 in chips) 
Seat 6: spidy02 ($3640.37 in chips) 
allthebest: posts small blind $10
devi7: posts big blind $25
*** HOLE CARDS ***
Dealt to Lucifer999 [Jh 8c]
Lucifer999: folds
spidy02: folds
JaspritBumrah786: folds
fishfry123: folds
allthebest: folds
Uncalled bet ($15) returned to devi7
devi7: doesn't show hand
devi7 collected $20 from pot
*** SUMMARY ***
Total pot $20.00 | Rake $0
Board []
Seat 1: JaspritBumrah786 folded before Flop (didn't bet)
Seat 2: fishfry123 (button) folded before Flop (didn't bet)
Seat 3: allthebest (small blind) folded before Flop
Seat 4: devi7 (big blind) collected ($20)
Seat 5: Lucifer999 folded before Flop (didn't bet)
Seat 6: spidy02 folded before Flop (didn't bet)



PokerStars Game #00327526605: Hold'em No Limit ($25/$50 USD) - 2022/04/30 09:31:44 ET
Table 'Hold'em (Min 1K Max 5K)   216' 6-max Seat #5 is the button
Seat 1: Lucifer999 ($16210.62 in chips) 
Seat 2: rahulh1 ($2844.42 in chips) 
Seat 5: Avaroni ($5000 in chips) 
Lucifer999: posts small blind $25
rahulh1: posts big blind $50
*** HOLE CARDS ***
Dealt to Lucifer999 [3c Th]
Avaroni: raises $100.00 to $150
Lucifer999: folds
rahulh1: folds
Uncalled bet ($100) returned to Avaroni
Avaroni: doesn't show hand
Avaroni collected $125 from pot
*** SUMMARY ***
Total pot $125.00 | Rake $0
Board []
Seat 1: Lucifer999 (small blind) folded before Flop
Seat 2: rahulh1 (big blind) folded before Flop
Seat 5: Avaroni (button) collected ($125)



PokerStars Game #00327526552: Hold'em No Limit ($50/$100 USD) - 2022/04/30 09:31:28 ET
Table 'Hold'em (Min 25KMax 10K)    69' 6-max Seat #5 is the button
Seat 1: Lucifer999 ($12423.4 in chips) 
Seat 2: Mangs ($2250 in chips) 
Seat 4: vinuth ($13527.87 in chips) 
Seat 5: shishir1511 ($6018.79 in chips) 
Seat 6: tabby20 ($10600 in chips) 
tabby20: posts small blind $50
Lucifer999: posts big blind $100
*** HOLE CARDS ***
Dealt to Lucifer999 [Ah Ks]
Mangs: calls $100
vinuth: folds
shishir1511: raises $350.00 to $450
tabby20: folds
Lucifer999: raises $1350.00 to $1800
Mangs: folds
shishir1511: calls $1350
*** FLOP *** [5s 9c Kc]
Lucifer999: checks
shishir1511: bets $1897.54
Lucifer999: raises $7402.46 to $9300
shishir1511: calls $2321.25
Uncalled bet ($5081.21) returned to Lucifer999
*** TURN *** [5s 9c Kc] [2s]
*** TURN *** [5s 9c Kc] [8d]
*** RIVER *** [5s 9c Kc 2s] [3c]
*** RIVER *** [5s 9c Kc 2s] [Qs]
*** SHOW DOWN ***
Lucifer999: shows [Ah Ks] (Pair, KK)
shishir1511: shows [8c Th] (Pair, 88)
Lucifer999 collected $5873.79 from pot
Lucifer999 collected $5873.79 from pot
*** SUMMARY ***
Total pot $12187.58 | Rake $440
Board [5s 9c Kc 2s 3c]
Seat 1: Lucifer999  (big blind) showed [Ah Ks] and won ($5873.79) with Pair, KK
Seat 2: Mangs folded before Flop
Seat 4: vinuth folded before Flop (didn't bet)
Seat 5: shishir1511 (button) showed [8c Th] and lost with Pair, 88
Seat 6: tabby20 (small blind) folded before Flop



PokerStars Game #00327526686: Hold'em No Limit ($25/$50 USD) - 2022/04/30 09:32:08 ET
Table 'Hold'em (Min 1K Max 5K)   216' 6-max Seat #1 is the button
Seat 1: Lucifer999 ($16185.62 in chips) 
Seat 2: rahulh1 ($2794.42 in chips) 
Seat 5: Avaroni ($5075 in chips) 
rahulh1: posts small blind $25
Avaroni: posts big blind $50
*** HOLE CARDS ***
Dealt to Lucifer999 [6s 7c]
Lucifer999: raises $100.00 to $150
rahulh1: folds
Avaroni: folds
Uncalled bet ($100) returned to Lucifer999
Lucifer999: doesn't show hand
Lucifer999 collected $125 from pot
*** SUMMARY ***
Total pot $125.00 | Rake $0
Board []
Seat 1: Lucifer999 (button) collected ($125)
Seat 2: rahulh1 (small blind) folded before Flop
Seat 5: Avaroni (big blind) folded before Flop



PokerStars Game #00327526673: Hold'em No Limit ($10/$25 USD) - 2022/04/30 09:32:05 ET
Table 'Hold'em (Min 500Max 2500) 1001' 6-max Seat #3 is the button
Seat 1: JaspritBumrah786 ($2240.38 in chips) 
Seat 2: fishfry123 ($1059.16 in chips) 
Seat 3: allthebest ($2025 in chips) 
Seat 4: devi7 ($2593.83 in chips) 
Seat 5: Lucifer999 ($4571 in chips) 
Seat 6: spidy02 ($3640.37 in chips) 
devi7: posts small blind $10
Lucifer999: posts big blind $25
*** HOLE CARDS ***
Dealt to Lucifer999 [Ah Qd]
spidy02: folds
JaspritBumrah786: folds
fishfry123: calls $25
allthebest: folds
devi7: folds
Lucifer999: raises $75.00 to $100
fishfry123: folds
Uncalled bet ($75) returned to Lucifer999
Lucifer999: doesn't show hand
Lucifer999 collected $60 from pot
*** SUMMARY ***
Total pot $60.00 | Rake $0
Board []
Seat 1: JaspritBumrah786 folded before Flop (didn't bet)
Seat 2: fishfry123 folded before Flop
Seat 3: allthebest (button) folded before Flop (didn't bet)
Seat 4: devi7 (small blind) folded before Flop
Seat 5: Lucifer999 (big blind) collected ($60)
Seat 6: spidy02 folded before Flop (didn't bet)



PokerStars Game #00327526770: Hold'em No Limit ($25/$50 USD) - 2022/04/30 09:32:39 ET
Table 'Hold'em (Min 1K Max 5K)   216' 6-max Seat #2 is the button
Seat 1: Lucifer999 ($16260.62 in chips) 
Seat 2: rahulh1 ($2769.42 in chips) 
Seat 5: Avaroni ($5025 in chips) 
Avaroni: posts small blind $25
Lucifer999: posts big blind $50
*** HOLE CARDS ***
Dealt to Lucifer999 [6c Kh]
rahulh1: folds
Avaroni: folds
Uncalled bet ($25) returned to Lucifer999
Lucifer999: doesn't show hand
Lucifer999 collected $50 from pot
*** SUMMARY ***
Total pot $50.00 | Rake $0
Board []
Seat 1: Lucifer999 (big blind) collected ($50)
Seat 2: rahulh1 (button) folded before Flop (didn't bet)
Seat 5: Avaroni (small blind) folded before Flop



PokerStars Game #00327526630: Hold'em No Limit ($10/$25 USD) - 2022/04/30 09:31:51 ET
Table 'Hold'em (Min 500Max 2500)  1282' 6-max Seat #4 is the button
Seat 3: devi7 ($3409 in chips) 
Seat 4: foldmybets ($3620.91 in chips) 
Seat 5: Lucifer999 ($3226.61 in chips) 
Lucifer999: posts small blind $10
devi7: posts big blind $25
*** HOLE CARDS ***
Dealt to Lucifer999 [9h 9s]
foldmybets: raises $50.00 to $75
Lucifer999: raises $275.00 to $350
devi7: folds
foldmybets: calls $275
*** FLOP *** [2h 3h Th]
Lucifer999: checks
foldmybets: bets $550
Lucifer999: calls $550
*** TURN *** [2h 3h Th] [Jd]
Lucifer999: checks
foldmybets: checks
*** RIVER *** [2h 3h Th Jd] [2c]
Lucifer999: checks
foldmybets: checks
*** SHOW DOWN ***
foldmybets: shows [Qd Kd] (Pair, 22)
Lucifer999: shows [9h 9s] (Two pairs, 9922)
Lucifer999 collected $1729.19 from pot
*** SUMMARY ***
Total pot $1825.00 | Rake $95.81
Board [2h 3h Th Jd 2c]
Seat 3: devi7 (big blind) folded before Flop
Seat 4: foldmybets (button) showed [Qd Kd] and lost with Pair, 22
Seat 5: Lucifer999  (small blind) showed [9h 9s] and won ($1729.19) with Two pairs, 9922



PokerStars Game #00327526725: Hold'em No Limit ($50/$100 USD) - 2022/04/30 09:32:24 ET
Table 'Hold'em (Min 25KMax 10K)    69' 6-max Seat #6 is the button
Seat 1: Lucifer999 ($18152.19 in chips) 
Seat 2: Mangs ($2150 in chips) 
Seat 4: vinuth ($13527.87 in chips) 
Seat 6: tabby20 ($10550 in chips) 
Lucifer999: posts small blind $50
Mangs: posts big blind $100
*** HOLE CARDS ***
Dealt to Lucifer999 [9d Qd]
vinuth: raises $200.00 to $300
tabby20: calls $300
Lucifer999: folds
Mangs: folds
*** FLOP *** [9s Ks Js]
vinuth: bets $500
tabby20: folds
Uncalled bet ($500) returned to vinuth
vinuth: doesn't show hand
vinuth collected $717 from pot
*** SUMMARY ***
Total pot $750.00 | Rake $33
Board [9s Ks Js]
Seat 1: Lucifer999 (small blind) folded before Flop
Seat 2: Mangs (big blind) folded before Flop
Seat 4: vinuth collected ($717)
Seat 6: tabby20 (button) folded on the Flop



PokerStars Game #00327526778: Hold'em No Limit ($10/$25 USD) - 2022/04/30 09:32:42 ET
Table 'Hold'em (Min 500Max 2500) 1001' 6-max Seat #4 is the button
Seat 1: JaspritBumrah786 ($2240.38 in chips) 
Seat 2: fishfry123 ($1034.16 in chips) 
Seat 3: allthebest ($2025 in chips) 
Seat 4: devi7 ($2583.83 in chips) 
Seat 5: Lucifer999 ($4606 in chips) 
Seat 6: spidy02 ($3640.37 in chips) 
Lucifer999: posts small blind $10
JaspritBumrah786: posts big blind $25
*** HOLE CARDS ***
Dealt to Lucifer999 [9c Jc]
fishfry123: calls $25
allthebest: folds
devi7: folds
Lucifer999: raises $85.00 to $110
JaspritBumrah786: folds
fishfry123: calls $85
*** FLOP *** [2c Qc 4c]
Lucifer999: bets $110
fishfry123: folds
Uncalled bet ($110) returned to Lucifer999
Lucifer999: doesn't show hand
Lucifer999 collected $230.14 from pot
*** SUMMARY ***
Total pot $245.00 | Rake $14.86
Board [2c Qc 4c]
Seat 1: JaspritBumrah786 (big blind) folded before Flop
Seat 2: fishfry123 folded on the Flop
Seat 3: allthebest folded before Flop (didn't bet)
Seat 4: devi7 (button) folded before Flop (didn't bet)
Seat 5: Lucifer999 (small blind) collected ($230.14)



PokerStars Game #00327526876: Hold'em No Limit ($10/$25 USD) - 2022/04/30 09:33:16 ET
Table 'Hold'em (Min 500Max 2500) 1001' 6-max Seat #5 is the button
Seat 1: JaspritBumrah786 ($2215.38 in chips) 
Seat 2: fishfry123 ($924.16 in chips) 
Seat 3: allthebest ($2025 in chips) 
Seat 4: devi7 ($2583.83 in chips) 
Seat 5: Lucifer999 ($4726.14 in chips) 
Seat 6: spidy02 ($3640.37 in chips) 
JaspritBumrah786: posts small blind $10
fishfry123: posts big blind $25
*** HOLE CARDS ***
Dealt to Lucifer999 [9h 3c]
allthebest: folds
devi7: folds
Lucifer999: folds
JaspritBumrah786: folds
Uncalled bet ($15) returned to fishfry123
fishfry123: doesn't show hand
fishfry123 collected $20 from pot
*** SUMMARY ***
Total pot $20.00 | Rake $0
Board []
Seat 1: JaspritBumrah786 (small blind) folded before Flop
Seat 2: fishfry123 (big blind) collected ($20)
Seat 3: allthebest folded before Flop (didn't bet)
Seat 4: devi7 folded before Flop (didn't bet)
Seat 5: Lucifer999 (button) folded before Flop (didn't bet)



PokerStars Game #00327526810: Hold'em No Limit ($25/$50 USD) - 2022/04/30 09:32:52 ET
Table 'Hold'em (Min 1K Max 5K)   216' 6-max Seat #5 is the button
Seat 1: Lucifer999 ($16285.62 in chips) 
Seat 2: rahulh1 ($2769.42 in chips) 
Seat 5: Avaroni ($5000 in chips) 
Lucifer999: posts small blind $25
rahulh1: posts big blind $50
*** HOLE CARDS ***
Dealt to Lucifer999 [2s Td]
Avaroni: raises $100.00 to $150
Lucifer999: folds
rahulh1: calls $100
*** FLOP *** [2h 6d 8c]
rahulh1: checks
Avaroni: checks
*** TURN *** [2h 6d 8c] [9s]
rahulh1: bets $50
Avaroni: raises $179.38 to $229.38
rahulh1: calls $179.38
*** RIVER *** [2h 6d 8c 9s] [5c]
rahulh1: checks
Avaroni: checks
*** SHOW DOWN ***
Avaroni: shows [3s Qd] (High card, Q)
rahulh1: shows [4d 5d] (Pair, 55)
rahulh1 collected $744.61 from pot
*** SUMMARY ***
Total pot $783.76 | Rake $39.15
Board [2h 6d 8c 9s 5c]
Seat 1: Lucifer999 (small blind) folded before Flop
Seat 2: rahulh1  (big blind) showed [4d 5d] and won ($744.61) with Pair, 55
Seat 5: Avaroni (button) showed [3s Qd] and lost with High card, Q



PokerStars Game #00327526813: Hold'em No Limit ($10/$25 USD) - 2022/04/30 09:32:53 ET
Table 'Hold'em (Min 500Max 2500)  1282' 6-max Seat #3 is the button
Seat 3: devi7 ($3384 in chips) 
Seat 4: foldmybets ($2720.91 in chips) 
Seat 5: Lucifer999 ($4055.8 in chips) 
devi7: posts small blind $10
Lucifer999: posts big blind $25
*** HOLE CARDS ***
Dealt to Lucifer999 [Kc 4h]
devi7: raises $45.00 to $70
Lucifer999: calls $45
*** FLOP *** [6c 4d 5s]
Lucifer999: checks
devi7: bets $50
Lucifer999: raises $110.00 to $160
devi7: calls $110
*** TURN *** [6c 4d 5s] [3c]
Lucifer999: bets $220
devi7: raises $440.00 to $660
Lucifer999: folds
Uncalled bet ($440) returned to devi7
devi7: doesn't show hand
devi7 collected $859.5 from pot
*** SUMMARY ***
Total pot $900.00 | Rake $40.5
Board [6c 4d 5s 3c]
Seat 3: devi7 (button) (small blind) collected ($859.5)
Seat 5: Lucifer999 (big blind) folded on the Turn



PokerStars Game #00327526988: Hold'em No Limit ($25/$50 USD) - 2022/04/30 09:33:52 ET
Table 'Hold'em (Min 1K Max 5K)   216' 6-max Seat #1 is the button
Seat 1: Lucifer999 ($16260.62 in chips) 
Seat 2: rahulh1 ($3134.65 in chips) 
Seat 5: Avaroni ($5000 in chips) 
rahulh1: posts small blind $25
Avaroni: posts big blind $50
*** HOLE CARDS ***
Dealt to Lucifer999 [6d 7d]
Lucifer999: raises $100.00 to $150
rahulh1: folds
Avaroni: folds
Uncalled bet ($100) returned to Lucifer999
Lucifer999: doesn't show hand
Lucifer999 collected $125 from pot
*** SUMMARY ***
Total pot $125.00 | Rake $0
Board []
Seat 1: Lucifer999 (button) collected ($125)
Seat 2: rahulh1 (small blind) folded before Flop
Seat 5: Avaroni (big blind) folded before Flop



PokerStars Game #00327526995: Hold'em No Limit ($10/$25 USD) - 2022/04/30 09:33:55 ET
Table 'Hold'em (Min 500Max 2500)  1282' 6-max Seat #5 is the button
Seat 3: devi7 ($3793.5 in chips) 
Seat 5: Lucifer999 ($3605.8 in chips) 
Lucifer999: posts small blind $10
devi7: posts big blind $25
*** HOLE CARDS ***
Dealt to Lucifer999 [5d 6d]
Lucifer999: raises $45.00 to $70
devi7: calls $45
*** FLOP *** [8h Qd Td]
devi7: checks
Lucifer999: bets $50
devi7: folds
Uncalled bet ($50) returned to Lucifer999
Lucifer999: doesn't show hand
Lucifer999 collected $133.7 from pot
*** SUMMARY ***
Total pot $140.00 | Rake $6.3
Board [8h Qd Td]
Seat 3: devi7 (big blind) folded on the Flop
Seat 5: Lucifer999 (button) (small blind) collected ($133.7)



PokerStars Game #00327526838: Hold'em No Limit ($50/$100 USD) - 2022/04/30 09:33:00 ET
Table 'Hold'em (Min 25KMax 10K)    69' 6-max Seat #1 is the button
Seat 1: Lucifer999 ($18102.19 in chips) 
Seat 2: Mangs ($2050 in chips) 
Seat 4: vinuth ($13944.87 in chips) 
Seat 6: tabby20 ($10250 in chips) 
Mangs: posts small blind $50
vinuth: posts big blind $100
*** HOLE CARDS ***
Dealt to Lucifer999 [Ah 5h]
tabby20: folds
Lucifer999: raises $200.00 to $300
Mangs: calls $250
vinuth: calls $200
*** FLOP *** [9h 2c Qh]
Mangs: checks
vinuth: checks
Lucifer999: bets $550
Mangs: calls $550
vinuth: raises $1295.59 to $1845.59
Lucifer999: calls $1295.59
Mangs: calls $1200
*** TURN *** [9h 2c Qh] [5d]
vinuth: bets $11799.28
Lucifer999: folds
Uncalled bet ($11799.28) returned to vinuth
*** RIVER *** [9h 2c Qh 5d] [4d]
*** RIVER *** [9h 2c Qh 5d] [7h]
vinuth collected $91.39 from side pot-1
vinuth collected $91.39 from side pot-1
*** SHOW DOWN ***
Mangs: shows [Js Kh] (High card, K)
vinuth: shows [2d 2h] (Three of a kind, 222)
vinuth collected $2939.7 from pot
vinuth collected $2939.7 from pot
*** SUMMARY ***
Total pot $6341.18 Main pot $6150.00. Side pot $191.18 | Rake $279
Board [9h 2c Qh 5d 4d]
Seat 1: Lucifer999 (button) folded on the Turn
Seat 2: Mangs (small blind) showed [Js Kh] and lost with High card, K
Seat 4: vinuth  (big blind) showed [2d 2h] and won ($3122.48) with Three of a kind, 222
Seat 6: tabby20 folded before Flop (didn't bet)



PokerStars Game #00327527043: Hold'em No Limit ($25/$50 USD) - 2022/04/30 09:34:15 ET
Table 'Hold'em (Min 1K Max 5K)   216' 6-max Seat #2 is the button
Seat 1: Lucifer999 ($16335.62 in chips) 
Seat 2: rahulh1 ($3109.65 in chips) 
Seat 5: Avaroni ($5000 in chips) 
Avaroni: posts small blind $25
Lucifer999: posts big blind $50
*** HOLE CARDS ***
Dealt to Lucifer999 [4d 5s]
rahulh1: folds
Avaroni: folds
Uncalled bet ($25) returned to Lucifer999
Lucifer999: doesn't show hand
Lucifer999 collected $50 from pot
*** SUMMARY ***
Total pot $50.00 | Rake $0
Board []
Seat 1: Lucifer999 (big blind) collected ($50)
Seat 2: rahulh1 (button) folded before Flop (didn't bet)
Seat 5: Avaroni (small blind) folded before Flop



PokerStars Game #00327526948: Hold'em No Limit ($10/$25 USD) - 2022/04/30 09:33:40 ET
Table 'Hold'em (Min 500Max 2500) 1001' 6-max Seat #1 is the button
Seat 1: JaspritBumrah786 ($2205.38 in chips) 
Seat 2: fishfry123 ($934.16 in chips) 
Seat 3: allthebest ($2025 in chips) 
Seat 4: devi7 ($2583.83 in chips) 
Seat 5: Lucifer999 ($4726.14 in chips) 
Seat 6: spidy02 ($3640.37 in chips) 
fishfry123: posts small blind $10
allthebest: posts big blind $25
spidy02: posts small & big blinds $35
*** HOLE CARDS ***
Dealt to Lucifer999 [7h 3c]
devi7: folds
Lucifer999: folds
spidy02: checks
JaspritBumrah786: folds
fishfry123: calls $15
allthebest: raises $90.00 to $125
spidy02: folds
fishfry123: folds
Uncalled bet ($100) returned to allthebest
allthebest: doesn't show hand
allthebest collected $85 from pot
*** SUMMARY ***
Total pot $85.00 | Rake $0
Board []
Seat 1: JaspritBumrah786 (button) folded before Flop (didn't bet)
Seat 2: fishfry123 (small blind) folded before Flop
Seat 3: allthebest (big blind) collected ($85)
Seat 4: devi7 folded before Flop (didn't bet)
Seat 5: Lucifer999 folded before Flop (didn't bet)
Seat 6: spidy02 folded before Flop



PokerStars Game #00327527073: Hold'em No Limit ($10/$25 USD) - 2022/04/30 09:34:25 ET
Table 'Hold'em (Min 500Max 2500)  1282' 6-max Seat #3 is the button
Seat 3: devi7 ($3723.5 in chips) 
Seat 5: Lucifer999 ($3669.5 in chips) 
devi7: posts small blind $10
Lucifer999: posts big blind $25
*** HOLE CARDS ***
Dealt to Lucifer999 [2s 3h]
devi7: raises $45.00 to $70
Lucifer999: folds
Uncalled bet ($45) returned to devi7
devi7: doesn't show hand
devi7 collected $50 from pot
*** SUMMARY ***
Total pot $50.00 | Rake $0
Board []
Seat 3: devi7 (button) (small blind) collected ($50)
Seat 5: Lucifer999 (big blind) folded before Flop



PokerStars Game #00327527087: Hold'em No Limit ($50/$100 USD) - 2022/04/30 09:34:31 ET
Table 'Hold'em (Min 25KMax 10K)    69' 6-max Seat #4 is the button
Seat 1: Lucifer999 ($15956.6 in chips) 
Seat 4: vinuth ($17861.46 in chips) 
Seat 6: tabby20 ($10250 in chips) 
tabby20: posts small blind $50
Lucifer999: posts big blind $100
*** HOLE CARDS ***
Dealt to Lucifer999 [4c 9c]
vinuth: folds
tabby20: folds
Uncalled bet ($50) returned to Lucifer999
Lucifer999: doesn't show hand
Lucifer999 collected $100 from pot
*** SUMMARY ***
Total pot $100.00 | Rake $0
Board []
Seat 1: Lucifer999 (big blind) collected ($100)
Seat 4: vinuth (button) folded before Flop (didn't bet)
Seat 6: tabby20 (small blind) folded before Flop



PokerStars Game #00327527094: Hold'em No Limit ($25/$50 USD) - 2022/04/30 09:34:33 ET
Table 'Hold'em (Min 1K Max 5K)   216' 6-max Seat #5 is the button
Seat 1: Lucifer999 ($16360.62 in chips) 
Seat 2: rahulh1 ($3109.65 in chips) 
Seat 5: Avaroni ($5000 in chips) 
Lucifer999: posts small blind $25
rahulh1: posts big blind $50
*** HOLE CARDS ***
Dealt to Lucifer999 [5d 6h]
Avaroni: raises $100.00 to $150
Lucifer999: folds
rahulh1: folds
Uncalled bet ($100) returned to Avaroni
Avaroni: doesn't show hand
Avaroni collected $125 from pot
*** SUMMARY ***
Total pot $125.00 | Rake $0
Board []
Seat 1: Lucifer999 (small blind) folded before Flop
Seat 2: rahulh1 (big blind) folded before Flop
Seat 5: Avaroni (button) collected ($125)



PokerStars Game #00327527113: Hold'em No Limit ($10/$25 USD) - 2022/04/30 09:34:38 ET
Table 'Hold'em (Min 500Max 2500)  1282' 6-max Seat #5 is the button
Seat 3: devi7 ($3748.5 in chips) 
Seat 5: Lucifer999 ($3644.5 in chips) 
Lucifer999: posts small blind $10
devi7: posts big blind $25
*** HOLE CARDS ***
Dealt to Lucifer999 [5s 5d]
Lucifer999: raises $45.00 to $70
devi7: raises $165.00 to $235
Lucifer999: raises $305.00 to $540
devi7: folds
Uncalled bet ($305) returned to Lucifer999
Lucifer999: doesn't show hand
Lucifer999 collected $470 from pot
*** SUMMARY ***
Total pot $470.00 | Rake $0
Board []
Seat 3: devi7 (big blind) folded before Flop
Seat 5: Lucifer999 (button) (small blind) collected ($470)



PokerStars Game #00327527099: Hold'em No Limit ($10/$25 USD) - 2022/04/30 09:34:34 ET
Table 'Hold'em (Min 500Max 2500) 1001' 6-max Seat #2 is the button
Seat 1: JaspritBumrah786 ($2205.38 in chips) 
Seat 2: fishfry123 ($909.16 in chips) 
Seat 3: allthebest ($2210 in chips) 
Seat 4: devi7 ($2583.83 in chips) 
Seat 5: Lucifer999 ($4726.14 in chips) 
Seat 6: spidy02 ($3605.37 in chips) 
allthebest: posts small blind $10
devi7: posts big blind $25
*** HOLE CARDS ***
Dealt to Lucifer999 [Kd Td]
Lucifer999: raises $55.00 to $80
spidy02: folds
JaspritBumrah786: folds
fishfry123: raises $195.00 to $275
allthebest: folds
devi7: folds
Lucifer999: folds
Uncalled bet ($195) returned to fishfry123
fishfry123: doesn't show hand
fishfry123 collected $195 from pot
*** SUMMARY ***
Total pot $195.00 | Rake $0
Board []
Seat 1: JaspritBumrah786 folded before Flop (didn't bet)
Seat 2: fishfry123 (button) collected ($195)
Seat 3: allthebest (small blind) folded before Flop
Seat 4: devi7 (big blind) folded before Flop
Seat 5: Lucifer999 folded before Flop
Seat 6: spidy02 folded before Flop (didn't bet)



PokerStars Game #00327527120: Hold'em No Limit ($50/$100 USD) - 2022/04/30 09:34:41 ET
Table 'Hold'em (Min 25KMax 10K)    69' 6-max Seat #6 is the button
Seat 1: Lucifer999 ($16006.6 in chips) 
Seat 3: bettercall7208 ($10000 in chips) 
Seat 4: vinuth ($17861.46 in chips) 
Seat 6: tabby20 ($10200 in chips) 
Lucifer999: posts small blind $50
vinuth: posts big blind $100
*** HOLE CARDS ***
Dealt to Lucifer999 [5s 7c]
tabby20: raises $200.00 to $300
Lucifer999: folds
vinuth: calls $200
*** FLOP *** [9c 2c 7d]
vinuth: checks
tabby20: bets $450
vinuth: folds
Uncalled bet ($450) returned to tabby20
tabby20: doesn't show hand
tabby20 collected $621.4 from pot
*** SUMMARY ***
Total pot $650.00 | Rake $28.6
Board [9c 2c 7d]
Seat 1: Lucifer999 (small blind) folded before Flop
Seat 4: vinuth (big blind) folded on the Flop
Seat 6: tabby20 (button) collected ($621.4)



PokerStars Game #00327527159: Hold'em No Limit ($25/$50 USD) - 2022/04/30 09:34:56 ET
Table 'Hold'em (Min 1K Max 5K)   216' 6-max Seat #1 is the button
Seat 1: Lucifer999 ($16335.62 in chips) 
Seat 2: rahulh1 ($3059.65 in chips) 
Seat 5: Avaroni ($5075 in chips) 
rahulh1: posts small blind $25
Avaroni: posts big blind $50
*** HOLE CARDS ***
Dealt to Lucifer999 [Kd 3c]
Lucifer999: folds
rahulh1: calls $25
Avaroni: raises $100.00 to $150
rahulh1: calls $100
*** FLOP *** [4s 3d Js]
rahulh1: checks
Avaroni: bets $175
rahulh1: folds
Uncalled bet ($175) returned to Avaroni
Avaroni: doesn't show hand
Avaroni collected $285 from pot
*** SUMMARY ***
Total pot $300.00 | Rake $15
Board [4s 3d Js]
Seat 1: Lucifer999 (button) folded before Flop (didn't bet)
Seat 2: rahulh1 (small blind) folded on the Flop
Seat 5: Avaroni (big blind) collected ($285)



PokerStars Game #00327527179: Hold'em No Limit ($10/$25 USD) - 2022/04/30 09:35:04 ET
Table 'Hold'em (Min 500Max 2500)  1282' 6-max Seat #3 is the button
Seat 3: devi7 ($3513.5 in chips) 
Seat 5: Lucifer999 ($3879.5 in chips) 
devi7: posts small blind $10
Lucifer999: posts big blind $25
*** HOLE CARDS ***
Dealt to Lucifer999 [Ks Kc]
devi7: raises $45.00 to $70
Lucifer999: raises $160.00 to $230
devi7: calls $160
*** FLOP *** [5h Td 6s]
Lucifer999: checks
devi7: checks
*** TURN *** [5h Td 6s] [Jd]
Lucifer999: bets $380
devi7: calls $380
*** RIVER *** [5h Td 6s Jd] [9s]
Lucifer999: bets $1100
devi7: calls $1100
*** SHOW DOWN ***
Lucifer999: shows [Ks Kc] (Pair, KK)
devi7: doesn't show hand
Lucifer999 collected $3280 from pot
*** SUMMARY ***
Total pot $3420.00 | Rake $140
Board [5h Td 6s Jd 9s]
Seat 3: devi7 (button) (small blind) mucked
Seat 5: Lucifer999  (big blind) showed [Ks Kc] and won ($3280) with Pair, KK



PokerStars Game #00327527224: Hold'em No Limit ($10/$25 USD) - 2022/04/30 09:35:20 ET
Table 'Hold'em (Min 500Max 2500) 1001' 6-max Seat #3 is the button
Seat 1: JaspritBumrah786 ($2205.38 in chips) 
Seat 2: fishfry123 ($1024.16 in chips) 
Seat 3: allthebest ($2200 in chips) 
Seat 4: devi7 ($2558.83 in chips) 
Seat 5: Lucifer999 ($4646.14 in chips) 
Seat 6: spidy02 ($3605.37 in chips) 
devi7: posts small blind $10
Lucifer999: posts big blind $25
*** HOLE CARDS ***
Dealt to Lucifer999 [2d 7c]
spidy02: raises $38.75 to $63.75
JaspritBumrah786: calls $63.75
fishfry123: folds
allthebest: folds
devi7: folds
Lucifer999: folds
*** FLOP *** [Ts 6d Jh]
spidy02: bets $89.71
JaspritBumrah786: folds
Uncalled bet ($89.71) returned to spidy02
spidy02: doesn't show hand
spidy02 collected $153 from pot
*** SUMMARY ***
Total pot $162.50 | Rake $9.5
Board [Ts 6d Jh]
Seat 1: JaspritBumrah786 folded on the Flop
Seat 2: fishfry123 folded before Flop (didn't bet)
Seat 3: allthebest (button) folded before Flop (didn't bet)
Seat 4: devi7 (small blind) folded before Flop
Seat 5: Lucifer999 (big blind) folded before Flop
Seat 6: spidy02 collected ($153)



PokerStars Game #00327527239: Hold'em No Limit ($50/$100 USD) - 2022/04/30 09:35:27 ET
Table 'Hold'em (Min 25KMax 10K)    69' 6-max Seat #1 is the button
Seat 1: Lucifer999 ($15956.6 in chips) 
Seat 3: bettercall7208 ($10000 in chips) 
Seat 4: vinuth ($17561.46 in chips) 
Seat 6: tabby20 ($10521.4 in chips) 
vinuth: posts small blind $50
tabby20: posts big blind $100
*** HOLE CARDS ***
Dealt to Lucifer999 [6c Kh]
Lucifer999: folds
vinuth: calls $50
tabby20: checks
*** FLOP *** [Kc 6h 9s]
vinuth: bets $200
tabby20: calls $200
*** TURN *** [Kc 6h 9s] [7s]
vinuth: bets $430.2
tabby20: folds
Uncalled bet ($430.2) returned to vinuth
vinuth: doesn't show hand
vinuth collected $573.6 from pot
*** SUMMARY ***
Total pot $600.00 | Rake $26.4
Board [Kc 6h 9s 7s]
Seat 1: Lucifer999 (button) folded before Flop (didn't bet)
Seat 4: vinuth (small blind) collected ($573.6)
Seat 6: tabby20 (big blind) folded on the Turn



PokerStars Game #00327527248: Hold'em No Limit ($25/$50 USD) - 2022/04/30 09:35:32 ET
Table 'Hold'em (Min 1K Max 5K)   216' 6-max Seat #2 is the button
Seat 1: Lucifer999 ($16335.62 in chips) 
Seat 2: rahulh1 ($2909.65 in chips) 
Seat 4: raj90341 ($1000 in chips) 
Seat 5: Avaroni ($5210 in chips) 
Avaroni: posts small blind $25
Lucifer999: posts big blind $50
*** HOLE CARDS ***
Dealt to Lucifer999 [7c 8s]
rahulh1: calls $50
Avaroni: folds
Lucifer999: checks
*** FLOP *** [5c 5s 4h]
Lucifer999: bets $100
rahulh1: calls $100
*** TURN *** [5c 5s 4h] [Js]
Lucifer999: bets $225
rahulh1: folds
Uncalled bet ($225) returned to Lucifer999
Lucifer999: doesn't show hand
Lucifer999 collected $308.75 from pot
*** SUMMARY ***
Total pot $325.00 | Rake $16.25
Board [5c 5s 4h Js]
Seat 1: Lucifer999 (big blind) collected ($308.75)
Seat 2: rahulh1 (button) folded on the Turn
Seat 5: Avaroni (small blind) folded before Flop



PokerStars Game #00327527338: Hold'em No Limit ($10/$25 USD) - 2022/04/30 09:36:04 ET
Table 'Hold'em (Min 500Max 2500)  1282' 6-max Seat #5 is the button
Seat 3: devi7 ($2500 in chips) 
Seat 5: Lucifer999 ($5449.5 in chips) 
Lucifer999: posts small blind $10
devi7: posts big blind $25
*** HOLE CARDS ***
Dealt to Lucifer999 [9h 8d]
Lucifer999: raises $25.00 to $50
devi7: raises $145.00 to $195
Lucifer999: folds
Uncalled bet ($145) returned to devi7
devi7: doesn't show hand
devi7 collected $100 from pot
*** SUMMARY ***
Total pot $100.00 | Rake $0
Board []
Seat 3: devi7 (big blind) collected ($100)
Seat 5: Lucifer999 (button) (small blind) folded before Flop



PokerStars Game #00327527339: Hold'em No Limit ($10/$25 USD) - 2022/04/30 09:36:04 ET
Table 'Hold'em (Min 500Max 2500) 1001' 6-max Seat #4 is the button
Seat 1: JaspritBumrah786 ($2141.63 in chips) 
Seat 2: fishfry123 ($1024.16 in chips) 
Seat 3: allthebest ($2200 in chips) 
Seat 4: devi7 ($2548.83 in chips) 
Seat 5: Lucifer999 ($4621.14 in chips) 
Seat 6: spidy02 ($3694.62 in chips) 
Lucifer999: posts small blind $10
spidy02: posts big blind $25
*** HOLE CARDS ***
Dealt to Lucifer999 [8c 8h]
JaspritBumrah786: folds
fishfry123: folds
allthebest: folds
devi7: folds
Lucifer999: raises $55.00 to $80
spidy02: folds
Uncalled bet ($55) returned to Lucifer999
Lucifer999: doesn't show hand
Lucifer999 collected $50 from pot
*** SUMMARY ***
Total pot $50.00 | Rake $0
Board []
Seat 1: JaspritBumrah786 folded before Flop (didn't bet)
Seat 2: fishfry123 folded before Flop (didn't bet)
Seat 3: allthebest folded before Flop (didn't bet)
Seat 4: devi7 (button) folded before Flop (didn't bet)
Seat 5: Lucifer999 (small blind) collected ($50)
Seat 6: spidy02 (big blind) folded before Flop



PokerStars Game #00327527385: Hold'em No Limit ($10/$25 USD) - 2022/04/30 09:36:21 ET
Table 'Hold'em (Min 500Max 2500)  1282' 6-max Seat #3 is the button
Seat 3: devi7 ($2550 in chips) 
Seat 5: Lucifer999 ($5399.5 in chips) 
devi7: posts small blind $10
Lucifer999: posts big blind $25
*** HOLE CARDS ***
Dealt to Lucifer999 [5d Jh]
devi7: raises $45.00 to $70
Lucifer999: folds
Uncalled bet ($45) returned to devi7
devi7: doesn't show hand
devi7 collected $50 from pot
*** SUMMARY ***
Total pot $50.00 | Rake $0
Board []
Seat 3: devi7 (button) (small blind) collected ($50)
Seat 5: Lucifer999 (big blind) folded before Flop



PokerStars Game #00327527376: Hold'em No Limit ($25/$50 USD) - 2022/04/30 09:36:19 ET
Table 'Hold'em (Min 1K Max 5K)   216' 6-max Seat #5 is the button
Seat 1: Lucifer999 ($16494.37 in chips) 
Seat 2: rahulh1 ($2759.65 in chips) 
Seat 4: raj90341 ($1000 in chips) 
Seat 5: Avaroni ($5185 in chips) 
Lucifer999: posts small blind $25
rahulh1: posts big blind $50
*** HOLE CARDS ***
Dealt to Lucifer999 [6s 4s]
raj90341: checks
Avaroni: folds
Lucifer999: raises $150.00 to $200
rahulh1: folds
raj90341: folds
Uncalled bet ($150) returned to Lucifer999
Lucifer999: doesn't show hand
Lucifer999 collected $150 from pot
*** SUMMARY ***
Total pot $150.00 | Rake $0
Board []
Seat 1: Lucifer999 (small blind) collected ($150)
Seat 2: rahulh1 (big blind) folded before Flop
Seat 4: raj90341 folded before Flop (didn't bet)
Seat 5: Avaroni (button) folded before Flop (didn't bet)



PokerStars Game #00327527349: Hold'em No Limit ($50/$100 USD) - 2022/04/30 09:36:08 ET
Table 'Hold'em (Min 25KMax 10K)    69' 6-max Seat #4 is the button
Seat 1: Lucifer999 ($15956.6 in chips) 
Seat 3: bettercall7208 ($10000 in chips) 
Seat 4: vinuth ($17835.06 in chips) 
Seat 6: tabby20 ($10221.4 in chips) 
tabby20: posts small blind $50
Lucifer999: posts big blind $100
*** HOLE CARDS ***
Dealt to Lucifer999 [Ac Kd]
bettercall7208: checks
vinuth: raises $250.00 to $350
tabby20: folds
Lucifer999: raises $1250.00 to $1600
bettercall7208: folds
vinuth: calls $1250
*** FLOP *** [9d Qc 3d]
Lucifer999: bets $2300
vinuth: calls $2300
*** TURN *** [9d Qc 3d] [2d]
Lucifer999: bets $4800
vinuth: folds
Uncalled bet ($4800) returned to Lucifer999
Lucifer999: doesn't show hand
Lucifer999 collected $7600.2 from pot
*** SUMMARY ***
Total pot $7950.00 | Rake $349.8
Board [9d Qc 3d 2d]
Seat 1: Lucifer999 (big blind) collected ($7600.2)
Seat 3: bettercall7208 folded before Flop (didn't bet)
Seat 4: vinuth (button) folded on the Turn
Seat 6: tabby20 (small blind) folded before Flop



PokerStars Game #00327527428: Hold'em No Limit ($10/$25 USD) - 2022/04/30 09:36:36 ET
Table 'Hold'em (Min 500Max 2500) 1001' 6-max Seat #5 is the button
Seat 1: JaspritBumrah786 ($2141.63 in chips) 
Seat 2: fishfry123 ($1024.16 in chips) 
Seat 3: allthebest ($2200 in chips) 
Seat 4: devi7 ($2548.83 in chips) 
Seat 5: Lucifer999 ($4646.14 in chips) 
Seat 6: spidy02 ($3669.62 in chips) 
spidy02: posts small blind $10
JaspritBumrah786: posts big blind $25
*** HOLE CARDS ***
Dealt to Lucifer999 [9c 2c]
fishfry123: folds
allthebest: folds
devi7: folds
Lucifer999: folds
spidy02: folds
Uncalled bet ($15) returned to JaspritBumrah786
JaspritBumrah786: doesn't show hand
JaspritBumrah786 collected $20 from pot
*** SUMMARY ***
Total pot $20.00 | Rake $0
Board []
Seat 1: JaspritBumrah786 (big blind) collected ($20)
Seat 2: fishfry123 folded before Flop (didn't bet)
Seat 3: allthebest folded before Flop (didn't bet)
Seat 4: devi7 folded before Flop (didn't bet)
Seat 5: Lucifer999 (button) folded before Flop (didn't bet)
Seat 6: spidy02 (small blind) folded before Flop



PokerStars Game #00327527479: Hold'em No Limit ($25/$50 USD) - 2022/04/30 09:36:56 ET
Table 'Hold'em (Min 1K Max 5K)   216' 6-max Seat #1 is the button
Seat 1: Lucifer999 ($16594.37 in chips) 
Seat 2: rahulh1 ($2709.65 in chips) 
Seat 4: raj90341 ($950 in chips) 
Seat 5: Avaroni ($5185 in chips) 
rahulh1: posts small blind $25
raj90341: posts big blind $50
*** HOLE CARDS ***
Dealt to Lucifer999 [6d Qs]
Avaroni: raises $100.00 to $150
Lucifer999: folds
rahulh1: folds
raj90341: raises $800.00 to $950
Avaroni: calls $800
*** FLOP *** [8c 3s 9d]
*** FLOP *** [4d Ks Ah]
*** TURN *** [8c 3s 9d] [4s]
*** TURN *** [8c 3s 9d] [8d]
*** RIVER *** [8c 3s 9d 4s] [8s]
*** RIVER *** [8c 3s 9d 4s] [5c]
*** SHOW DOWN ***
raj90341: shows [Ad 4h] (Two pairs, AA44)
Avaroni: shows [7h 7c] (Pair, 77)
Avaroni collected $914.38 from pot
raj90341 collected $914.37 from pot
*** SUMMARY ***
Total pot $1925.00 | Rake $96.25
Board [8c 3s 9d 4s 8s]
Seat 1: Lucifer999 (button) folded before Flop (didn't bet)
Seat 2: rahulh1 (small blind) folded before Flop
Seat 4: raj90341  (big blind) showed [Ad 4h] and won ($914.37) with Two pairs, AA44
Seat 5: Avaroni  showed [7h 7c] and won ($914.38) with Pair, 77



PokerStars Game #00327527506: Hold'em No Limit ($50/$100 USD) - 2022/04/30 09:37:04 ET
Table 'Hold'em (Min 25KMax 10K)    69' 6-max Seat #6 is the button
Seat 1: Lucifer999 ($19656.8 in chips) 
Seat 3: bettercall7208 ($9900 in chips) 
Seat 4: vinuth ($13935.06 in chips) 
Seat 6: tabby20 ($10171.4 in chips) 
Lucifer999: posts small blind $50
bettercall7208: posts big blind $100
*** HOLE CARDS ***
Dealt to Lucifer999 [6d 7c]
vinuth: raises $200.00 to $300
tabby20: folds
Lucifer999: folds
bettercall7208: folds
Uncalled bet ($200) returned to vinuth
vinuth: doesn't show hand
vinuth collected $250 from pot
*** SUMMARY ***
Total pot $250.00 | Rake $0
Board []
Seat 1: Lucifer999 (small blind) folded before Flop
Seat 3: bettercall7208 (big blind) folded before Flop
Seat 4: vinuth collected ($250)
Seat 6: tabby20 (button) folded before Flop (didn't bet)



PokerStars Game #00327527588: Hold'em No Limit ($25/$50 USD) - 2022/04/30 09:37:29 ET
Table 'Hold'em (Min 1K Max 5K)   216' 6-max Seat #2 is the button
Seat 1: Lucifer999 ($16594.37 in chips) 
Seat 2: rahulh1 ($2684.65 in chips) 
Seat 4: raj90341 ($914.37 in chips) 
Seat 5: Avaroni ($5149.38 in chips) 
raj90341: posts small blind $25
Avaroni: posts big blind $50
*** HOLE CARDS ***
Dealt to Lucifer999 [Kd 3c]
Lucifer999: folds
rahulh1: folds
raj90341: calls $25
Avaroni: checks
*** FLOP *** [2s Qh 4c]
raj90341: checks
Avaroni: bets $50
raj90341: folds
Uncalled bet ($50) returned to Avaroni
Avaroni: doesn't show hand
Avaroni collected $95 from pot
*** SUMMARY ***
Total pot $100.00 | Rake $5
Board [2s Qh 4c]
Seat 1: Lucifer999 folded before Flop (didn't bet)
Seat 2: rahulh1 (button) folded before Flop (didn't bet)
Seat 4: raj90341 (small blind) folded on the Flop
Seat 5: Avaroni (big blind) collected ($95)



PokerStars Game #00327527515: Hold'em No Limit ($10/$25 USD) - 2022/04/30 09:37:07 ET
Table 'Hold'em (Min 500Max 2500) 1001' 6-max Seat #6 is the button
Seat 1: JaspritBumrah786 ($2151.63 in chips) 
Seat 2: fishfry123 ($1024.16 in chips) 
Seat 3: allthebest ($2200 in chips) 
Seat 4: devi7 ($2548.83 in chips) 
Seat 5: Lucifer999 ($4646.14 in chips) 
Seat 6: spidy02 ($3659.62 in chips) 
JaspritBumrah786: posts small blind $10
fishfry123: posts big blind $25
*** HOLE CARDS ***
Dealt to Lucifer999 [3h 9d]
allthebest: folds
devi7: folds
Lucifer999: folds
spidy02: folds
JaspritBumrah786: calls $15
fishfry123: checks
*** FLOP *** [Js 7s Qh]
JaspritBumrah786: bets $50
fishfry123: folds
Uncalled bet ($50) returned to JaspritBumrah786
JaspritBumrah786: doesn't show hand
JaspritBumrah786 collected $47.38 from pot
*** SUMMARY ***
Total pot $50.00 | Rake $2.62
Board [Js 7s Qh]
Seat 1: JaspritBumrah786 (small blind) collected ($47.38)
Seat 2: fishfry123 (big blind) folded on the Flop
Seat 3: allthebest folded before Flop (didn't bet)
Seat 4: devi7 folded before Flop (didn't bet)
Seat 5: Lucifer999 folded before Flop (didn't bet)
Seat 6: spidy02 (button) folded before Flop (didn't bet)



PokerStars Game #00327527596: Hold'em No Limit ($50/$100 USD) - 2022/04/30 09:37:31 ET
Table 'Hold'em (Min 25KMax 10K)    69' 6-max Seat #1 is the button
Seat 1: Lucifer999 ($19606.8 in chips) 
Seat 3: bettercall7208 ($9800 in chips) 
Seat 4: vinuth ($14085.06 in chips) 
Seat 6: tabby20 ($10171.4 in chips) 
bettercall7208: posts small blind $50
tabby20: posts big blind $100
*** HOLE CARDS ***
Dealt to Lucifer999 [Jc 6d]
Lucifer999: folds
bettercall7208: calls $50
tabby20: raises $250.00 to $350
bettercall7208: calls $250
*** FLOP *** [Tc 6c Kd]
bettercall7208: checks
tabby20: bets $450
bettercall7208: folds
Uncalled bet ($450) returned to tabby20
tabby20: doesn't show hand
tabby20 collected $669.2 from pot
*** SUMMARY ***
Total pot $700.00 | Rake $30.8
Board [Tc 6c Kd]
Seat 1: Lucifer999 (button) folded before Flop (didn't bet)
Seat 3: bettercall7208 (small blind) folded on the Flop
Seat 6: tabby20 (big blind) collected ($669.2)



PokerStars Game #00327527704: Hold'em No Limit ($10/$25 USD) - 2022/04/30 09:38:04 ET
Table 'Hold'em (Min 500Max 2500) 1001' 6-max Seat #1 is the button
Seat 1: JaspritBumrah786 ($2174.01 in chips) 
Seat 2: fishfry123 ($999.16 in chips) 
Seat 3: allthebest ($2200 in chips) 
Seat 4: devi7 ($2548.83 in chips) 
Seat 5: Lucifer999 ($4646.14 in chips) 
Seat 6: spidy02 ($3659.62 in chips) 
fishfry123: posts small blind $10
allthebest: posts big blind $25
*** HOLE CARDS ***
Dealt to Lucifer999 [6c Ad]
devi7: raises $50.00 to $75
Lucifer999: folds
spidy02: folds
JaspritBumrah786: folds
fishfry123: folds
allthebest: folds
Uncalled bet ($50) returned to devi7
devi7: doesn't show hand
devi7 collected $60 from pot
*** SUMMARY ***
Total pot $60.00 | Rake $0
Board []
Seat 1: JaspritBumrah786 (button) folded before Flop (didn't bet)
Seat 2: fishfry123 (small blind) folded before Flop
Seat 3: allthebest (big blind) folded before Flop
Seat 4: devi7 collected ($60)
Seat 5: Lucifer999 folded before Flop (didn't bet)
Seat 6: spidy02 folded before Flop (didn't bet)



PokerStars Game #00327527684: Hold'em No Limit ($25/$50 USD) - 2022/04/30 09:38:01 ET
Table 'Hold'em (Min 1K Max 5K)   216' 6-max Seat #4 is the button
Seat 1: Lucifer999 ($16594.37 in chips) 
Seat 2: rahulh1 ($2684.65 in chips) 
Seat 4: raj90341 ($864.37 in chips) 
Seat 5: Avaroni ($5194.38 in chips) 
Avaroni: posts small blind $25
Lucifer999: posts big blind $50
*** HOLE CARDS ***
Dealt to Lucifer999 [Ts 7d]
rahulh1: calls $50
raj90341: calls $50
Avaroni: calls $25
Lucifer999: checks
*** FLOP *** [3s 9d 7s]
Avaroni: checks
Lucifer999: checks
rahulh1: checks
raj90341: bets $814.37
Avaroni: folds
Lucifer999: folds
rahulh1: folds
Uncalled bet ($814.37) returned to raj90341
raj90341: doesn't show hand
raj90341 collected $190 from pot
*** SUMMARY ***
Total pot $200.00 | Rake $10
Board [3s 9d 7s]
Seat 1: Lucifer999 (big blind) folded on the Flop
Seat 2: rahulh1 folded on the Flop
Seat 4: raj90341 (button) collected ($190)
Seat 5: Avaroni (small blind) folded on the Flop



PokerStars Game #00327527722: Hold'em No Limit ($50/$100 USD) - 2022/04/30 09:38:11 ET
Table 'Hold'em (Min 25KMax 10K)    69' 6-max Seat #3 is the button
Seat 1: Lucifer999 ($19606.8 in chips) 
Seat 3: bettercall7208 ($9450 in chips) 
Seat 4: vinuth ($14085.06 in chips) 
Seat 6: tabby20 ($10490.6 in chips) 
tabby20: posts small blind $50
Lucifer999: posts big blind $100
*** HOLE CARDS ***
Dealt to Lucifer999 [3d Ah]
bettercall7208: raises $175.00 to $275
tabby20: calls $225
Lucifer999: folds
*** FLOP *** [9d As 4d]
tabby20: checks
bettercall7208: bets $410.7
tabby20: folds
Uncalled bet ($410.7) returned to bettercall7208
bettercall7208: doesn't show hand
bettercall7208 collected $621.4 from pot
*** SUMMARY ***
Total pot $650.00 | Rake $28.6
Board [9d As 4d]
Seat 1: Lucifer999 (big blind) folded before Flop
Seat 3: bettercall7208 (button) collected ($621.4)
Seat 6: tabby20 (small blind) folded on the Flop



PokerStars Game #00327527826: Hold'em No Limit ($50/$100 USD) - 2022/04/30 09:38:49 ET
Table 'Hold'em (Min 25KMax 10K)    69' 6-max Seat #6 is the button
Seat 1: Lucifer999 ($19506.8 in chips) 
Seat 3: bettercall7208 ($9796.4 in chips) 
Seat 4: vinuth ($14085.06 in chips) 
Seat 6: tabby20 ($10215.6 in chips) 
Lucifer999: posts small blind $50
bettercall7208: posts big blind $100
*** HOLE CARDS ***
Dealt to Lucifer999 [4d 2h]
tabby20: folds
Lucifer999: folds
Uncalled bet ($50) returned to bettercall7208
bettercall7208: doesn't show hand
bettercall7208 collected $100 from pot
*** SUMMARY ***
Total pot $100.00 | Rake $0
Board []
Seat 1: Lucifer999 (small blind) folded before Flop
Seat 3: bettercall7208 (big blind) collected ($100)
Seat 6: tabby20 (button) folded before Flop (didn't bet)



PokerStars Game #00327527883: Hold'em No Limit ($50/$100 USD) - 2022/04/30 09:39:09 ET
Table 'Hold'em (Min 25KMax 10K)    69' 6-max Seat #1 is the button
Seat 1: Lucifer999 ($19456.8 in chips) 
Seat 3: bettercall7208 ($9846.4 in chips) 
Seat 4: vinuth ($14085.06 in chips) 
Seat 6: tabby20 ($10215.6 in chips) 
bettercall7208: posts small blind $50
tabby20: posts big blind $100
*** HOLE CARDS ***
Dealt to Lucifer999 [Jc 8c]
Lucifer999: folds
bettercall7208: folds
Uncalled bet ($50) returned to tabby20
tabby20: doesn't show hand
tabby20 collected $100 from pot
*** SUMMARY ***
Total pot $100.00 | Rake $0
Board []
Seat 1: Lucifer999 (button) folded before Flop (didn't bet)
Seat 3: bettercall7208 (small blind) folded before Flop
Seat 6: tabby20 (big blind) collected ($100)



PokerStars Game #00327527805: Hold'em No Limit ($10/$25 USD) - 2022/04/30 09:38:42 ET
Table 'Hold'em (Min 500Max 2500) 1001' 6-max Seat #2 is the button
Seat 1: JaspritBumrah786 ($2174.01 in chips) 
Seat 2: fishfry123 ($989.16 in chips) 
Seat 3: allthebest ($2175 in chips) 
Seat 4: devi7 ($2583.83 in chips) 
Seat 5: Lucifer999 ($4646.14 in chips) 
Seat 6: spidy02 ($3659.62 in chips) 
allthebest: posts small blind $10
devi7: posts big blind $25
*** HOLE CARDS ***
Dealt to Lucifer999 [2s 3h]
Lucifer999: folds
spidy02: raises $60.00 to $85
JaspritBumrah786: folds
fishfry123: calls $85
allthebest: folds
devi7: folds
*** FLOP *** [4d Ts 2h]
spidy02: checks
fishfry123: bets $144.18
spidy02: calls $144.18
*** TURN *** [4d Ts 2h] [6d]
spidy02: checks
fishfry123: bets $231.74
spidy02: folds
Uncalled bet ($231.74) returned to fishfry123
fishfry123: doesn't show hand
fishfry123 collected $463.48 from pot
*** SUMMARY ***
Total pot $493.36 | Rake $29.88
Board [4d Ts 2h 6d]
Seat 1: JaspritBumrah786 folded before Flop (didn't bet)
Seat 2: fishfry123 (button) collected ($463.48)
Seat 3: allthebest (small blind) folded before Flop
Seat 4: devi7 (big blind) folded before Flop
Seat 5: Lucifer999 folded before Flop (didn't bet)
Seat 6: spidy02 folded on the Turn



PokerStars Game #00327527827: Hold'em No Limit ($25/$50 USD) - 2022/04/30 09:38:49 ET
Table 'Hold'em (Min 1K Max 5K)   216' 6-max Seat #5 is the button
Seat 1: Lucifer999 ($16544.37 in chips) 
Seat 2: rahulh1 ($2634.65 in chips) 
Seat 4: raj90341 ($1004.37 in chips) 
Seat 5: Avaroni ($5144.38 in chips) 
Lucifer999: posts small blind $25
rahulh1: posts big blind $50
*** HOLE CARDS ***
Dealt to Lucifer999 [6c 8c]
raj90341: calls $50
Avaroni: folds
Lucifer999: calls $25
rahulh1: checks
*** FLOP *** [9s 2c Td]
Lucifer999: bets $100
rahulh1: calls $100
raj90341: calls $100
*** TURN *** [9s 2c Td] [Ts]
Lucifer999: bets $300
rahulh1: calls $300
raj90341: folds
*** RIVER *** [9s 2c Td Ts] [Ks]
Lucifer999: checks
rahulh1: checks
*** SHOW DOWN ***
Lucifer999: shows [6c 8c] (Pair, TT)
rahulh1: shows [9h 4s] (Two pairs, TT99)
rahulh1 collected $997.5 from pot
*** SUMMARY ***
Total pot $1050.00 | Rake $52.5
Board [9s 2c Td Ts Ks]
Seat 1: Lucifer999 (small blind) showed [6c 8c] and lost with Pair, TT
Seat 2: rahulh1  (big blind) showed [9h 4s] and won ($997.5) with Two pairs, TT99
Seat 4: raj90341 folded on the Turn
Seat 5: Avaroni (button) folded before Flop (didn't bet)



PokerStars Game #00327527936: Hold'em No Limit ($50/$100 USD) - 2022/04/30 09:39:28 ET
Table 'Hold'em (Min 25KMax 10K)    69' 6-max Seat #3 is the button
Seat 1: Lucifer999 ($19456.8 in chips) 
Seat 3: bettercall7208 ($9796.4 in chips) 
Seat 4: vinuth ($14085.06 in chips) 
Seat 6: tabby20 ($10265.6 in chips) 
tabby20: posts small blind $50
Lucifer999: posts big blind $100
*** HOLE CARDS ***
Dealt to Lucifer999 [8d 7s]
bettercall7208: folds
tabby20: raises $200.00 to $300
Lucifer999: folds
Uncalled bet ($200) returned to tabby20
tabby20: doesn't show hand
tabby20 collected $200 from pot
*** SUMMARY ***
Total pot $200.00 | Rake $0
Board []
Seat 1: Lucifer999 (big blind) folded before Flop
Seat 3: bettercall7208 (button) folded before Flop (didn't bet)
Seat 6: tabby20 (small blind) collected ($200)



PokerStars Game #00327527953: Hold'em No Limit ($10/$25 USD) - 2022/04/30 09:39:35 ET
Table 'Hold'em (Min 500Max 2500) 1001' 6-max Seat #3 is the button
Seat 1: JaspritBumrah786 ($2174.01 in chips) 
Seat 2: fishfry123 ($1223.46 in chips) 
Seat 3: allthebest ($2165 in chips) 
Seat 4: devi7 ($2558.83 in chips) 
Seat 5: Lucifer999 ($4646.14 in chips) 
Seat 6: spidy02 ($3430.44 in chips) 
devi7: posts small blind $10
Lucifer999: posts big blind $25
*** HOLE CARDS ***
Dealt to Lucifer999 [Qc Kc]
spidy02: folds
JaspritBumrah786: folds
fishfry123: folds
allthebest: folds
devi7: raises $55.00 to $80
Lucifer999: raises $240.00 to $320
devi7: folds
Uncalled bet ($240) returned to Lucifer999
Lucifer999: doesn't show hand
Lucifer999 collected $160 from pot
*** SUMMARY ***
Total pot $160.00 | Rake $0
Board []
Seat 1: JaspritBumrah786 folded before Flop (didn't bet)
Seat 2: fishfry123 folded before Flop (didn't bet)
Seat 3: allthebest (button) folded before Flop (didn't bet)
Seat 4: devi7 (small blind) folded before Flop
Seat 5: Lucifer999 (big blind) collected ($160)
Seat 6: spidy02 folded before Flop (didn't bet)



PokerStars Game #00327527965: Hold'em No Limit ($50/$100 USD) - 2022/04/30 09:39:41 ET
Table 'Hold'em (Min 25KMax 10K)    69' 6-max Seat #6 is the button
Seat 1: Lucifer999 ($19356.8 in chips) 
Seat 3: bettercall7208 ($9796.4 in chips) 
Seat 4: vinuth ($14085.06 in chips) 
Seat 6: tabby20 ($10365.6 in chips) 
Lucifer999: posts small blind $50
bettercall7208: posts big blind $100
*** HOLE CARDS ***
Dealt to Lucifer999 [Js 6d]
tabby20: raises $200.00 to $300
Lucifer999: folds
bettercall7208: calls $200
*** FLOP *** [Th Kc Ks]
bettercall7208: checks
tabby20: bets $310.7
bettercall7208: folds
Uncalled bet ($310.7) returned to tabby20
tabby20: doesn't show hand
tabby20 collected $621.4 from pot
*** SUMMARY ***
Total pot $650.00 | Rake $28.6
Board [Th Kc Ks]
Seat 1: Lucifer999 (small blind) folded before Flop
Seat 3: bettercall7208 (big blind) folded on the Flop
Seat 6: tabby20 (button) collected ($621.4)



PokerStars Game #00327527957: Hold'em No Limit ($25/$50 USD) - 2022/04/30 09:39:36 ET
Table 'Hold'em (Min 1K Max 5K)   216' 6-max Seat #1 is the button
Seat 1: Lucifer999 ($16094.37 in chips) 
Seat 2: rahulh1 ($3182.15 in chips) 
Seat 4: raj90341 ($854.37 in chips) 
Seat 5: Avaroni ($5144.38 in chips) 
rahulh1: posts small blind $25
raj90341: posts big blind $50
*** HOLE CARDS ***
Dealt to Lucifer999 [9d Th]
Avaroni: folds
Lucifer999: folds
rahulh1: calls $25
raj90341: checks
*** FLOP *** [6c 2s 3h]
rahulh1: bets $55.26
raj90341: calls $55.26
*** TURN *** [6c 2s 3h] [Jh]
rahulh1: checks
raj90341: bets $749.11
rahulh1: folds
Uncalled bet ($749.11) returned to raj90341
raj90341: doesn't show hand
raj90341 collected $200.02 from pot
*** SUMMARY ***
Total pot $210.52 | Rake $10.5
Board [6c 2s 3h Jh]
Seat 1: Lucifer999 (button) folded before Flop (didn't bet)
Seat 2: rahulh1 (small blind) folded on the Turn
Seat 4: raj90341 (big blind) collected ($200.02)
Seat 5: Avaroni folded before Flop (didn't bet)



PokerStars Game #00327528084: Hold'em No Limit ($25/$50 USD) - 2022/04/30 09:40:19 ET
Table 'Hold'em (Min 1K Max 5K)   216' 6-max Seat #2 is the button
Seat 1: Lucifer999 ($16094.37 in chips) 
Seat 2: rahulh1 ($3076.89 in chips) 
Seat 4: raj90341 ($949.13 in chips) 
Seat 5: Avaroni ($5144.38 in chips) 
raj90341: posts small blind $25
Avaroni: posts big blind $50
*** HOLE CARDS ***
Dealt to Lucifer999 [Jd 6d]
Lucifer999: folds
rahulh1: folds
raj90341: calls $25
Avaroni: raises $150.00 to $200
raj90341: folds
Uncalled bet ($150) returned to Avaroni
Avaroni: doesn't show hand
Avaroni collected $100 from pot
*** SUMMARY ***
Total pot $100.00 | Rake $0
Board []
Seat 1: Lucifer999 folded before Flop (didn't bet)
Seat 2: rahulh1 (button) folded before Flop (didn't bet)
Seat 4: raj90341 (small blind) folded before Flop
Seat 5: Avaroni (big blind) collected ($100)



PokerStars Game #00327528052: Hold'em No Limit ($10/$25 USD) - 2022/04/30 09:40:08 ET
Table 'Hold'em (Min 500Max 2500) 1001' 6-max Seat #4 is the button
Seat 1: JaspritBumrah786 ($2174.01 in chips) 
Seat 2: fishfry123 ($1223.46 in chips) 
Seat 3: allthebest ($2165 in chips) 
Seat 4: devi7 ($2478.83 in chips) 
Seat 5: Lucifer999 ($4726.14 in chips) 
Seat 6: spidy02 ($3430.44 in chips) 
Lucifer999: posts small blind $10
spidy02: posts big blind $25
*** HOLE CARDS ***
Dealt to Lucifer999 [Ac Kc]
JaspritBumrah786: folds
fishfry123: folds
allthebest: raises $50.00 to $75
devi7: folds
Lucifer999: raises $275.00 to $350
spidy02: folds
allthebest: folds
Uncalled bet ($275) returned to Lucifer999
Lucifer999: doesn't show hand
Lucifer999 collected $175 from pot
*** SUMMARY ***
Total pot $175.00 | Rake $0
Board []
Seat 1: JaspritBumrah786 folded before Flop (didn't bet)
Seat 2: fishfry123 folded before Flop (didn't bet)
Seat 3: allthebest folded before Flop
Seat 4: devi7 (button) folded before Flop (didn't bet)
Seat 5: Lucifer999 (small blind) collected ($175)
Seat 6: spidy02 (big blind) folded before Flop



PokerStars Game #00327528080: Hold'em No Limit ($50/$100 USD) - 2022/04/30 09:40:18 ET
Table 'Hold'em (Min 25KMax 10K)    69' 6-max Seat #1 is the button
Seat 1: Lucifer999 ($19306.8 in chips) 
Seat 3: bettercall7208 ($9496.4 in chips) 
Seat 4: vinuth ($16585.06 in chips) 
Seat 6: tabby20 ($10687 in chips) 
bettercall7208: posts small blind $50
tabby20: posts big blind $100
*** HOLE CARDS ***
Dealt to Lucifer999 [Ks Kh]
Lucifer999: calls $100
bettercall7208: raises $300.00 to $400
tabby20: folds
Lucifer999: raises $1000.00 to $1400
bettercall7208: calls $1000
*** FLOP *** [Ad Qh 4d]
bettercall7208: checks
Lucifer999: checks
*** TURN *** [Ad Qh 4d] [9d]
bettercall7208: bets $1386.2
Lucifer999: calls $1386.2
*** RIVER *** [Ad Qh 4d 9d] [Jc]
bettercall7208: bets $2711.42
Lucifer999: calls $2711.42
*** SHOW DOWN ***
bettercall7208: shows [Kc Ah] (Pair, AA)
Lucifer999: doesn't show hand
bettercall7208 collected $10655.24 from pot
*** SUMMARY ***
Total pot $11095.24 | Rake $440
Board [Ad Qh 4d 9d Jc]
Seat 1: Lucifer999 (button) mucked
Seat 3: bettercall7208  (small blind) showed [Kc Ah] and won ($10655.24) with Pair, AA
Seat 6: tabby20 (big blind) folded before Flop



PokerStars Game #00327528242: Hold'em No Limit ($50/$100 USD) - 2022/04/30 09:41:08 ET
Table 'Hold'em (Min 25KMax 10K)    69' 6-max Seat #3 is the button
Seat 1: Lucifer999 ($13809.18 in chips) 
Seat 3: bettercall7208 ($14654.02 in chips) 
Seat 4: TheWay ($2500 in chips) 
Seat 6: tabby20 ($10587 in chips) 
tabby20: posts small blind $50
Lucifer999: posts big blind $100
*** HOLE CARDS ***
Dealt to Lucifer999 [2d 9h]
bettercall7208: folds
tabby20: raises $200.00 to $300
Lucifer999: folds
Uncalled bet ($200) returned to tabby20
tabby20: doesn't show hand
tabby20 collected $200 from pot
*** SUMMARY ***
Total pot $200.00 | Rake $0
Board []
Seat 1: Lucifer999 (big blind) folded before Flop
Seat 3: bettercall7208 (button) folded before Flop (didn't bet)
Seat 6: tabby20 (small blind) collected ($200)



PokerStars Game #00327528178: Hold'em No Limit ($25/$50 USD) - 2022/04/30 09:40:45 ET
Table 'Hold'em (Min 1K Max 5K)   216' 6-max Seat #4 is the button
Seat 1: Lucifer999 ($16094.37 in chips) 
Seat 2: rahulh1 ($3076.89 in chips) 
Seat 4: raj90341 ($899.13 in chips) 
Seat 5: Avaroni ($5194.38 in chips) 
Avaroni: posts small blind $25
Lucifer999: posts big blind $50
*** HOLE CARDS ***
Dealt to Lucifer999 [Th 6s]
rahulh1: folds
raj90341: folds
Avaroni: raises $100.00 to $150
Lucifer999: calls $100
*** FLOP *** [5d Jd 5s]
Avaroni: checks
Lucifer999: checks
*** TURN *** [5d Jd 5s] [Ah]
Avaroni: checks
Lucifer999: checks
*** RIVER *** [5d Jd 5s Ah] [Qs]
Avaroni: bets $142.5
Lucifer999: folds
Uncalled bet ($142.5) returned to Avaroni
Avaroni: doesn't show hand
Avaroni collected $285 from pot
*** SUMMARY ***
Total pot $300.00 | Rake $15
Board [5d Jd 5s Ah Qs]
Seat 1: Lucifer999 (big blind) folded on the River
Seat 2: rahulh1 folded before Flop (didn't bet)
Seat 4: raj90341 (button) folded before Flop (didn't bet)
Seat 5: Avaroni (small blind) collected ($285)



PokerStars Game #00327528278: Hold'em No Limit ($50/$100 USD) - 2022/04/30 09:41:21 ET
Table 'Hold'em (Min 25KMax 10K)    69' 6-max Seat #6 is the button
Seat 1: Lucifer999 ($13709.18 in chips) 
Seat 3: bettercall7208 ($14654.02 in chips) 
Seat 4: TheWay ($2500 in chips) 
Seat 6: tabby20 ($10687 in chips) 
Lucifer999: posts small blind $50
bettercall7208: posts big blind $100
*** HOLE CARDS ***
Dealt to Lucifer999 [Qs As]
TheWay: checks
tabby20: folds
Lucifer999: raises $350.00 to $450
bettercall7208: folds
TheWay: folds
Uncalled bet ($350) returned to Lucifer999
Lucifer999: doesn't show hand
Lucifer999 collected $300 from pot
*** SUMMARY ***
Total pot $300.00 | Rake $0
Board []
Seat 1: Lucifer999 (small blind) collected ($300)
Seat 3: bettercall7208 (big blind) folded before Flop
Seat 4: TheWay folded before Flop (didn't bet)
Seat 6: tabby20 (button) folded before Flop (didn't bet)



PokerStars Game #00327528191: Hold'em No Limit ($10/$25 USD) - 2022/04/30 09:40:49 ET
Table 'Hold'em (Min 500Max 2500) 1001' 6-max Seat #5 is the button
Seat 1: JaspritBumrah786 ($2174.01 in chips) 
Seat 2: fishfry123 ($1223.46 in chips) 
Seat 3: allthebest ($2090 in chips) 
Seat 4: devi7 ($2478.83 in chips) 
Seat 5: Lucifer999 ($4826.14 in chips) 
Seat 6: spidy02 ($3405.44 in chips) 
spidy02: posts small blind $10
JaspritBumrah786: posts big blind $25
*** HOLE CARDS ***
Dealt to Lucifer999 [Kc 2h]
fishfry123: calls $25
allthebest: folds
devi7: folds
Lucifer999: folds
spidy02: folds
JaspritBumrah786: checks
*** FLOP *** [6s 3s Qd]
JaspritBumrah786: checks
fishfry123: checks
*** TURN *** [6s 3s Qd] [Qh]
JaspritBumrah786: bets $50
fishfry123: calls $50
*** RIVER *** [6s 3s Qd Qh] [Ac]
JaspritBumrah786: checks
fishfry123: bets $75.3
JaspritBumrah786: folds
Uncalled bet ($75.3) returned to fishfry123
fishfry123: doesn't show hand
fishfry123 collected $150.6 from pot
*** SUMMARY ***
Total pot $160.00 | Rake $9.4
Board [6s 3s Qd Qh Ac]
Seat 1: JaspritBumrah786 (big blind) folded on the River
Seat 2: fishfry123 collected ($150.6)
Seat 3: allthebest folded before Flop (didn't bet)
Seat 4: devi7 folded before Flop (didn't bet)
Seat 5: Lucifer999 (button) folded before Flop (didn't bet)
Seat 6: spidy02 (small blind) folded before Flop



PokerStars Game #00327528304: Hold'em No Limit ($25/$50 USD) - 2022/04/30 09:41:28 ET
Table 'Hold'em (Min 1K Max 5K)   216' 6-max Seat #5 is the button
Seat 1: Lucifer999 ($15944.37 in chips) 
Seat 2: rahulh1 ($3076.89 in chips) 
Seat 4: raj90341 ($899.13 in chips) 
Seat 5: Avaroni ($5329.38 in chips) 
Lucifer999: posts small blind $25
rahulh1: posts big blind $50
*** HOLE CARDS ***
Dealt to Lucifer999 [5d 8s]
raj90341: folds
Avaroni: raises $100.00 to $150
Lucifer999: folds
rahulh1: calls $100
*** FLOP *** [Js 8c 2s]
rahulh1: checks
Avaroni: bets $250
rahulh1: calls $250
*** TURN *** [Js 8c 2s] [7c]
rahulh1: checks
Avaroni: checks
*** RIVER *** [Js 8c 2s 7c] [3d]
rahulh1: bets $263.7
Avaroni: folds
Uncalled bet ($263.7) returned to rahulh1
rahulh1: doesn't show hand
rahulh1 collected $783.75 from pot
*** SUMMARY ***
Total pot $825.00 | Rake $41.25
Board [Js 8c 2s 7c 3d]
Seat 1: Lucifer999 (small blind) folded before Flop
Seat 2: rahulh1 (big blind) collected ($783.75)
Seat 4: raj90341 folded before Flop (didn't bet)
Seat 5: Avaroni (button) folded on the River



PokerStars Game #00327528366: Hold'em No Limit ($10/$25 USD) - 2022/04/30 09:41:50 ET
Table 'Hold'em (Min 500Max 2500) 1001' 6-max Seat #6 is the button
Seat 1: JaspritBumrah786 ($2099.01 in chips) 
Seat 2: fishfry123 ($1299.06 in chips) 
Seat 3: allthebest ($2090 in chips) 
Seat 4: devi7 ($2478.83 in chips) 
Seat 5: Lucifer999 ($4826.14 in chips) 
Seat 6: spidy02 ($3395.44 in chips) 
JaspritBumrah786: posts small blind $10
fishfry123: posts big blind $25
*** HOLE CARDS ***
Dealt to Lucifer999 [2s 7s]
allthebest: folds
devi7: folds
Lucifer999: folds
spidy02: folds
JaspritBumrah786: folds
Uncalled bet ($15) returned to fishfry123
fishfry123: doesn't show hand
fishfry123 collected $20 from pot
*** SUMMARY ***
Total pot $20.00 | Rake $0
Board []
Seat 1: JaspritBumrah786 (small blind) folded before Flop
Seat 2: fishfry123 (big blind) collected ($20)
Seat 3: allthebest folded before Flop (didn't bet)
Seat 4: devi7 folded before Flop (didn't bet)
Seat 5: Lucifer999 folded before Flop (didn't bet)
Seat 6: spidy02 (button) folded before Flop (didn't bet)



PokerStars Game #00327528362: Hold'em No Limit ($50/$100 USD) - 2022/04/30 09:41:49 ET
Table 'Hold'em (Min 25KMax 10K)    69' 6-max Seat #1 is the button
Seat 1: Lucifer999 ($13909.18 in chips) 
Seat 3: bettercall7208 ($14554.02 in chips) 
Seat 4: TheWay ($2400 in chips) 
Seat 6: tabby20 ($10687 in chips) 
bettercall7208: posts small blind $50
TheWay: posts big blind $100
*** HOLE CARDS ***
Dealt to Lucifer999 [As Qh]
tabby20: folds
Lucifer999: raises $250.00 to $350
bettercall7208: folds
TheWay: calls $250
*** FLOP *** [6c Kd 5d]
TheWay: checks
Lucifer999: checks
*** TURN *** [6c Kd 5d] [Jc]
TheWay: bets $478
Lucifer999: calls $478
*** RIVER *** [6c Kd 5d Jc] [2s]
TheWay: bets $300
Lucifer999: calls $300
*** SHOW DOWN ***
TheWay: shows [Js Tc] (Pair, JJ)
Lucifer999: doesn't show hand
TheWay collected $2204.54 from pot
*** SUMMARY ***
Total pot $2306.00 | Rake $101.46
Board [6c Kd 5d Jc 2s]
Seat 1: Lucifer999 (button) mucked
Seat 3: bettercall7208 (small blind) folded before Flop
Seat 4: TheWay  (big blind) showed [Js Tc] and won ($2204.54) with Pair, JJ
Seat 6: tabby20 folded before Flop (didn't bet)



PokerStars Game #00327528455: Hold'em No Limit ($25/$50 USD) - 2022/04/30 09:42:18 ET
Table 'Hold'em (Min 1K Max 5K)   216' 6-max Seat #1 is the button
Seat 1: Lucifer999 ($15919.37 in chips) 
Seat 2: rahulh1 ($3460.64 in chips) 
Seat 4: raj90341 ($899.13 in chips) 
Seat 5: Avaroni ($5000 in chips) 
rahulh1: posts small blind $25
raj90341: posts big blind $50
*** HOLE CARDS ***
Dealt to Lucifer999 [2d Tc]
Avaroni: folds
Lucifer999: folds
rahulh1: calls $25
raj90341: checks
*** FLOP *** [5d Jc 2s]
rahulh1: bets $50
raj90341: calls $50
*** TURN *** [5d Jc 2s] [3h]
rahulh1: bets $95
raj90341: folds
Uncalled bet ($95) returned to rahulh1
rahulh1: doesn't show hand
rahulh1 collected $190 from pot
*** SUMMARY ***
Total pot $200.00 | Rake $10
Board [5d Jc 2s 3h]
Seat 1: Lucifer999 (button) folded before Flop (didn't bet)
Seat 2: rahulh1 (small blind) collected ($190)
Seat 4: raj90341 (big blind) folded on the Turn
Seat 5: Avaroni folded before Flop (didn't bet)



PokerStars Game #00327528523: Hold'em No Limit ($50/$100 USD) - 2022/04/30 09:42:45 ET
Table 'Hold'em (Min 25KMax 10K)    69' 6-max Seat #3 is the button
Seat 1: Lucifer999 ($12781.18 in chips) 
Seat 3: bettercall7208 ($14504.02 in chips) 
Seat 4: TheWay ($3476.54 in chips) 
Seat 6: tabby20 ($10687 in chips) 
TheWay: posts small blind $50
tabby20: posts big blind $100
*** HOLE CARDS ***
Dealt to Lucifer999 [2h 4d]
Lucifer999: folds
bettercall7208: folds
TheWay: raises $100.00 to $200
tabby20: folds
Uncalled bet ($100) returned to TheWay
TheWay: doesn't show hand
TheWay collected $200 from pot
*** SUMMARY ***
Total pot $200.00 | Rake $0
Board []
Seat 1: Lucifer999 folded before Flop (didn't bet)
Seat 3: bettercall7208 (button) folded before Flop (didn't bet)
Seat 4: TheWay (small blind) collected ($200)
Seat 6: tabby20 (big blind) folded before Flop



PokerStars Game #00327528469: Hold'em No Limit ($10/$25 USD) - 2022/04/30 09:42:24 ET
Table 'Hold'em (Min 500Max 2500) 1001' 6-max Seat #1 is the button
Seat 1: JaspritBumrah786 ($2089.01 in chips) 
Seat 2: fishfry123 ($1309.06 in chips) 
Seat 3: allthebest ($2090 in chips) 
Seat 4: devi7 ($2478.83 in chips) 
Seat 5: Lucifer999 ($4826.14 in chips) 
Seat 6: spidy02 ($3395.44 in chips) 
fishfry123: posts small blind $10
allthebest: posts big blind $25
*** HOLE CARDS ***
Dealt to Lucifer999 [3s Ah]
devi7: folds
Lucifer999: folds
spidy02: raises $35.00 to $60
JaspritBumrah786: folds
fishfry123: calls $50
allthebest: folds
*** FLOP *** [7c Ts 8c]
fishfry123: checks
spidy02: bets $68.19
fishfry123: calls $68.19
*** TURN *** [7c Ts 8c] [9h]
fishfry123: checks
spidy02: bets $198.47
fishfry123: calls $198.47
*** RIVER *** [7c Ts 8c 9h] [Qs]
fishfry123: checks
spidy02: checks
*** SHOW DOWN ***
spidy02: shows [5h 6h] (Straight, T-6)
fishfry123: doesn't show hand
spidy02 collected $637.73 from pot
*** SUMMARY ***
Total pot $678.32 | Rake $40.59
Board [7c Ts 8c 9h Qs]
Seat 1: JaspritBumrah786 (button) folded before Flop (didn't bet)
Seat 2: fishfry123 (small blind) mucked
Seat 3: allthebest (big blind) folded before Flop
Seat 4: devi7 folded before Flop (didn't bet)
Seat 5: Lucifer999 folded before Flop (didn't bet)
Seat 6: spidy02  showed [5h 6h] and won ($637.73) with Straight, T-6



PokerStars Game #00327528543: Hold'em No Limit ($25/$50 USD) - 2022/04/30 09:42:53 ET
Table 'Hold'em (Min 1K Max 5K)   216' 6-max Seat #2 is the button
Seat 1: Lucifer999 ($15919.37 in chips) 
Seat 2: rahulh1 ($3550.64 in chips) 
Seat 4: raj90341 ($799.13 in chips) 
Seat 5: Avaroni ($5000 in chips) 
raj90341: posts small blind $25
Avaroni: posts big blind $50
*** HOLE CARDS ***
Dealt to Lucifer999 [7s Qd]
Lucifer999: folds
rahulh1: folds
raj90341: calls $25
Avaroni: checks
*** FLOP *** [Kc 4h 4s]
raj90341: checks
Avaroni: checks
*** TURN *** [Kc 4h 4s] [4c]
raj90341: checks
Avaroni: checks
*** RIVER *** [Kc 4h 4s 4c] [3d]
raj90341: checks
Avaroni: checks
*** SHOW DOWN ***
raj90341: shows [8d 6s] (Three of a kind, 444)
Avaroni: shows [Tc 6d] (Three of a kind, 444)
Avaroni collected $95 from pot
*** SUMMARY ***
Total pot $100.00 | Rake $5
Board [Kc 4h 4s 4c 3d]
Seat 1: Lucifer999 folded before Flop (didn't bet)
Seat 2: rahulh1 (button) folded before Flop (didn't bet)
Seat 4: raj90341 (small blind) showed [8d 6s] and lost with Three of a kind, 444
Seat 5: Avaroni  (big blind) showed [Tc 6d] and won ($95) with Three of a kind, 444



PokerStars Game #00327528622: Hold'em No Limit ($10/$25 USD) - 2022/04/30 09:43:17 ET
Table 'Hold'em (Min 500Max 2500) 1001' 6-max Seat #2 is the button
Seat 1: JaspritBumrah786 ($2089.01 in chips) 
Seat 2: fishfry123 ($982.4 in chips) 
Seat 3: allthebest ($2065 in chips) 
Seat 4: devi7 ($2478.83 in chips) 
Seat 5: Lucifer999 ($4826.14 in chips) 
Seat 6: spidy02 ($3706.51 in chips) 
allthebest: posts small blind $10
devi7: posts big blind $25
*** HOLE CARDS ***
Dealt to Lucifer999 [8d Qh]
Lucifer999: folds
spidy02: folds
JaspritBumrah786: folds
fishfry123: raises $38.75 to $63.75
allthebest: folds
devi7: folds
Uncalled bet ($38.75) returned to fishfry123
fishfry123: doesn't show hand
fishfry123 collected $60 from pot
*** SUMMARY ***
Total pot $60.00 | Rake $0
Board []
Seat 1: JaspritBumrah786 folded before Flop (didn't bet)
Seat 2: fishfry123 (button) collected ($60)
Seat 3: allthebest (small blind) folded before Flop
Seat 4: devi7 (big blind) folded before Flop
Seat 5: Lucifer999 folded before Flop (didn't bet)
Seat 6: spidy02 folded before Flop (didn't bet)



PokerStars Game #00327528598: Hold'em No Limit ($50/$100 USD) - 2022/04/30 09:43:08 ET
Table 'Hold'em (Min 25KMax 10K)    69' 6-max Seat #4 is the button
Seat 1: Lucifer999 ($12781.18 in chips) 
Seat 2: vinuth ($14085.06 in chips) 
Seat 3: bettercall7208 ($14504.02 in chips) 
Seat 4: TheWay ($3576.54 in chips) 
Seat 6: tabby20 ($10587 in chips) 
tabby20: posts small blind $50
Lucifer999: posts big blind $100
*** HOLE CARDS ***
Dealt to Lucifer999 [5d 2d]
bettercall7208: folds
TheWay: calls $100
tabby20: folds
Lucifer999: checks
*** FLOP *** [6d 9d 9c]
Lucifer999: checks
TheWay: checks
*** TURN *** [6d 9d 9c] [Jd]
Lucifer999: bets $300
TheWay: folds
Uncalled bet ($300) returned to Lucifer999
Lucifer999: doesn't show hand
Lucifer999 collected $239 from pot
*** SUMMARY ***
Total pot $250.00 | Rake $11
Board [6d 9d 9c Jd]
Seat 1: Lucifer999 (big blind) collected ($239)
Seat 3: bettercall7208 folded before Flop (didn't bet)
Seat 4: TheWay (button) folded on the Turn
Seat 6: tabby20 (small blind) folded before Flop



PokerStars Game #00327528676: Hold'em No Limit ($25/$50 USD) - 2022/04/30 09:43:36 ET
Table 'Hold'em (Min 1K Max 5K)   216' 6-max Seat #4 is the button
Seat 1: Lucifer999 ($15919.37 in chips) 
Seat 2: rahulh1 ($3550.64 in chips) 
Seat 4: raj90341 ($749.13 in chips) 
Seat 5: Avaroni ($5045 in chips) 
Avaroni: posts small blind $25
Lucifer999: posts big blind $50
*** HOLE CARDS ***
Dealt to Lucifer999 [Ad 6d]
rahulh1: folds
raj90341: calls $50
Avaroni: calls $25
Lucifer999: raises $175.00 to $225
raj90341: raises $524.13 to $749.13
Avaroni: folds
Lucifer999: calls $524.13
*** FLOP *** [4c Jc 8c]
*** FLOP *** [5s Qd 4d]
*** TURN *** [4c Jc 8c] [9s]
*** TURN *** [4c Jc 8c] [9d]
*** RIVER *** [4c Jc 8c 9s] [Kh]
*** RIVER *** [4c Jc 8c 9s] [8s]
*** SHOW DOWN ***
Lucifer999: shows [Ad 6d] (Flush, A high)
raj90341: shows [Ks Ac] (High card, A)
raj90341 collected $735.43 from pot
Lucifer999 collected $735.43 from pot
*** SUMMARY ***
Total pot $1548.26 | Rake $77.4
Board [4c Jc 8c 9s Kh]
Seat 1: Lucifer999  (big blind) showed [Ad 6d] and won ($735.43) with Flush, A high
Seat 2: rahulh1 folded before Flop (didn't bet)
Seat 4: raj90341  (button) showed [Ks Ac] and won ($735.43) with High card, A
Seat 5: Avaroni (small blind) folded before Flop



PokerStars Game #00327528709: Hold'em No Limit ($10/$25 USD) - 2022/04/30 09:43:46 ET
Table 'Hold'em (Min 500Max 2500) 1001' 6-max Seat #3 is the button
Seat 1: JaspritBumrah786 ($2089.01 in chips) 
Seat 2: fishfry123 ($1017.4 in chips) 
Seat 3: allthebest ($2055 in chips) 
Seat 4: devi7 ($2453.83 in chips) 
Seat 5: Lucifer999 ($4826.14 in chips) 
Seat 6: spidy02 ($3706.51 in chips) 
devi7: posts small blind $10
Lucifer999: posts big blind $25
*** HOLE CARDS ***
Dealt to Lucifer999 [4s Kc]
spidy02: folds
JaspritBumrah786: folds
fishfry123: calls $25
allthebest: raises $75.00 to $100
devi7: folds
Lucifer999: folds
fishfry123: calls $75
*** FLOP *** [9s Jd Ah]
fishfry123: checks
allthebest: checks
*** TURN *** [9s Jd Ah] [4h]
fishfry123: checks
allthebest: checks
*** RIVER *** [9s Jd Ah 4h] [Qd]
fishfry123: checks
allthebest: checks
*** SHOW DOWN ***
allthebest: shows [9c Td] (Pair, 99)
fishfry123: doesn't show hand
allthebest collected $220.67 from pot
*** SUMMARY ***
Total pot $235.00 | Rake $14.33
Board [9s Jd Ah 4h Qd]
Seat 1: JaspritBumrah786 folded before Flop (didn't bet)
Seat 2: fishfry123 mucked
Seat 3: allthebest  (button) showed [9c Td] and won ($220.67) with Pair, 99
Seat 4: devi7 (small blind) folded before Flop
Seat 5: Lucifer999 (big blind) folded before Flop
Seat 6: spidy02 folded before Flop (didn't bet)



PokerStars Game #00327528734: Hold'em No Limit ($50/$100 USD) - 2022/04/30 09:43:55 ET
Table 'Hold'em (Min 25KMax 10K)    69' 6-max Seat #6 is the button
Seat 1: Lucifer999 ($12920.18 in chips) 
Seat 2: vinuth ($14085.06 in chips) 
Seat 3: bettercall7208 ($14504.02 in chips) 
Seat 4: TheWay ($3476.54 in chips) 
Seat 6: tabby20 ($10537 in chips) 
Lucifer999: posts small blind $50
vinuth: posts big blind $100
*** HOLE CARDS ***
Dealt to Lucifer999 [Kh 6s]
bettercall7208: raises $200.00 to $300
TheWay: folds
tabby20: calls $300
Lucifer999: folds
vinuth: folds
*** FLOP *** [Jh 3c Td]
bettercall7208: bets $358.5
tabby20: raises $537.75 to $896.25
bettercall7208: calls $537.75
*** TURN *** [Jh 3c Td] [4c]
bettercall7208: checks
tabby20: bets $1500
bettercall7208: folds
Uncalled bet ($1500) returned to tabby20
tabby20: doesn't show hand
tabby20 collected $2430.66 from pot
*** SUMMARY ***
Total pot $2542.50 | Rake $111.84
Board [Jh 3c Td 4c]
Seat 1: Lucifer999 (small blind) folded before Flop
Seat 2: vinuth (big blind) folded before Flop
Seat 3: bettercall7208 folded on the Turn
Seat 4: TheWay folded before Flop (didn't bet)
Seat 6: tabby20 (button) collected ($2430.66)



PokerStars Game #00327528812: Hold'em No Limit ($25/$50 USD) - 2022/04/30 09:44:19 ET
Table 'Hold'em (Min 1K Max 5K)   216' 6-max Seat #5 is the button
Seat 1: Lucifer999 ($15905.67 in chips) 
Seat 2: rahulh1 ($3550.64 in chips) 
Seat 4: raj90341 ($735.43 in chips) 
Seat 5: Avaroni ($5000 in chips) 
Lucifer999: posts small blind $25
rahulh1: posts big blind $50
*** HOLE CARDS ***
Dealt to Lucifer999 [Ah 6c]
raj90341: calls $50
Avaroni: folds
Lucifer999: calls $25
rahulh1: checks
*** FLOP *** [Jc 9d 9s]
Lucifer999: checks
rahulh1: checks
raj90341: checks
*** TURN *** [Jc 9d 9s] [5d]
Lucifer999: checks
rahulh1: checks
raj90341: checks
*** RIVER *** [Jc 9d 9s 5d] [9h]
Lucifer999: checks
rahulh1: checks
raj90341: checks
*** SHOW DOWN ***
Lucifer999: shows [Ah 6c] (Three of a kind, 999)
rahulh1: doesn't show hand
raj90341: doesn't show hand
Lucifer999 collected $142.5 from pot
*** SUMMARY ***
Total pot $150.00 | Rake $7.5
Board [Jc 9d 9s 5d 9h]
Seat 1: Lucifer999  (small blind) showed [Ah 6c] and won ($142.5) with Three of a kind, 999
Seat 2: rahulh1 (big blind) mucked
Seat 4: raj90341 mucked
Seat 5: Avaroni (button) folded before Flop (didn't bet)



PokerStars Game #00327528967: Hold'em No Limit ($25/$50 USD) - 2022/04/30 09:45:05 ET
Table 'Hold'em (Min 1K Max 5K)   216' 6-max Seat #1 is the button
Seat 1: Lucifer999 ($15998.17 in chips) 
Seat 2: rahulh1 ($3500.64 in chips) 
Seat 4: raj90341 ($685.43 in chips) 
Seat 5: Avaroni ($5000 in chips) 
rahulh1: posts small blind $25
raj90341: posts big blind $50
*** HOLE CARDS ***
Dealt to Lucifer999 [9d Js]
Avaroni: folds
Lucifer999: raises $100.00 to $150
rahulh1: folds
raj90341: raises $535.43 to $685.43
Lucifer999: folds
Uncalled bet ($535.43) returned to raj90341
raj90341: doesn't show hand
raj90341 collected $325 from pot
*** SUMMARY ***
Total pot $325.00 | Rake $0
Board []
Seat 1: Lucifer999 (button) folded before Flop
Seat 2: rahulh1 (small blind) folded before Flop
Seat 4: raj90341 (big blind) collected ($325)
Seat 5: Avaroni folded before Flop (didn't bet)



PokerStars Game #00327528897: Hold'em No Limit ($50/$100 USD) - 2022/04/30 09:44:45 ET
Table 'Hold'em (Min 25KMax 10K)    69' 6-max Seat #1 is the button
Seat 1: Lucifer999 ($12870.18 in chips) 
Seat 2: vinuth ($13985.06 in chips) 
Seat 3: bettercall7208 ($13307.77 in chips) 
Seat 4: TheWay ($3476.54 in chips) 
Seat 6: tabby20 ($11771.41 in chips) 
vinuth: posts small blind $50
bettercall7208: posts big blind $100
*** HOLE CARDS ***
Dealt to Lucifer999 [5c Ac]
TheWay: raises $100.00 to $200
tabby20: folds
Lucifer999: calls $200
vinuth: calls $150
bettercall7208: calls $100
*** FLOP *** [7h Kd 7c]
vinuth: checks
bettercall7208: checks
TheWay: bets $382.4
Lucifer999: folds
vinuth: calls $382.4
bettercall7208: folds
*** TURN *** [7h Kd 7c] [9c]
vinuth: checks
TheWay: bets $500
vinuth: raises $950.00 to $1450
TheWay: folds
Uncalled bet ($950) returned to vinuth
vinuth: doesn't show hand
vinuth collected $2451.99 from pot
*** SUMMARY ***
Total pot $2564.80 | Rake $112.81
Board [7h Kd 7c 9c]
Seat 1: Lucifer999 (button) folded on the Flop
Seat 2: vinuth (small blind) collected ($2451.99)
Seat 3: bettercall7208 (big blind) folded on the Flop
Seat 4: TheWay folded on the Turn
Seat 6: tabby20 folded before Flop (didn't bet)



PokerStars Game #00327528879: Hold'em No Limit ($10/$25 USD) - 2022/04/30 09:44:37 ET
Table 'Hold'em (Min 500Max 2500) 1001' 6-max Seat #4 is the button
Seat 1: JaspritBumrah786 ($2089.01 in chips) 
Seat 2: fishfry123 ($917.4 in chips) 
Seat 3: allthebest ($2245.67 in chips) 
Seat 4: devi7 ($2443.83 in chips) 
Seat 5: Lucifer999 ($4801.14 in chips) 
Seat 6: spidy02 ($3706.51 in chips) 
Lucifer999: posts small blind $10
spidy02: posts big blind $25
*** HOLE CARDS ***
Dealt to Lucifer999 [4h Ac]
JaspritBumrah786: folds
fishfry123: raises $38.75 to $63.75
allthebest: folds
devi7: calls $63.75
Lucifer999: folds
spidy02: calls $38.75
*** FLOP *** [7s 4s Ad]
spidy02: bets $94.35
fishfry123: calls $94.35
devi7: calls $94.35
*** TURN *** [7s 4s Ad] [5s]
spidy02: checks
fishfry123: checks
devi7: bets $390
spidy02: folds
fishfry123: folds
Uncalled bet ($390) returned to devi7
devi7: doesn't show hand
devi7 collected $454.89 from pot
*** SUMMARY ***
Total pot $484.30 | Rake $29.41
Board [7s 4s Ad 5s]
Seat 1: JaspritBumrah786 folded before Flop (didn't bet)
Seat 2: fishfry123 folded on the Turn
Seat 3: allthebest folded before Flop (didn't bet)
Seat 4: devi7 (button) collected ($454.89)
Seat 5: Lucifer999 (small blind) folded before Flop
Seat 6: spidy02 (big blind) folded on the Turn



PokerStars Game #00327529050: Hold'em No Limit ($10/$25 USD) - 2022/04/30 09:45:37 ET
Table 'Hold'em (Min 500Max 2500)  1282' 6-max Seat #5 is the button
Seat 1: frostbyte28 ($2500 in chips) 
Seat 5: Lucifer999 ($5374.5 in chips) 
Lucifer999: posts small blind $10
frostbyte28: posts big blind $25
*** HOLE CARDS ***
Dealt to Lucifer999 [Kh 9c]
Lucifer999: raises $50.00 to $75
frostbyte28: folds
Uncalled bet ($50) returned to Lucifer999
Lucifer999: doesn't show hand
Lucifer999 collected $50 from pot
*** SUMMARY ***
Total pot $50.00 | Rake $0
Board []
Seat 1: frostbyte28 (big blind) folded before Flop
Seat 5: Lucifer999 (button) (small blind) collected ($50)



PokerStars Game #00327529096: Hold'em No Limit ($10/$25 USD) - 2022/04/30 09:45:52 ET
Table 'Hold'em (Min 500Max 2500)  1282' 6-max Seat #1 is the button
Seat 1: frostbyte28 ($2475 in chips) 
Seat 5: Lucifer999 ($5399.5 in chips) 
frostbyte28: posts small blind $10
Lucifer999: posts big blind $25
*** HOLE CARDS ***
Dealt to Lucifer999 [5d Jh]
frostbyte28: folds
Uncalled bet ($15) returned to Lucifer999
Lucifer999: doesn't show hand
Lucifer999 collected $20 from pot
*** SUMMARY ***
Total pot $20.00 | Rake $0
Board []
Seat 1: frostbyte28 (button) (small blind) folded before Flop
Seat 5: Lucifer999 (big blind) collected ($20)



PokerStars Game #00327529045: Hold'em No Limit ($25/$50 USD) - 2022/04/30 09:45:36 ET
Table 'Hold'em (Min 1K Max 5K)   216' 6-max Seat #2 is the button
Seat 1: Lucifer999 ($15848.17 in chips) 
Seat 2: rahulh1 ($3475.64 in chips) 
Seat 4: raj90341 ($860.43 in chips) 
Seat 5: Avaroni ($5000 in chips) 
raj90341: posts small blind $25
Avaroni: posts big blind $50
*** HOLE CARDS ***
Dealt to Lucifer999 [5c 8s]
Lucifer999: folds
rahulh1: folds
raj90341: calls $25
Avaroni: raises $150.00 to $200
raj90341: calls $150
*** FLOP *** [2h Qd 7h]
raj90341: checks
Avaroni: bets $150
raj90341: folds
Uncalled bet ($150) returned to Avaroni
Avaroni: doesn't show hand
Avaroni collected $380 from pot
*** SUMMARY ***
Total pot $400.00 | Rake $20
Board [2h Qd 7h]
Seat 1: Lucifer999 folded before Flop (didn't bet)
Seat 2: rahulh1 (button) folded before Flop (didn't bet)
Seat 4: raj90341 (small blind) folded on the Flop
Seat 5: Avaroni (big blind) collected ($380)



PokerStars Game #00327529093: Hold'em No Limit ($10/$25 USD) - 2022/04/30 09:45:51 ET
Table 'Hold'em (Min 500Max 2500) 1001' 6-max Seat #5 is the button
Seat 1: JaspritBumrah786 ($2089.01 in chips) 
Seat 2: fishfry123 ($759.3 in chips) 
Seat 3: allthebest ($2245.67 in chips) 
Seat 4: devi7 ($2740.62 in chips) 
Seat 5: Lucifer999 ($4791.14 in chips) 
Seat 6: spidy02 ($3548.41 in chips) 
spidy02: posts small blind $10
JaspritBumrah786: posts big blind $25
*** HOLE CARDS ***
Dealt to Lucifer999 [8h 9d]
fishfry123: calls $25
allthebest: folds
devi7: folds
Lucifer999: folds
spidy02: folds
JaspritBumrah786: checks
*** FLOP *** [Js Ts 8c]
JaspritBumrah786: checks
fishfry123: bets $42.64
JaspritBumrah786: folds
Uncalled bet ($42.64) returned to fishfry123
fishfry123: doesn't show hand
fishfry123 collected $56.85 from pot
*** SUMMARY ***
Total pot $60.00 | Rake $3.15
Board [Js Ts 8c]
Seat 1: JaspritBumrah786 (big blind) folded on the Flop
Seat 2: fishfry123 collected ($56.85)
Seat 3: allthebest folded before Flop (didn't bet)
Seat 4: devi7 folded before Flop (didn't bet)
Seat 5: Lucifer999 (button) folded before Flop (didn't bet)
Seat 6: spidy02 (small blind) folded before Flop



PokerStars Game #00327529119: Hold'em No Limit ($10/$25 USD) - 2022/04/30 09:45:59 ET
Table 'Hold'em (Min 500Max 2500)  1282' 6-max Seat #5 is the button
Seat 1: frostbyte28 ($2465 in chips) 
Seat 5: Lucifer999 ($5409.5 in chips) 
Lucifer999: posts small blind $10
frostbyte28: posts big blind $25
*** HOLE CARDS ***
Dealt to Lucifer999 [As 4d]
Lucifer999: raises $50.00 to $75
frostbyte28: calls $50
*** FLOP *** [4c 4h Kd]
frostbyte28: checks
Lucifer999: bets $130
frostbyte28: folds
Uncalled bet ($130) returned to Lucifer999
Lucifer999: doesn't show hand
Lucifer999 collected $143.25 from pot
*** SUMMARY ***
Total pot $150.00 | Rake $6.75
Board [4c 4h Kd]
Seat 1: frostbyte28 (big blind) folded on the Flop
Seat 5: Lucifer999 (button) (small blind) collected ($143.25)



PokerStars Game #00327529204: Hold'em No Limit ($10/$25 USD) - 2022/04/30 09:46:26 ET
Table 'Hold'em (Min 500Max 2500)  1282' 6-max Seat #1 is the button
Seat 1: frostbyte28 ($2390 in chips) 
Seat 5: Lucifer999 ($5477.75 in chips) 
frostbyte28: posts small blind $10
Lucifer999: posts big blind $25
*** HOLE CARDS ***
Dealt to Lucifer999 [2d 7d]
frostbyte28: folds
Uncalled bet ($15) returned to Lucifer999
Lucifer999: doesn't show hand
Lucifer999 collected $20 from pot
*** SUMMARY ***
Total pot $20.00 | Rake $0
Board []
Seat 1: frostbyte28 (button) (small blind) folded before Flop
Seat 5: Lucifer999 (big blind) collected ($20)



PokerStars Game #00327529056: Hold'em No Limit ($50/$100 USD) - 2022/04/30 09:45:38 ET
Table 'Hold'em (Min 25KMax 10K)    69' 6-max Seat #2 is the button
Seat 1: Lucifer999 ($12670.18 in chips) 
Seat 2: vinuth ($15354.65 in chips) 
Seat 3: bettercall7208 ($13107.77 in chips) 
Seat 4: TheWay ($2394.14 in chips) 
Seat 6: tabby20 ($11771.41 in chips) 
bettercall7208: posts small blind $50
TheWay: posts big blind $100
*** HOLE CARDS ***
Dealt to Lucifer999 [Ts Qs]
tabby20: raises $250.00 to $350
Lucifer999: folds
vinuth: calls $350
bettercall7208: folds
TheWay: calls $250
*** FLOP *** [2d 9s As]
TheWay: checks
tabby20: checks
vinuth: checks
*** TURN *** [2d 9s As] [5h]
TheWay: checks
tabby20: bets $750
vinuth: calls $750
TheWay: folds
*** RIVER *** [2d 9s As 5h] [Qh]
tabby20: checks
vinuth: checks
*** SHOW DOWN ***
tabby20: shows [8c Tc] (High card, A)
vinuth: shows [9d Th] (Pair, 99)
vinuth collected $2485.6 from pot
*** SUMMARY ***
Total pot $2600.00 | Rake $114.4
Board [2d 9s As 5h Qh]
Seat 1: Lucifer999 folded before Flop (didn't bet)
Seat 2: vinuth  (button) showed [9d Th] and won ($2485.6) with Pair, 99
Seat 3: bettercall7208 (small blind) folded before Flop
Seat 4: TheWay (big blind) folded on the Turn
Seat 6: tabby20 showed [8c Tc] and lost with High card, A



PokerStars Game #00327529164: Hold'em No Limit ($25/$50 USD) - 2022/04/30 09:46:12 ET
Table 'Hold'em (Min 1K Max 5K)   216' 6-max Seat #4 is the button
Seat 1: Lucifer999 ($15848.17 in chips) 
Seat 2: rahulh1 ($3475.64 in chips) 
Seat 4: raj90341 ($660.43 in chips) 
Seat 5: Avaroni ($5180 in chips) 
Avaroni: posts small blind $25
Lucifer999: posts big blind $50
*** HOLE CARDS ***
Dealt to Lucifer999 [Jh 8c]
rahulh1: folds
raj90341: calls $50
Avaroni: folds
Lucifer999: checks
*** FLOP *** [7h 2h Kc]
Lucifer999: checks
raj90341: checks
*** TURN *** [7h 2h Kc] [Qc]
Lucifer999: checks
raj90341: checks
*** RIVER *** [7h 2h Kc Qc] [2s]
Lucifer999: bets $150
raj90341: folds
Uncalled bet ($150) returned to Lucifer999
Lucifer999: doesn't show hand
Lucifer999 collected $118.75 from pot
*** SUMMARY ***
Total pot $125.00 | Rake $6.25
Board [7h 2h Kc Qc 2s]
Seat 1: Lucifer999 (big blind) collected ($118.75)
Seat 2: rahulh1 folded before Flop (didn't bet)
Seat 4: raj90341 (button) folded on the River
Seat 5: Avaroni (small blind) folded before Flop



PokerStars Game #00327529187: Hold'em No Limit ($10/$25 USD) - 2022/04/30 09:46:21 ET
Table 'Hold'em (Min 500Max 2500) 1001' 6-max Seat #6 is the button
Seat 1: JaspritBumrah786 ($2064.01 in chips) 
Seat 2: fishfry123 ($791.15 in chips) 
Seat 3: allthebest ($2245.67 in chips) 
Seat 4: devi7 ($2740.62 in chips) 
Seat 5: Lucifer999 ($4791.14 in chips) 
Seat 6: spidy02 ($3538.41 in chips) 
JaspritBumrah786: posts small blind $10
fishfry123: posts big blind $25
*** HOLE CARDS ***
Dealt to Lucifer999 [9d Js]
allthebest: folds
devi7: folds
Lucifer999: folds
spidy02: folds
JaspritBumrah786: raises $50.00 to $75
fishfry123: calls $50
*** FLOP *** [Ts 4d 2d]
JaspritBumrah786: checks
fishfry123: checks
*** TURN *** [Ts 4d 2d] [Th]
JaspritBumrah786: checks
fishfry123: checks
*** RIVER *** [Ts 4d 2d Th] [3h]
JaspritBumrah786: checks
fishfry123: checks
*** SHOW DOWN ***
JaspritBumrah786: shows [Kc Qh] (Pair, TT)
fishfry123: shows [7c Ad] (Pair, TT)
fishfry123 collected $141.13 from pot
*** SUMMARY ***
Total pot $150.00 | Rake $8.87
Board [Ts 4d 2d Th 3h]
Seat 1: JaspritBumrah786 (small blind) showed [Kc Qh] and lost with Pair, TT
Seat 2: fishfry123  (big blind) showed [7c Ad] and won ($141.13) with Pair, TT
Seat 3: allthebest folded before Flop (didn't bet)
Seat 4: devi7 folded before Flop (didn't bet)
Seat 5: Lucifer999 folded before Flop (didn't bet)
Seat 6: spidy02 (button) folded before Flop (didn't bet)



PokerStars Game #00327529227: Hold'em No Limit ($10/$25 USD) - 2022/04/30 09:46:33 ET
Table 'Hold'em (Min 500Max 2500)  1282' 6-max Seat #5 is the button
Seat 1: frostbyte28 ($2380 in chips) 
Seat 5: Lucifer999 ($5487.75 in chips) 
Lucifer999: posts small blind $10
frostbyte28: posts big blind $25
*** HOLE CARDS ***
Dealt to Lucifer999 [9d Th]
Lucifer999: calls $15
frostbyte28: checks
*** FLOP *** [5h Ac 6s]
frostbyte28: checks
Lucifer999: bets $40
frostbyte28: calls $40
*** TURN *** [5h Ac 6s] [2h]
frostbyte28: checks
Lucifer999: checks
*** RIVER *** [5h Ac 6s 2h] [Kd]
frostbyte28: bets $93.11
Lucifer999: folds
Uncalled bet ($93.11) returned to frostbyte28
frostbyte28: doesn't show hand
frostbyte28 collected $124.15 from pot
*** SUMMARY ***
Total pot $130.00 | Rake $5.85
Board [5h Ac 6s 2h Kd]
Seat 1: frostbyte28 (big blind) collected ($124.15)
Seat 5: Lucifer999 (button) (small blind) folded on the River



PokerStars Game #00327529293: Hold'em No Limit ($25/$50 USD) - 2022/04/30 09:46:56 ET
Table 'Hold'em (Min 1K Max 5K)   216' 6-max Seat #5 is the button
Seat 1: Lucifer999 ($15916.92 in chips) 
Seat 2: rahulh1 ($3475.64 in chips) 
Seat 4: raj90341 ($610.43 in chips) 
Seat 5: Avaroni ($5155 in chips) 
Lucifer999: posts small blind $25
rahulh1: posts big blind $50
*** HOLE CARDS ***
Dealt to Lucifer999 [6c 4c]
raj90341: calls $50
Avaroni: folds
Lucifer999: calls $25
rahulh1: checks
*** FLOP *** [9h Js 3h]
Lucifer999: checks
rahulh1: checks
raj90341: bets $560.43
Lucifer999: folds
rahulh1: folds
Uncalled bet ($560.43) returned to raj90341
raj90341: doesn't show hand
raj90341 collected $142.5 from pot
*** SUMMARY ***
Total pot $150.00 | Rake $7.5
Board [9h Js 3h]
Seat 1: Lucifer999 (small blind) folded on the Flop
Seat 2: rahulh1 (big blind) folded on the Flop
Seat 4: raj90341 collected ($142.5)
Seat 5: Avaroni (button) folded before Flop (didn't bet)



PokerStars Game #00327529325: Hold'em No Limit ($10/$25 USD) - 2022/04/30 09:47:07 ET
Table 'Hold'em (Min 500Max 2500) 1001' 6-max Seat #1 is the button
Seat 1: JaspritBumrah786 ($2025 in chips) 
Seat 2: fishfry123 ($857.28 in chips) 
Seat 3: allthebest ($2245.67 in chips) 
Seat 4: devi7 ($2740.62 in chips) 
Seat 5: Lucifer999 ($4791.14 in chips) 
Seat 6: spidy02 ($3538.41 in chips) 
fishfry123: posts small blind $10
allthebest: posts big blind $25
*** HOLE CARDS ***
Dealt to Lucifer999 [Ac 7c]
devi7: folds
Lucifer999: folds
spidy02: folds
JaspritBumrah786: folds
fishfry123: raises $25.00 to $50
allthebest: folds
Uncalled bet ($25) returned to fishfry123
fishfry123: doesn't show hand
fishfry123 collected $50 from pot
*** SUMMARY ***
Total pot $50.00 | Rake $0
Board []
Seat 1: JaspritBumrah786 (button) folded before Flop (didn't bet)
Seat 2: fishfry123 (small blind) collected ($50)
Seat 3: allthebest (big blind) folded before Flop
Seat 4: devi7 folded before Flop (didn't bet)
Seat 5: Lucifer999 folded before Flop (didn't bet)
Seat 6: spidy02 folded before Flop (didn't bet)



PokerStars Game #00327529235: Hold'em No Limit ($50/$100 USD) - 2022/04/30 09:46:37 ET
Table 'Hold'em (Min 25KMax 10K)    69' 6-max Seat #3 is the button
Seat 1: Lucifer999 ($12670.18 in chips) 
Seat 2: vinuth ($16740.25 in chips) 
Seat 3: bettercall7208 ($13057.77 in chips) 
Seat 4: TheWay ($2044.14 in chips) 
Seat 6: tabby20 ($10671.41 in chips) 
TheWay: posts small blind $50
Lucifer999: posts big blind $100
*** HOLE CARDS ***
Dealt to Lucifer999 [Ad Qc]
vinuth: raises $200.00 to $300
bettercall7208: calls $300
TheWay: folds
Lucifer999: raises $1200.00 to $1500
vinuth: calls $1200
bettercall7208: folds
*** FLOP *** [2h 2s 3d]
Lucifer999: bets $1500
vinuth: calls $1500
*** TURN *** [2h 2s 3d] [3c]
Lucifer999: bets $4400
vinuth: raises $9340.25 to $13740.25
Lucifer999: folds
Uncalled bet ($9340.25) returned to vinuth
vinuth: doesn't show hand
vinuth collected $14710 from pot
*** SUMMARY ***
Total pot $15150.00 | Rake $440
Board [2h 2s 3d 3c]
Seat 1: Lucifer999 (big blind) folded on the Turn
Seat 2: vinuth collected ($14710)
Seat 3: bettercall7208 (button) folded before Flop
Seat 4: TheWay (small blind) folded before Flop



PokerStars Game #00327529383: Hold'em No Limit ($25/$50 USD) - 2022/04/30 09:47:25 ET
Table 'Hold'em (Min 1K Max 5K)   216' 6-max Seat #1 is the button
Seat 1: Lucifer999 ($15866.92 in chips) 
Seat 2: rahulh1 ($3425.64 in chips) 
Seat 4: raj90341 ($702.93 in chips) 
Seat 5: Avaroni ($5155 in chips) 
rahulh1: posts small blind $25
raj90341: posts big blind $50
*** HOLE CARDS ***
Dealt to Lucifer999 [Qs Ac]
Avaroni: folds
Lucifer999: raises $100.00 to $150
rahulh1: folds
raj90341: folds
Uncalled bet ($100) returned to Lucifer999
Lucifer999: doesn't show hand
Lucifer999 collected $125 from pot
*** SUMMARY ***
Total pot $125.00 | Rake $0
Board []
Seat 1: Lucifer999 (button) collected ($125)
Seat 2: rahulh1 (small blind) folded before Flop
Seat 4: raj90341 (big blind) folded before Flop
Seat 5: Avaroni folded before Flop (didn't bet)



PokerStars Game #00327529429: Hold'em No Limit ($10/$25 USD) - 2022/04/30 09:47:40 ET
Table 'Hold'em (Min 500Max 2500) 1001' 6-max Seat #2 is the button
Seat 1: JaspritBumrah786 ($2025 in chips) 
Seat 2: fishfry123 ($882.28 in chips) 
Seat 3: allthebest ($2220.67 in chips) 
Seat 4: devi7 ($2740.62 in chips) 
Seat 5: Lucifer999 ($4791.14 in chips) 
Seat 6: spidy02 ($3538.41 in chips) 
allthebest: posts small blind $10
devi7: posts big blind $25
*** HOLE CARDS ***
Dealt to Lucifer999 [Qh Qd]
Lucifer999: folds
spidy02: raises $38.75 to $63.75
JaspritBumrah786: folds
fishfry123: folds
allthebest: folds
devi7: folds
Uncalled bet ($38.75) returned to spidy02
spidy02: doesn't show hand
spidy02 collected $60 from pot
*** SUMMARY ***
Total pot $60.00 | Rake $0
Board []
Seat 1: JaspritBumrah786 folded before Flop (didn't bet)
Seat 2: fishfry123 (button) folded before Flop (didn't bet)
Seat 3: allthebest (small blind) folded before Flop
Seat 4: devi7 (big blind) folded before Flop
Seat 5: Lucifer999 folded before Flop (didn't bet)
Seat 6: spidy02 collected ($60)



PokerStars Game #00327529464: Hold'em No Limit ($25/$50 USD) - 2022/04/30 09:47:52 ET
Table 'Hold'em (Min 1K Max 5K)   216' 6-max Seat #2 is the button
Seat 1: Lucifer999 ($15941.92 in chips) 
Seat 2: rahulh1 ($3400.64 in chips) 
Seat 4: raj90341 ($652.93 in chips) 
Seat 5: Avaroni ($5155 in chips) 
raj90341: posts small blind $25
Avaroni: posts big blind $50
*** HOLE CARDS ***
Dealt to Lucifer999 [Kc 8h]
Lucifer999: folds
rahulh1: folds
raj90341: folds
Uncalled bet ($25) returned to Avaroni
Avaroni: doesn't show hand
Avaroni collected $50 from pot
*** SUMMARY ***
Total pot $50.00 | Rake $0
Board []
Seat 1: Lucifer999 folded before Flop (didn't bet)
Seat 2: rahulh1 (button) folded before Flop (didn't bet)
Seat 4: raj90341 (small blind) folded before Flop
Seat 5: Avaroni (big blind) collected ($50)



PokerStars Game #00327529427: Hold'em No Limit ($50/$100 USD) - 2022/04/30 09:47:39 ET
Table 'Hold'em (Min 25KMax 10K)    69' 6-max Seat #4 is the button
Seat 1: Lucifer999 ($10000 in chips) 
Seat 2: vinuth ($24050.25 in chips) 
Seat 3: bettercall7208 ($12757.77 in chips) 
Seat 4: TheWay ($1994.14 in chips) 
Lucifer999: posts small blind $50
vinuth: posts big blind $100
*** HOLE CARDS ***
Dealt to Lucifer999 [Th Qc]
bettercall7208: folds
TheWay: raises $250.00 to $350
Lucifer999: folds
vinuth: calls $250
*** FLOP *** [6c Js 2d]
vinuth: checks
TheWay: bets $717
vinuth: folds
Uncalled bet ($717) returned to TheWay
TheWay: doesn't show hand
TheWay collected $717 from pot
*** SUMMARY ***
Total pot $750.00 | Rake $33
Board [6c Js 2d]
Seat 1: Lucifer999 (small blind) folded before Flop
Seat 2: vinuth (big blind) folded on the Flop
Seat 3: bettercall7208 folded before Flop (didn't bet)
Seat 4: TheWay (button) collected ($717)



PokerStars Game #00327529364: Hold'em No Limit ($10/$25 USD) - 2022/04/30 09:47:20 ET
Table 'Hold'em (Min 500Max 2500)  1282' 6-max Seat #1 is the button
Seat 1: frostbyte28 ($2439.15 in chips) 
Seat 5: Lucifer999 ($5422.75 in chips) 
frostbyte28: posts small blind $10
Lucifer999: posts big blind $25
*** HOLE CARDS ***
Dealt to Lucifer999 [Qs 4h]
frostbyte28: raises $33.75 to $58.75
Lucifer999: calls $33.75
*** FLOP *** [5h Ad Qc]
Lucifer999: checks
frostbyte28: bets $84.18
Lucifer999: calls $84.18
*** TURN *** [5h Ad Qc] [4s]
Lucifer999: checks
frostbyte28: checks
*** RIVER *** [5h Ad Qc 4s] [5c]
Lucifer999: bets $200
frostbyte28: folds
Uncalled bet ($200) returned to Lucifer999
Lucifer999: doesn't show hand
Lucifer999 collected $273.04 from pot
*** SUMMARY ***
Total pot $285.86 | Rake $12.82
Board [5h Ad Qc 4s 5c]
Seat 1: frostbyte28 (button) (small blind) folded on the River
Seat 5: Lucifer999 (big blind) collected ($273.04)



PokerStars Game #00327529546: Hold'em No Limit ($10/$25 USD) - 2022/04/30 09:48:17 ET
Table 'Hold'em (Min 500Max 2500)  1282' 6-max Seat #5 is the button
Seat 1: frostbyte28 ($2296.22 in chips) 
Seat 5: Lucifer999 ($5552.86 in chips) 
Lucifer999: posts small blind $10
frostbyte28: posts big blind $25
*** HOLE CARDS ***
Dealt to Lucifer999 [3h Kd]
Lucifer999: raises $50.00 to $75
frostbyte28: folds
Uncalled bet ($50) returned to Lucifer999
Lucifer999: doesn't show hand
Lucifer999 collected $50 from pot
*** SUMMARY ***
Total pot $50.00 | Rake $0
Board []
Seat 1: frostbyte28 (big blind) folded before Flop
Seat 5: Lucifer999 (button) (small blind) collected ($50)



PokerStars Game #00327529586: Hold'em No Limit ($10/$25 USD) - 2022/04/30 09:48:31 ET
Table 'Hold'em (Min 500Max 2500)  1282' 6-max Seat #1 is the button
Seat 1: frostbyte28 ($2271.22 in chips) 
Seat 5: Lucifer999 ($5577.86 in chips) 
Seat 6: devi7 ($2575 in chips) 
frostbyte28: posts small blind $10
Lucifer999: posts big blind $25
*** HOLE CARDS ***
Dealt to Lucifer999 [Kd Td]
frostbyte28: folds
Uncalled bet ($15) returned to Lucifer999
Lucifer999: doesn't show hand
Lucifer999 collected $20 from pot
*** SUMMARY ***
Total pot $20.00 | Rake $0
Board []
Seat 1: frostbyte28 (button) (small blind) folded before Flop
Seat 5: Lucifer999 (big blind) collected ($20)



PokerStars Game #00327529540: Hold'em No Limit ($50/$100 USD) - 2022/04/30 09:48:15 ET
Table 'Hold'em (Min 25KMax 10K)    69' 6-max Seat #1 is the button
Seat 1: Lucifer999 ($10000 in chips) 
Seat 2: vinuth ($23700.25 in chips) 
Seat 3: bettercall7208 ($12757.77 in chips) 
Seat 4: TheWay ($2361.14 in chips) 
vinuth: posts small blind $50
bettercall7208: posts big blind $100
*** HOLE CARDS ***
Dealt to Lucifer999 [7d Ac]
TheWay: calls $100
Lucifer999: folds
vinuth: folds
bettercall7208: checks
*** FLOP *** [Ks 2d 6c]
bettercall7208: checks
TheWay: bets $239
bettercall7208: folds
Uncalled bet ($239) returned to TheWay
TheWay: doesn't show hand
TheWay collected $239 from pot
*** SUMMARY ***
Total pot $250.00 | Rake $11
Board [Ks 2d 6c]
Seat 1: Lucifer999 (button) folded before Flop (didn't bet)
Seat 2: vinuth (small blind) folded before Flop
Seat 3: bettercall7208 (big blind) folded on the Flop
Seat 4: TheWay collected ($239)



PokerStars Game #00327529528: Hold'em No Limit ($10/$25 USD) - 2022/04/30 09:48:12 ET
Table 'Hold'em (Min 500Max 2500) 1001' 6-max Seat #3 is the button
Seat 1: JaspritBumrah786 ($2025 in chips) 
Seat 2: fishfry123 ($882.28 in chips) 
Seat 3: allthebest ($2210.67 in chips) 
Seat 4: devi7 ($2715.62 in chips) 
Seat 5: Lucifer999 ($4791.14 in chips) 
Seat 6: spidy02 ($3573.41 in chips) 
devi7: posts small blind $10
Lucifer999: posts big blind $25
*** HOLE CARDS ***
Dealt to Lucifer999 [Th 4c]
spidy02: folds
JaspritBumrah786: folds
fishfry123: folds
allthebest: raises $50.00 to $75
devi7: folds
Lucifer999: folds
Uncalled bet ($50) returned to allthebest
allthebest: doesn't show hand
allthebest collected $60 from pot
*** SUMMARY ***
Total pot $60.00 | Rake $0
Board []
Seat 1: JaspritBumrah786 folded before Flop (didn't bet)
Seat 2: fishfry123 folded before Flop (didn't bet)
Seat 3: allthebest (button) collected ($60)
Seat 4: devi7 (small blind) folded before Flop
Seat 5: Lucifer999 (big blind) folded before Flop
Seat 6: spidy02 folded before Flop (didn't bet)



PokerStars Game #00327529533: Hold'em No Limit ($25/$50 USD) - 2022/04/30 09:48:13 ET
Table 'Hold'em (Min 1K Max 5K)   216' 6-max Seat #4 is the button
Seat 1: Lucifer999 ($15941.92 in chips) 
Seat 2: rahulh1 ($3400.64 in chips) 
Seat 4: raj90341 ($627.93 in chips) 
Seat 5: Avaroni ($5180 in chips) 
Avaroni: posts small blind $25
Lucifer999: posts big blind $50
*** HOLE CARDS ***
Dealt to Lucifer999 [Kd 3h]
rahulh1: folds
raj90341: folds
Avaroni: raises $100.00 to $150
Lucifer999: calls $100
*** FLOP *** [5d 2s 5h]
Avaroni: bets $142.5
Lucifer999: calls $142.5
*** TURN *** [5d 2s 5h] [2h]
Avaroni: checks
Lucifer999: bets $200
Avaroni: folds
Uncalled bet ($200) returned to Lucifer999
Lucifer999: doesn't show hand
Lucifer999 collected $555.75 from pot
*** SUMMARY ***
Total pot $585.00 | Rake $29.25
Board [5d 2s 5h 2h]
Seat 1: Lucifer999 (big blind) collected ($555.75)
Seat 2: rahulh1 folded before Flop (didn't bet)
Seat 4: raj90341 (button) folded before Flop (didn't bet)
Seat 5: Avaroni (small blind) folded on the Turn



PokerStars Game #00327529621: Hold'em No Limit ($50/$100 USD) - 2022/04/30 09:48:39 ET
Table 'Hold'em (Min 25KMax 10K)    69' 6-max Seat #2 is the button
Seat 1: Lucifer999 ($10000 in chips) 
Seat 2: vinuth ($23650.25 in chips) 
Seat 3: bettercall7208 ($12657.77 in chips) 
Seat 4: TheWay ($2500.14 in chips) 
bettercall7208: posts small blind $50
TheWay: posts big blind $100
*** HOLE CARDS ***
Dealt to Lucifer999 [4c 9c]
Lucifer999: folds
vinuth: calls $100
bettercall7208: raises $183.33 to $283.33
TheWay: calls $183.33
vinuth: calls $183.33
*** FLOP *** [Ac 2h 3h]
bettercall7208: bets $541.76
TheWay: folds
vinuth: folds
Uncalled bet ($541.76) returned to bettercall7208
bettercall7208: doesn't show hand
bettercall7208 collected $812.64 from pot
*** SUMMARY ***
Total pot $849.99 | Rake $37.35
Board [Ac 2h 3h]
Seat 1: Lucifer999 folded before Flop (didn't bet)
Seat 2: vinuth (button) folded on the Flop
Seat 3: bettercall7208 (small blind) collected ($812.64)
Seat 4: TheWay (big blind) folded on the Flop



PokerStars Game #00327529665: Hold'em No Limit ($10/$25 USD) - 2022/04/30 09:48:53 ET
Table 'Hold'em (Min 500Max 2500) 1001' 6-max Seat #4 is the button
Seat 1: JaspritBumrah786 ($2025 in chips) 
Seat 2: fishfry123 ($882.28 in chips) 
Seat 3: allthebest ($2245.67 in chips) 
Seat 4: devi7 ($2705.62 in chips) 
Seat 5: Lucifer999 ($4766.14 in chips) 
Seat 6: spidy02 ($3573.41 in chips) 
Lucifer999: posts small blind $10
spidy02: posts big blind $25
*** HOLE CARDS ***
Dealt to Lucifer999 [8d 7c]
JaspritBumrah786: folds
fishfry123: folds
allthebest: raises $50.00 to $75
devi7: folds
Lucifer999: folds
spidy02: folds
Uncalled bet ($50) returned to allthebest
allthebest: doesn't show hand
allthebest collected $60 from pot
*** SUMMARY ***
Total pot $60.00 | Rake $0
Board []
Seat 1: JaspritBumrah786 folded before Flop (didn't bet)
Seat 2: fishfry123 folded before Flop (didn't bet)
Seat 3: allthebest collected ($60)
Seat 4: devi7 (button) folded before Flop (didn't bet)
Seat 5: Lucifer999 (small blind) folded before Flop
Seat 6: spidy02 (big blind) folded before Flop



PokerStars Game #00327529614: Hold'em No Limit ($10/$25 USD) - 2022/04/30 09:48:38 ET
Table 'Hold'em (Min 500Max 2500)  1282' 6-max Seat #5 is the button
Seat 1: frostbyte28 ($2261.22 in chips) 
Seat 2: foldmybets ($525 in chips) 
Seat 5: Lucifer999 ($5587.86 in chips) 
Seat 6: devi7 ($2575 in chips) 
Lucifer999: posts small blind $10
frostbyte28: posts big blind $25
*** HOLE CARDS ***
Dealt to Lucifer999 [7d 4s]
Lucifer999: calls $15
frostbyte28: checks
*** FLOP *** [Td Ks 9d]
frostbyte28: checks
Lucifer999: bets $30
frostbyte28: calls $30
*** TURN *** [Td Ks 9d] [4d]
frostbyte28: checks
Lucifer999: checks
*** RIVER *** [Td Ks 9d 4d] [5c]
frostbyte28: bets $78.79
Lucifer999: folds
Uncalled bet ($78.79) returned to frostbyte28
frostbyte28: doesn't show hand
frostbyte28 collected $105.05 from pot
*** SUMMARY ***
Total pot $110.00 | Rake $4.95
Board [Td Ks 9d 4d 5c]
Seat 1: frostbyte28 (big blind) collected ($105.05)
Seat 5: Lucifer999 (button) (small blind) folded on the River



PokerStars Game #00327529797: Hold'em No Limit ($10/$25 USD) - 2022/04/30 09:49:35 ET
Table 'Hold'em (Min 500Max 2500)  1282' 6-max Seat #1 is the button
Seat 1: frostbyte28 ($2311.27 in chips) 
Seat 2: jayakumar2020 ($525 in chips) 
Seat 3: wahmodijiwah ($2500 in chips) 
Seat 5: Lucifer999 ($5532.86 in chips) 
Seat 6: devi7 ($2575 in chips) 
Lucifer999: posts small blind $10
devi7: posts big blind $25
*** HOLE CARDS ***
Dealt to Lucifer999 [As Js]
frostbyte28: folds
Lucifer999: raises $55.00 to $80
devi7: folds
Uncalled bet ($55) returned to Lucifer999
Lucifer999: doesn't show hand
Lucifer999 collected $50 from pot
*** SUMMARY ***
Total pot $50.00 | Rake $0
Board []
Seat 1: frostbyte28 (button) folded before Flop (didn't bet)
Seat 5: Lucifer999 (small blind) collected ($50)
Seat 6: devi7 (big blind) folded before Flop



PokerStars Game #00327529674: Hold'em No Limit ($25/$50 USD) - 2022/04/30 09:48:56 ET
Table 'Hold'em (Min 1K Max 5K)   216' 6-max Seat #5 is the button
Seat 1: Lucifer999 ($16205.17 in chips) 
Seat 2: rahulh1 ($3400.64 in chips) 
Seat 4: raj90341 ($627.93 in chips) 
Seat 5: Avaroni ($5000 in chips) 
Lucifer999: posts small blind $25
rahulh1: posts big blind $50
*** HOLE CARDS ***
Dealt to Lucifer999 [Kd 9s]
raj90341: calls $50
Avaroni: calls $50
Lucifer999: folds
rahulh1: checks
*** FLOP *** [9d 5h 8h]
rahulh1: bets $50
raj90341: calls $50
Avaroni: calls $50
*** TURN *** [9d 5h 8h] [4c]
rahulh1: bets $105.48
raj90341: folds
Avaroni: calls $105.48
*** RIVER *** [9d 5h 8h 4c] [Tc]
rahulh1: checks
Avaroni: bets $200
rahulh1: calls $200
*** SHOW DOWN ***
Avaroni: shows [Ts Kh] (Pair, TT)
rahulh1: doesn't show hand
Avaroni collected $889.21 from pot
*** SUMMARY ***
Total pot $935.96 | Rake $46.75
Board [9d 5h 8h 4c Tc]
Seat 1: Lucifer999 (small blind) folded before Flop
Seat 2: rahulh1 (big blind) mucked
Seat 4: raj90341 folded on the Turn
Seat 5: Avaroni  (button) showed [Ts Kh] and won ($889.21) with Pair, TT



PokerStars Game #00327529758: Hold'em No Limit ($50/$100 USD) - 2022/04/30 09:49:24 ET
Table 'Hold'em (Min 25KMax 10K)    69' 6-max Seat #3 is the button
Seat 1: Lucifer999 ($10000 in chips) 
Seat 2: vinuth ($23366.92 in chips) 
Seat 3: bettercall7208 ($13187.08 in chips) 
Seat 4: TheWay ($2216.81 in chips) 
TheWay: posts small blind $50
Lucifer999: posts big blind $100
*** HOLE CARDS ***
Dealt to Lucifer999 [Qh Ks]
vinuth: folds
bettercall7208: folds
TheWay: calls $50
Lucifer999: raises $250.00 to $350
TheWay: calls $250
*** FLOP *** [3c Qs Js]
TheWay: bets $334.6
Lucifer999: calls $334.6
*** TURN *** [3c Qs Js] [6c]
TheWay: bets $1308.97
Lucifer999: raises $1308.97 to $2617.94
TheWay: folds
Uncalled bet ($1308.97) returned to Lucifer999
Lucifer999: doesn't show hand
Lucifer999 collected $3811.72 from pot
*** SUMMARY ***
Total pot $3987.14 | Rake $175.42
Board [3c Qs Js 6c]
Seat 1: Lucifer999 (big blind) collected ($3811.72)
Seat 2: vinuth folded before Flop (didn't bet)
Seat 3: bettercall7208 (button) folded before Flop (didn't bet)
Seat 4: TheWay (small blind) folded on the Turn



PokerStars Game #00327529862: Hold'em No Limit ($25/$50 USD) - 2022/04/30 09:50:01 ET
Table 'Hold'em (Min 1K Max 5K)   216' 6-max Seat #1 is the button
Seat 1: Lucifer999 ($16180.17 in chips) 
Seat 2: rahulh1 ($2995.16 in chips) 
Seat 4: raj90341 ($527.93 in chips) 
Seat 5: Avaroni ($5483.73 in chips) 
rahulh1: posts small blind $25
raj90341: posts big blind $50
*** HOLE CARDS ***
Dealt to Lucifer999 [Qh Js]
Avaroni: folds
Lucifer999: folds
rahulh1: calls $25
raj90341: raises $477.93 to $527.93
rahulh1: folds
Uncalled bet ($477.93) returned to raj90341
raj90341: doesn't show hand
raj90341 collected $100 from pot
*** SUMMARY ***
Total pot $100.00 | Rake $0
Board []
Seat 1: Lucifer999 (button) folded before Flop (didn't bet)
Seat 2: rahulh1 (small blind) folded before Flop
Seat 4: raj90341 (big blind) collected ($100)
Seat 5: Avaroni folded before Flop (didn't bet)



PokerStars Game #00327529782: Hold'em No Limit ($10/$25 USD) - 2022/04/30 09:49:30 ET
Table 'Hold'em (Min 500Max 2500) 1001' 6-max Seat #5 is the button
Seat 1: JaspritBumrah786 ($2025 in chips) 
Seat 2: fishfry123 ($882.28 in chips) 
Seat 3: allthebest ($2280.67 in chips) 
Seat 4: devi7 ($2705.62 in chips) 
Seat 5: Lucifer999 ($4756.14 in chips) 
Seat 6: spidy02 ($3548.41 in chips) 
spidy02: posts small blind $10
JaspritBumrah786: posts big blind $25
*** HOLE CARDS ***
Dealt to Lucifer999 [Ks 5d]
fishfry123: folds
allthebest: folds
devi7: raises $50.00 to $75
Lucifer999: folds
spidy02: raises $115.00 to $190
JaspritBumrah786: folds
devi7: calls $115
*** FLOP *** [5c 4h 4d]
spidy02: checks
devi7: bets $160
spidy02: calls $160
*** TURN *** [5c 4h 4d] [As]
spidy02: bets $340.97
devi7: folds
Uncalled bet ($340.97) returned to spidy02
spidy02: doesn't show hand
spidy02 collected $681.94 from pot
*** SUMMARY ***
Total pot $725.00 | Rake $43.06
Board [5c 4h 4d As]
Seat 1: JaspritBumrah786 (big blind) folded before Flop
Seat 2: fishfry123 folded before Flop (didn't bet)
Seat 3: allthebest folded before Flop (didn't bet)
Seat 4: devi7 folded on the Turn
Seat 5: Lucifer999 (button) folded before Flop (didn't bet)
Seat 6: spidy02 (small blind) collected ($681.94)



PokerStars Game #00327529834: Hold'em No Limit ($10/$25 USD) - 2022/04/30 09:49:50 ET
Table 'Hold'em (Min 500Max 2500)  1282' 6-max Seat #5 is the button
Seat 1: frostbyte28 ($2311.27 in chips) 
Seat 2: jayakumar2020 ($525 in chips) 
Seat 3: wahmodijiwah ($2500 in chips) 
Seat 5: Lucifer999 ($5557.86 in chips) 
Seat 6: devi7 ($2550 in chips) 
devi7: posts small blind $10
frostbyte28: posts big blind $25
*** HOLE CARDS ***
Dealt to Lucifer999 [Tc Th]
jayakumar2020: checks
Lucifer999: raises $65.00 to $90
devi7: calls $80
frostbyte28: folds
jayakumar2020: folds
*** FLOP *** [7h Ad 2c]
devi7: checks
Lucifer999: bets $85
devi7: calls $85
*** TURN *** [7h Ad 2c] [Jd]
devi7: checks
Lucifer999: checks
*** RIVER *** [7h Ad 2c Jd] [5h]
devi7: bets $187.5
Lucifer999: folds
Uncalled bet ($187.5) returned to devi7
devi7: doesn't show hand
devi7 collected $375 from pot
*** SUMMARY ***
Total pot $400.00 | Rake $25
Board [7h Ad 2c Jd 5h]
Seat 1: frostbyte28 (big blind) folded before Flop
Seat 2: jayakumar2020 folded before Flop (didn't bet)
Seat 5: Lucifer999 (button) folded on the River
Seat 6: devi7 (small blind) collected ($375)



PokerStars Game #00327529939: Hold'em No Limit ($50/$100 USD) - 2022/04/30 09:50:26 ET
Table 'Hold'em (Min 25KMax 10K)    69' 6-max Seat #4 is the button
Seat 1: Lucifer999 ($11818.15 in chips) 
Seat 2: vinuth ($23366.92 in chips) 
Seat 3: bettercall7208 ($13187.08 in chips) 
Seat 4: TheWay ($223.24 in chips) 
Seat 5: tabby20 ($10671.41 in chips) 
Lucifer999: posts small blind $50
bettercall7208: posts big blind $100
*** HOLE CARDS ***
Dealt to Lucifer999 [Kd Qh]
TheWay: raises $123.24 to $223.24
Lucifer999: raises $826.76 to $1050
bettercall7208: folds
Uncalled bet ($826.76) returned to Lucifer999
*** FLOP *** [4d 5d 5c]
*** FLOP *** [2s Qs Js]
*** TURN *** [4d 5d 5c] [2c]
*** TURN *** [4d 5d 5c] [6h]
*** RIVER *** [4d 5d 5c 2c] [3h]
*** RIVER *** [4d 5d 5c 2c] [4s]
*** SHOW DOWN ***
Lucifer999: shows [Kd Qh] (Pair, QQ)
TheWay: shows [9d Qc] (Pair, QQ)
Lucifer999 collected $261.23 from pot
Lucifer999 collected $261.23 from pot
*** SUMMARY ***
Total pot $546.48 | Rake $24.02
Board [4d 5d 5c 2c 3h]
Seat 1: Lucifer999  (small blind) showed [Kd Qh] and won ($261.23) with Pair, QQ
Seat 3: bettercall7208 (big blind) folded before Flop
Seat 4: TheWay (button) showed [9d Qc] and lost with Pair, QQ



PokerStars Game #00327529958: Hold'em No Limit ($25/$50 USD) - 2022/04/30 09:50:33 ET
Table 'Hold'em (Min 1K Max 5K)   216' 6-max Seat #2 is the button
Seat 1: Lucifer999 ($16180.17 in chips) 
Seat 2: rahulh1 ($2945.16 in chips) 
Seat 4: raj90341 ($577.93 in chips) 
Seat 5: Avaroni ($5483.73 in chips) 
raj90341: posts small blind $25
Avaroni: posts big blind $50
*** HOLE CARDS ***
Dealt to Lucifer999 [9s 3c]
Lucifer999: folds
rahulh1: calls $50
raj90341: calls $25
Avaroni: raises $175.00 to $225
rahulh1: calls $175
raj90341: raises $352.93 to $577.93
Avaroni: calls $352.93
rahulh1: calls $352.93
*** FLOP *** [6h Tc 4c]
Avaroni: checks
rahulh1: bets $475.67
Avaroni: folds
Uncalled bet ($475.67) returned to rahulh1
*** TURN *** [6h Tc 4c] [3h]
*** TURN *** [6h Tc 4c] [Ac]
*** RIVER *** [6h Tc 4c 3h] [Ks]
*** RIVER *** [6h Tc 4c 3h] [8h]
*** SHOW DOWN ***
rahulh1: shows [3d 3s] (Pair, 33)
raj90341: shows [Jd Qh] (High card, A)
rahulh1 collected $823.57 from pot
rahulh1 collected $823.57 from pot
*** SUMMARY ***
Total pot $1733.79 | Rake $86.65
Board [6h Tc 4c 3h Ks]
Seat 1: Lucifer999 folded before Flop (didn't bet)
Seat 2: rahulh1  (button) showed [3d 3s] and won ($823.57) with Pair, 33
Seat 4: raj90341 (small blind) showed [Jd Qh] and lost with High card, A
Seat 5: Avaroni (big blind) folded on the Flop



PokerStars Game #00327529980: Hold'em No Limit ($10/$25 USD) - 2022/04/30 09:50:41 ET
Table 'Hold'em (Min 500Max 2500)  1282' 6-max Seat #6 is the button
Seat 1: frostbyte28 ($2286.27 in chips) 
Seat 2: jayakumar2020 ($500 in chips) 
Seat 3: wahmodijiwah ($2500 in chips) 
Seat 5: Lucifer999 ($5382.86 in chips) 
Seat 6: devi7 ($2750 in chips) 
frostbyte28: posts small blind $10
jayakumar2020: posts big blind $25
*** HOLE CARDS ***
Dealt to Lucifer999 [8d 6c]
Lucifer999: folds
devi7: raises $50.00 to $75
frostbyte28: calls $65
jayakumar2020: folds
*** FLOP *** [5d 2h 2s]
frostbyte28: bets $82.41
devi7: raises $164.82 to $247.23
frostbyte28: calls $164.82
*** TURN *** [5d 2h 2s] [Kd]
frostbyte28: checks
devi7: bets $314.67
frostbyte28: folds
Uncalled bet ($314.67) returned to devi7
devi7: doesn't show hand
devi7 collected $629.34 from pot
*** SUMMARY ***
Total pot $669.46 | Rake $40.12
Board [5d 2h 2s Kd]
Seat 1: frostbyte28 (small blind) folded on the Turn
Seat 2: jayakumar2020 (big blind) folded before Flop
Seat 5: Lucifer999 folded before Flop (didn't bet)
Seat 6: devi7 (button) collected ($629.34)



PokerStars Game #00327530097: Hold'em No Limit ($25/$50 USD) - 2022/04/30 09:51:23 ET
Table 'Hold'em (Min 1K Max 5K)   216' 6-max Seat #5 is the button
Seat 1: Lucifer999 ($16180.17 in chips) 
Seat 2: rahulh1 ($4014.37 in chips) 
Seat 5: Avaroni ($5000 in chips) 
Lucifer999: posts small blind $25
rahulh1: posts big blind $50
*** HOLE CARDS ***
Dealt to Lucifer999 [Kd 2c]
Avaroni: folds
Lucifer999: raises $100.00 to $150
rahulh1: folds
Uncalled bet ($100) returned to Lucifer999
Lucifer999: doesn't show hand
Lucifer999 collected $100 from pot
*** SUMMARY ***
Total pot $100.00 | Rake $0
Board []
Seat 1: Lucifer999 (small blind) collected ($100)
Seat 2: rahulh1 (big blind) folded before Flop
Seat 5: Avaroni (button) folded before Flop (didn't bet)



PokerStars Game #00327530020: Hold'em No Limit ($50/$100 USD) - 2022/04/30 09:50:59 ET
Table 'Hold'em (Min 25KMax 10K)    69' 6-max Seat #1 is the button
Seat 1: Lucifer999 ($12117.37 in chips) 
Seat 2: vinuth ($23366.92 in chips) 
Seat 3: bettercall7208 ($13087.08 in chips) 
Seat 5: tabby20 ($10671.41 in chips) 
bettercall7208: posts small blind $50
tabby20: posts big blind $100
*** HOLE CARDS ***
Dealt to Lucifer999 [6s 7h]
Lucifer999: folds
bettercall7208: calls $50
tabby20: checks
*** FLOP *** [6d Ks 3h]
bettercall7208: checks
tabby20: bets $100
bettercall7208: calls $100
*** TURN *** [6d Ks 3h] [Th]
bettercall7208: checks
tabby20: bets $300
bettercall7208: folds
Uncalled bet ($300) returned to tabby20
tabby20: doesn't show hand
tabby20 collected $382.4 from pot
*** SUMMARY ***
Total pot $400.00 | Rake $17.6
Board [6d Ks 3h Th]
Seat 1: Lucifer999 (button) folded before Flop (didn't bet)
Seat 3: bettercall7208 (small blind) folded on the Turn
Seat 5: tabby20 (big blind) collected ($382.4)



PokerStars Game #00327530127: Hold'em No Limit ($10/$25 USD) - 2022/04/30 09:51:36 ET
Table 'Hold'em (Min 500Max 2500)  1282' 6-max Seat #1 is the button
Seat 1: frostbyte28 ($1964.04 in chips) 
Seat 2: jayakumar2020 ($475 in chips) 
Seat 3: wahmodijiwah ($2500 in chips) 
Seat 4: papadickkies ($500 in chips) 
Seat 5: Lucifer999 ($5382.86 in chips) 
Seat 6: devi7 ($3057.11 in chips) 
jayakumar2020: posts small blind $10
Lucifer999: posts big blind $25
*** HOLE CARDS ***
Dealt to Lucifer999 [2d As]
devi7: folds
frostbyte28: raises $38.75 to $63.75
jayakumar2020: folds
Lucifer999: folds
Uncalled bet ($38.75) returned to frostbyte28
frostbyte28: doesn't show hand
frostbyte28 collected $60 from pot
*** SUMMARY ***
Total pot $60.00 | Rake $0
Board []
Seat 1: frostbyte28 (button) collected ($60)
Seat 2: jayakumar2020 (small blind) folded before Flop
Seat 5: Lucifer999 (big blind) folded before Flop
Seat 6: devi7 folded before Flop (didn't bet)



PokerStars Game #00327530167: Hold'em No Limit ($25/$50 USD) - 2022/04/30 09:51:49 ET
Table 'Hold'em (Min 1K Max 5K)   216' 6-max Seat #1 is the button
Seat 1: Lucifer999 ($16230.17 in chips) 
Seat 2: rahulh1 ($3964.37 in chips) 
Seat 5: Avaroni ($5000 in chips) 
rahulh1: posts small blind $25
Avaroni: posts big blind $50
*** HOLE CARDS ***
Dealt to Lucifer999 [Jd 3d]
Lucifer999: raises $100.00 to $150
rahulh1: folds
Avaroni: folds
Uncalled bet ($100) returned to Lucifer999
Lucifer999: doesn't show hand
Lucifer999 collected $125 from pot
*** SUMMARY ***
Total pot $125.00 | Rake $0
Board []
Seat 1: Lucifer999 (button) collected ($125)
Seat 2: rahulh1 (small blind) folded before Flop
Seat 5: Avaroni (big blind) folded before Flop



PokerStars Game #00327529963: Hold'em No Limit ($10/$25 USD) - 2022/04/30 09:50:35 ET
Table 'Hold'em (Min 500Max 2500) 1001' 6-max Seat #6 is the button
Seat 1: JaspritBumrah786 ($2000 in chips) 
Seat 2: fishfry123 ($882.28 in chips) 
Seat 3: allthebest ($2280.67 in chips) 
Seat 4: devi7 ($2355.62 in chips) 
Seat 5: Lucifer999 ($4756.14 in chips) 
Seat 6: spidy02 ($3880.35 in chips) 
JaspritBumrah786: posts small blind $10
fishfry123: posts big blind $25
*** HOLE CARDS ***
Dealt to Lucifer999 [Ac 4h]
allthebest: raises $50.00 to $75
devi7: calls $75
Lucifer999: folds
spidy02: calls $75
JaspritBumrah786: folds
fishfry123: folds
*** FLOP *** [Qh Tc 4d]
allthebest: bets $175
devi7: folds
spidy02: calls $175
*** TURN *** [Qh Tc 4d] [8c]
allthebest: checks
spidy02: checks
*** RIVER *** [Qh Tc 4d 8c] [3h]
allthebest: checks
spidy02: checks
*** SHOW DOWN ***
allthebest: shows [Ah Js] (High card, A)
spidy02: shows [As Jh] (High card, A)
allthebest collected $286.49 from pot
spidy02 collected $286.49 from pot
*** SUMMARY ***
Total pot $610.00 | Rake $37.02
Board [Qh Tc 4d 8c 3h]
Seat 1: JaspritBumrah786 (small blind) folded before Flop
Seat 2: fishfry123 (big blind) folded before Flop
Seat 3: allthebest  showed [Ah Js] and won ($286.49) with High card, A
Seat 4: devi7 folded on the Flop
Seat 5: Lucifer999 folded before Flop (didn't bet)
Seat 6: spidy02  (button) showed [As Jh] and won ($286.49) with High card, A



PokerStars Game #00327530231: Hold'em No Limit ($25/$50 USD) - 2022/04/30 09:52:11 ET
Table 'Hold'em (Min 1K Max 5K)   216' 6-max Seat #2 is the button
Seat 1: Lucifer999 ($16305.17 in chips) 
Seat 2: rahulh1 ($3939.37 in chips) 
Seat 5: Avaroni ($5000 in chips) 
Avaroni: posts small blind $25
Lucifer999: posts big blind $50
*** HOLE CARDS ***
Dealt to Lucifer999 [Ad 2h]
rahulh1: folds
Avaroni: folds
Uncalled bet ($25) returned to Lucifer999
Lucifer999: doesn't show hand
Lucifer999 collected $50 from pot
*** SUMMARY ***
Total pot $50.00 | Rake $0
Board []
Seat 1: Lucifer999 (big blind) collected ($50)
Seat 2: rahulh1 (button) folded before Flop (didn't bet)
Seat 5: Avaroni (small blind) folded before Flop



PokerStars Game #00327530238: Hold'em No Limit ($10/$25 USD) - 2022/04/30 09:52:13 ET
Table 'Hold'em (Min 500Max 2500) 1001' 6-max Seat #1 is the button
Seat 1: JaspritBumrah786 ($2025 in chips) 
Seat 2: fishfry123 ($857.28 in chips) 
Seat 3: allthebest ($2317.16 in chips) 
Seat 4: devi7 ($2280.62 in chips) 
Seat 5: Lucifer999 ($4756.14 in chips) 
Seat 6: spidy02 ($3916.84 in chips) 
allthebest: posts small blind $10
devi7: posts big blind $25
*** HOLE CARDS ***
Dealt to Lucifer999 [Qc 9h]
Lucifer999: folds
spidy02: folds
JaspritBumrah786: folds
allthebest: folds
Uncalled bet ($15) returned to devi7
devi7: doesn't show hand
devi7 collected $20 from pot
*** SUMMARY ***
Total pot $20.00 | Rake $0
Board []
Seat 1: JaspritBumrah786 (button) folded before Flop (didn't bet)
Seat 3: allthebest (small blind) folded before Flop
Seat 4: devi7 (big blind) collected ($20)
Seat 5: Lucifer999 folded before Flop (didn't bet)
Seat 6: spidy02 folded before Flop (didn't bet)



PokerStars Game #00327530191: Hold'em No Limit ($50/$100 USD) - 2022/04/30 09:51:58 ET
Table 'Hold'em (Min 25KMax 10K)    69' 6-max Seat #3 is the button
Seat 1: Lucifer999 ($12117.37 in chips) 
Seat 2: vinuth ($23366.92 in chips) 
Seat 3: bettercall7208 ($12887.08 in chips) 
Seat 5: tabby20 ($10853.81 in chips) 
tabby20: posts small blind $50
Lucifer999: posts big blind $100
*** HOLE CARDS ***
Dealt to Lucifer999 [3d 5h]
bettercall7208: raises $200.00 to $300
tabby20: raises $800.00 to $1100
Lucifer999: folds
bettercall7208: calls $800
*** FLOP *** [9c 3h Kh]
tabby20: bets $1400
bettercall7208: calls $1400
*** TURN *** [9c 3h Kh] [6h]
tabby20: bets $3000
bettercall7208: calls $3000
*** RIVER *** [9c 3h Kh 6h] [Ac]
tabby20: bets $5353.81
bettercall7208: calls $5353.81
*** SHOW DOWN ***
bettercall7208: shows [6c Ad] (Two pairs, AA66)
tabby20: shows [Qh Jh] (Flush, K high)
tabby20 collected $21367.62 from pot
*** SUMMARY ***
Total pot $21807.62 | Rake $440
Board [9c 3h Kh 6h Ac]
Seat 1: Lucifer999 (big blind) folded before Flop
Seat 3: bettercall7208 (button) showed [6c Ad] and lost with Two pairs, AA66
Seat 5: tabby20  (small blind) showed [Qh Jh] and won ($21367.62) with Flush, K high



PokerStars Game #00327530193: Hold'em No Limit ($10/$25 USD) - 2022/04/30 09:51:59 ET
Table 'Hold'em (Min 500Max 2500)  1282' 6-max Seat #2 is the button
Seat 1: frostbyte28 ($1999.04 in chips) 
Seat 2: jayakumar2020 ($465 in chips) 
Seat 3: wahmodijiwah ($2500 in chips) 
Seat 4: papadickkies ($500 in chips) 
Seat 5: Lucifer999 ($5357.86 in chips) 
Seat 6: devi7 ($3057.11 in chips) 
Lucifer999: posts small blind $10
devi7: posts big blind $25
*** HOLE CARDS ***
Dealt to Lucifer999 [Th Ac]
frostbyte28: folds
jayakumar2020: folds
Lucifer999: raises $55.00 to $80
devi7: calls $55
*** FLOP *** [Kc 7h Tc]
Lucifer999: checks
devi7: bets $99.4
Lucifer999: calls $99.4
*** TURN *** [Kc 7h Tc] [2h]
Lucifer999: checks
devi7: checks
*** RIVER *** [Kc 7h Tc 2h] [Ad]
Lucifer999: bets $160
devi7: folds
Uncalled bet ($160) returned to Lucifer999
Lucifer999: doesn't show hand
Lucifer999 collected $337.01 from pot
*** SUMMARY ***
Total pot $358.80 | Rake $21.79
Board [Kc 7h Tc 2h Ad]
Seat 1: frostbyte28 folded before Flop (didn't bet)
Seat 2: jayakumar2020 (button) folded before Flop (didn't bet)
Seat 5: Lucifer999 (small blind) collected ($337.01)
Seat 6: devi7 (big blind) folded on the River



PokerStars Game #00327530310: Hold'em No Limit ($10/$25 USD) - 2022/04/30 09:52:39 ET
Table 'Hold'em (Min 500Max 2500) 1001' 6-max Seat #3 is the button
Seat 1: JaspritBumrah786 ($2025 in chips) 
Seat 2: fishfry123 ($857.28 in chips) 
Seat 3: allthebest ($2307.16 in chips) 
Seat 4: devi7 ($2290.62 in chips) 
Seat 5: Lucifer999 ($4756.14 in chips) 
Seat 6: spidy02 ($3916.84 in chips) 
devi7: posts small blind $10
Lucifer999: posts big blind $25
*** HOLE CARDS ***
Dealt to Lucifer999 [7h 4d]
spidy02: folds
JaspritBumrah786: raises $50.00 to $75
allthebest: folds
devi7: folds
Lucifer999: folds
Uncalled bet ($50) returned to JaspritBumrah786
JaspritBumrah786: doesn't show hand
JaspritBumrah786 collected $60 from pot
*** SUMMARY ***
Total pot $60.00 | Rake $0
Board []
Seat 1: JaspritBumrah786 collected ($60)
Seat 3: allthebest (button) folded before Flop (didn't bet)
Seat 4: devi7 (small blind) folded before Flop
Seat 5: Lucifer999 (big blind) folded before Flop
Seat 6: spidy02 folded before Flop (didn't bet)



PokerStars Game #00327530262: Hold'em No Limit ($25/$50 USD) - 2022/04/30 09:52:22 ET
Table 'Hold'em (Min 1K Max 5K)   216' 6-max Seat #5 is the button
Seat 1: Lucifer999 ($16330.17 in chips) 
Seat 2: rahulh1 ($3939.37 in chips) 
Seat 5: Avaroni ($5000 in chips) 
Lucifer999: posts small blind $25
rahulh1: posts big blind $50
*** HOLE CARDS ***
Dealt to Lucifer999 [8c Ts]
Avaroni: raises $100.00 to $150
Lucifer999: folds
rahulh1: raises $218.75 to $368.75
Avaroni: calls $218.75
*** FLOP *** [6d Qh 2c]
rahulh1: checks
Avaroni: bets $450
rahulh1: raises $3120.62 to $3570.62
Avaroni: folds
Uncalled bet ($3120.62) returned to rahulh1
rahulh1: doesn't show hand
rahulh1 collected $1579.4 from pot
*** SUMMARY ***
Total pot $1662.50 | Rake $83.1
Board [6d Qh 2c]
Seat 1: Lucifer999 (small blind) folded before Flop
Seat 2: rahulh1 (big blind) collected ($1579.4)
Seat 5: Avaroni (button) folded on the Flop



PokerStars Game #00327530348: Hold'em No Limit ($50/$100 USD) - 2022/04/30 09:52:54 ET
Table 'Hold'em (Min 25KMax 10K)    69' 6-max Seat #5 is the button
Seat 1: Lucifer999 ($12017.37 in chips) 
Seat 2: vinuth ($23366.92 in chips) 
Seat 3: bettercall7208 ($2033.27 in chips) 
Seat 5: tabby20 ($21367.62 in chips) 
Lucifer999: posts small blind $50
bettercall7208: posts big blind $100
*** HOLE CARDS ***
Dealt to Lucifer999 [7s Td]
tabby20: raises $200.00 to $300
Lucifer999: folds
bettercall7208: calls $200
*** FLOP *** [2h Qs Ac]
bettercall7208: checks
tabby20: bets $310.7
bettercall7208: folds
Uncalled bet ($310.7) returned to tabby20
tabby20: doesn't show hand
tabby20 collected $621.4 from pot
*** SUMMARY ***
Total pot $650.00 | Rake $28.6
Board [2h Qs Ac]
Seat 1: Lucifer999 (small blind) folded before Flop
Seat 3: bettercall7208 (big blind) folded on the Flop
Seat 5: tabby20 (button) collected ($621.4)



PokerStars Game #00327530384: Hold'em No Limit ($10/$25 USD) - 2022/04/30 09:53:05 ET
Table 'Hold'em (Min 500Max 2500) 1001' 6-max Seat #4 is the button
Seat 1: JaspritBumrah786 ($2135 in chips) 
Seat 2: fishfry123 ($857.28 in chips) 
Seat 3: allthebest ($2307.16 in chips) 
Seat 4: devi7 ($2280.62 in chips) 
Seat 5: Lucifer999 ($4731.14 in chips) 
Seat 6: spidy02 ($3916.84 in chips) 
Lucifer999: posts small blind $10
spidy02: posts big blind $25
fishfry123: posts small blind $10
*** HOLE CARDS ***
Dealt to Lucifer999 [3s 3h]
JaspritBumrah786: folds
fishfry123: calls $15
allthebest: folds
devi7: raises $85.00 to $110
Lucifer999: calls $100
spidy02: calls $85
fishfry123: folds
*** FLOP *** [9h 2d Ad]
Lucifer999: checks
spidy02: bets $166.69
devi7: folds
Lucifer999: folds
Uncalled bet ($166.69) returned to spidy02
spidy02: doesn't show hand
spidy02 collected $333.37 from pot
*** SUMMARY ***
Total pot $355.00 | Rake $21.63
Board [9h 2d Ad]
Seat 1: JaspritBumrah786 folded before Flop (didn't bet)
Seat 2: fishfry123 folded before Flop
Seat 3: allthebest folded before Flop (didn't bet)
Seat 4: devi7 (button) folded on the Flop
Seat 5: Lucifer999 (small blind) folded on the Flop
Seat 6: spidy02 (big blind) collected ($333.37)



PokerStars Game #00327530359: Hold'em No Limit ($10/$25 USD) - 2022/04/30 09:52:59 ET
Table 'Hold'em (Min 500Max 2500)  1282' 6-max Seat #5 is the button
Seat 1: frostbyte28 ($1999.04 in chips) 
Seat 2: jayakumar2020 ($465 in chips) 
Seat 3: wahmodijiwah ($2500 in chips) 
Seat 4: papadickkies ($500 in chips) 
Seat 5: Lucifer999 ($5515.47 in chips) 
Seat 6: devi7 ($2877.71 in chips) 
devi7: posts small blind $10
frostbyte28: posts big blind $25
*** HOLE CARDS ***
Dealt to Lucifer999 [Qc 7d]
jayakumar2020: folds
Lucifer999: raises $55.00 to $80
devi7: folds
frostbyte28: calls $55
*** FLOP *** [Kd Ad Td]
frostbyte28: checks
Lucifer999: bets $100
frostbyte28: calls $100
*** TURN *** [Kd Ad Td] [As]
frostbyte28: checks
Lucifer999: checks
*** RIVER *** [Kd Ad Td As] [7c]
frostbyte28: bets $260.69
Lucifer999: folds
Uncalled bet ($260.69) returned to frostbyte28
frostbyte28: doesn't show hand
frostbyte28 collected $347.58 from pot
*** SUMMARY ***
Total pot $370.00 | Rake $22.42
Board [Kd Ad Td As 7c]
Seat 1: frostbyte28 (big blind) collected ($347.58)
Seat 2: jayakumar2020 folded before Flop (didn't bet)
Seat 5: Lucifer999 (button) folded on the River
Seat 6: devi7 (small blind) folded before Flop



PokerStars Game #00327530416: Hold'em No Limit ($25/$50 USD) - 2022/04/30 09:53:15 ET
Table 'Hold'em (Min 1K Max 5K)   216' 6-max Seat #1 is the button
Seat 1: Lucifer999 ($16305.17 in chips) 
Seat 2: rahulh1 ($4700.02 in chips) 
Seat 5: Avaroni ($5000 in chips) 
rahulh1: posts small blind $25
Avaroni: posts big blind $50
*** HOLE CARDS ***
Dealt to Lucifer999 [Ac Qs]
Lucifer999: calls $50
rahulh1: calls $25
Avaroni: raises $175.00 to $225
Lucifer999: calls $175
rahulh1: folds
*** FLOP *** [8d 3s Qc]
Avaroni: bets $400
Lucifer999: calls $400
*** TURN *** [8d 3s Qc] [As]
Avaroni: checks
Lucifer999: bets $950
Avaroni: folds
Uncalled bet ($950) returned to Lucifer999
Lucifer999: doesn't show hand
Lucifer999 collected $1235 from pot
*** SUMMARY ***
Total pot $1300.00 | Rake $65
Board [8d 3s Qc As]
Seat 1: Lucifer999 (button) collected ($1235)
Seat 2: rahulh1 (small blind) folded before Flop
Seat 5: Avaroni (big blind) folded on the Turn



PokerStars Game #00327530451: Hold'em No Limit ($50/$100 USD) - 2022/04/30 09:53:27 ET
Table 'Hold'em (Min 25KMax 10K)    69' 6-max Seat #1 is the button
Seat 1: Lucifer999 ($11967.37 in chips) 
Seat 2: vinuth ($23366.92 in chips) 
Seat 3: bettercall7208 ($1733.27 in chips) 
Seat 5: tabby20 ($21689.02 in chips) 
bettercall7208: posts small blind $50
tabby20: posts big blind $100
*** HOLE CARDS ***
Dealt to Lucifer999 [4h 8c]
Lucifer999: folds
bettercall7208: calls $50
tabby20: raises $300.00 to $400
bettercall7208: calls $300
*** FLOP *** [9h 4s 4c]
bettercall7208: checks
tabby20: bets $300
bettercall7208: calls $300
*** TURN *** [9h 4s 4c] [Kc]
bettercall7208: checks
tabby20: checks
*** RIVER *** [9h 4s 4c Kc] [5d]
bettercall7208: bets $1033.27
tabby20: calls $1033.27
*** SHOW DOWN ***
bettercall7208: shows [Kh Ts] (Two pairs, KK44)
tabby20: shows [Jh Kd] (Two pairs, KK44)
tabby20 collected $3314.04 from pot
*** SUMMARY ***
Total pot $3466.54 | Rake $152.5
Board [9h 4s 4c Kc 5d]
Seat 1: Lucifer999 (button) folded before Flop (didn't bet)
Seat 3: bettercall7208 (small blind) showed [Kh Ts] and lost with Two pairs, KK44
Seat 5: tabby20  (big blind) showed [Jh Kd] and won ($3314.04) with Two pairs, KK44



PokerStars Game #00327530582: Hold'em No Limit ($10/$25 USD) - 2022/04/30 09:54:07 ET
Table 'Hold'em (Min 500Max 2500)  1282' 6-max Seat #6 is the button
Seat 1: frostbyte28 ($2166.62 in chips) 
Seat 2: jayakumar2020 ($465 in chips) 
Seat 3: wahmodijiwah ($2500 in chips) 
Seat 4: papadickkies ($500 in chips) 
Seat 5: Lucifer999 ($5335.47 in chips) 
Seat 6: devi7 ($2867.71 in chips) 
frostbyte28: posts small blind $10
jayakumar2020: posts big blind $25
*** HOLE CARDS ***
Dealt to Lucifer999 [Qd Td]
Lucifer999: folds
devi7: folds
frostbyte28: raises $33.75 to $58.75
jayakumar2020: folds
Uncalled bet ($33.75) returned to frostbyte28
frostbyte28: doesn't show hand
frostbyte28 collected $50 from pot
*** SUMMARY ***
Total pot $50.00 | Rake $0
Board []
Seat 1: frostbyte28 (small blind) collected ($50)
Seat 2: jayakumar2020 (big blind) folded before Flop
Seat 5: Lucifer999 folded before Flop (didn't bet)
Seat 6: devi7 (button) folded before Flop (didn't bet)



PokerStars Game #00327530535: Hold'em No Limit ($10/$25 USD) - 2022/04/30 09:53:53 ET
Table 'Hold'em (Min 500Max 2500) 1001' 6-max Seat #5 is the button
Seat 1: JaspritBumrah786 ($2135 in chips) 
Seat 2: fishfry123 ($832.28 in chips) 
Seat 3: allthebest ($2307.16 in chips) 
Seat 4: devi7 ($2170.62 in chips) 
Seat 5: Lucifer999 ($4621.14 in chips) 
Seat 6: spidy02 ($4140.21 in chips) 
spidy02: posts small blind $10
JaspritBumrah786: posts big blind $25
*** HOLE CARDS ***
Dealt to Lucifer999 [Kc 4d]
fishfry123: folds
allthebest: folds
devi7: folds
Lucifer999: raises $55.00 to $80
spidy02: calls $70
JaspritBumrah786: folds
*** FLOP *** [Qd 9s 4c]
spidy02: checks
Lucifer999: bets $130
spidy02: folds
Uncalled bet ($130) returned to Lucifer999
Lucifer999: doesn't show hand
Lucifer999 collected $174.29 from pot
*** SUMMARY ***
Total pot $185.00 | Rake $10.71
Board [Qd 9s 4c]
Seat 1: JaspritBumrah786 (big blind) folded before Flop
Seat 2: fishfry123 folded before Flop (didn't bet)
Seat 3: allthebest folded before Flop (didn't bet)
Seat 4: devi7 folded before Flop (didn't bet)
Seat 5: Lucifer999 (button) collected ($174.29)
Seat 6: spidy02 (small blind) folded on the Flop



PokerStars Game #00327530603: Hold'em No Limit ($50/$100 USD) - 2022/04/30 09:54:13 ET
Table 'Hold'em (Min 25KMax 10K)    69' 6-max Seat #5 is the button
Seat 1: Lucifer999 ($11967.37 in chips) 
Seat 2: vinuth ($23366.92 in chips) 
Seat 5: tabby20 ($23269.79 in chips) 
tabby20: posts small blind $50
Lucifer999: posts big blind $100
*** HOLE CARDS ***
Dealt to Lucifer999 [Th 9s]
tabby20: raises $100.00 to $200
Lucifer999: raises $500.00 to $700
tabby20: calls $500
*** FLOP *** [6d 2s 2d]
Lucifer999: bets $650
tabby20: folds
Uncalled bet ($650) returned to Lucifer999
Lucifer999: doesn't show hand
Lucifer999 collected $1345.4 from pot
*** SUMMARY ***
Total pot $1400.00 | Rake $54.6
Board [6d 2s 2d]
Seat 1: Lucifer999 (big blind) collected ($1345.4)
Seat 5: tabby20 (button) (small blind) folded on the Flop



PokerStars Game #00327530578: Hold'em No Limit ($25/$50 USD) - 2022/04/30 09:54:07 ET
Table 'Hold'em (Min 1K Max 5K)   216' 6-max Seat #2 is the button
Seat 1: Lucifer999 ($16915.17 in chips) 
Seat 2: rahulh1 ($4650.02 in chips) 
Seat 5: Avaroni ($5000 in chips) 
Avaroni: posts small blind $25
Lucifer999: posts big blind $50
*** HOLE CARDS ***
Dealt to Lucifer999 [Ts Ks]
rahulh1: calls $50
Avaroni: folds
Lucifer999: raises $150.00 to $200
rahulh1: calls $150
*** FLOP *** [Td 8s Kh]
Lucifer999: checks
rahulh1: checks
*** TURN *** [Td 8s Kh] [4s]
Lucifer999: bets $350
rahulh1: folds
Uncalled bet ($350) returned to Lucifer999
Lucifer999: doesn't show hand
Lucifer999 collected $403.75 from pot
*** SUMMARY ***
Total pot $425.00 | Rake $21.25
Board [Td 8s Kh 4s]
Seat 1: Lucifer999 (big blind) collected ($403.75)
Seat 2: rahulh1 (button) folded on the Turn
Seat 5: Avaroni (small blind) folded before Flop



PokerStars Game #00327530673: Hold'em No Limit ($10/$25 USD) - 2022/04/30 09:54:40 ET
Table 'Hold'em (Min 500Max 2500) 1001' 6-max Seat #6 is the button
Seat 1: JaspritBumrah786 ($2110 in chips) 
Seat 2: fishfry123 ($832.28 in chips) 
Seat 3: allthebest ($2307.16 in chips) 
Seat 4: devi7 ($2170.62 in chips) 
Seat 5: Lucifer999 ($4715.43 in chips) 
Seat 6: spidy02 ($4060.21 in chips) 
JaspritBumrah786: posts small blind $10
fishfry123: posts big blind $25
*** HOLE CARDS ***
Dealt to Lucifer999 [8h 5h]
allthebest: folds
devi7: folds
Lucifer999: folds
spidy02: raises $38.75 to $63.75
JaspritBumrah786: folds
fishfry123: calls $38.75
*** FLOP *** [3s 8c 7h]
fishfry123: checks
spidy02: bets $64.66
fishfry123: raises $96.98 to $161.64
spidy02: calls $96.98
*** TURN *** [3s 8c 7h] [2d]
fishfry123: bets $432.63
spidy02: folds
Uncalled bet ($432.63) returned to fishfry123
fishfry123: doesn't show hand
fishfry123 collected $432.63 from pot
*** SUMMARY ***
Total pot $460.78 | Rake $28.15
Board [3s 8c 7h 2d]
Seat 1: JaspritBumrah786 (small blind) folded before Flop
Seat 2: fishfry123 (big blind) collected ($432.63)
Seat 3: allthebest folded before Flop (didn't bet)
Seat 4: devi7 folded before Flop (didn't bet)
Seat 5: Lucifer999 folded before Flop (didn't bet)
Seat 6: spidy02 (button) folded on the Turn



PokerStars Game #00327530698: Hold'em No Limit ($50/$100 USD) - 2022/04/30 09:54:49 ET
Table 'Hold'em (Min 25KMax 10K)    69' 6-max Seat #1 is the button
Seat 1: Lucifer999 ($12612.77 in chips) 
Seat 2: vinuth ($23366.92 in chips) 
Seat 5: tabby20 ($22569.79 in chips) 
Lucifer999: posts small blind $50
tabby20: posts big blind $100
*** HOLE CARDS ***
Dealt to Lucifer999 [Jd 3d]
Lucifer999: raises $100.00 to $200
tabby20: calls $100
*** FLOP *** [As 2h 7s]
tabby20: checks
Lucifer999: bets $200
tabby20: calls $200
*** TURN *** [As 2h 7s] [Th]
tabby20: checks
Lucifer999: checks
*** RIVER *** [As 2h 7s Th] [8d]
tabby20: checks
Lucifer999: checks
*** SHOW DOWN ***
Lucifer999: shows [Jd 3d] (High card, A)
tabby20: shows [2d Kc] (Pair, 22)
tabby20 collected $768.8 from pot
*** SUMMARY ***
Total pot $800.00 | Rake $31.2
Board [As 2h 7s Th 8d]
Seat 1: Lucifer999 (button) (small blind) showed [Jd 3d] and lost with High card, A
Seat 5: tabby20  (big blind) showed [2d Kc] and won ($768.8) with Pair, 22



PokerStars Game #00327530667: Hold'em No Limit ($10/$25 USD) - 2022/04/30 09:54:38 ET
Table 'Hold'em (Min 500Max 2500)  1282' 6-max Seat #1 is the button
Seat 1: frostbyte28 ($2191.62 in chips) 
Seat 2: jayakumar2020 ($440 in chips) 
Seat 4: papadickkies ($500 in chips) 
Seat 5: Lucifer999 ($5335.47 in chips) 
Seat 6: devi7 ($2867.71 in chips) 
jayakumar2020: posts small blind $10
papadickkies: posts big blind $25
*** HOLE CARDS ***
Dealt to Lucifer999 [2s 7d]
Lucifer999: folds
devi7: folds
frostbyte28: raises $25.00 to $50
jayakumar2020: folds
papadickkies: calls $25
*** FLOP *** [4s Js 7c]
papadickkies: checks
frostbyte28: bets $77.42
papadickkies: calls $77.42
*** TURN *** [4s Js 7c] [6d]
papadickkies: checks
frostbyte28: bets $124.49
papadickkies: raises $248.09 to $372.58
frostbyte28: calls $248.09
*** RIVER *** [4s Js 7c 6d] [Jd]
*** SHOW DOWN ***
frostbyte28: shows [5h 5d] (Two pairs, JJ55)
papadickkies: shows [5s 3s] (Straight, 7-3)
papadickkies collected $951.98 from pot
*** SUMMARY ***
Total pot $1010.00 | Rake $58.02
Board [4s Js 7c 6d Jd]
Seat 1: frostbyte28 (button) showed [5h 5d] and lost with Two pairs, JJ55
Seat 2: jayakumar2020 (small blind) folded before Flop
Seat 4: papadickkies  (big blind) showed [5s 3s] and won ($951.98) with Straight, 7-3
Seat 5: Lucifer999 folded before Flop (didn't bet)
Seat 6: devi7 folded before Flop (didn't bet)



PokerStars Game #00327530722: Hold'em No Limit ($25/$50 USD) - 2022/04/30 09:54:55 ET
Table 'Hold'em (Min 1K Max 5K)   216' 6-max Seat #5 is the button
Seat 1: Lucifer999 ($17118.92 in chips) 
Seat 2: rahulh1 ($4450.02 in chips) 
Seat 5: Avaroni ($5000 in chips) 
Lucifer999: posts small blind $25
rahulh1: posts big blind $50
*** HOLE CARDS ***
Dealt to Lucifer999 [Kd Qs]
Avaroni: raises $100.00 to $150
Lucifer999: calls $125
rahulh1: folds
*** FLOP *** [Jc 3s Td]
Lucifer999: checks
Avaroni: checks
*** TURN *** [Jc 3s Td] [6h]
Lucifer999: bets $275
Avaroni: calls $275
*** RIVER *** [Jc 3s Td 6h] [4c]
Lucifer999: checks
Avaroni: bets $600
Lucifer999: raises $800.00 to $1400
Avaroni: calls $800
*** SHOW DOWN ***
Lucifer999: shows [Kd Qs] (High card, K)
Avaroni: shows [Jd 9c] (Pair, JJ)
Avaroni collected $3515 from pot
*** SUMMARY ***
Total pot $3700.00 | Rake $185
Board [Jc 3s Td 6h 4c]
Seat 1: Lucifer999 (small blind) showed [Kd Qs] and lost with High card, K
Seat 2: rahulh1 (big blind) folded before Flop
Seat 5: Avaroni  (button) showed [Jd 9c] and won ($3515) with Pair, JJ



PokerStars Game #00327530865: Hold'em No Limit ($10/$25 USD) - 2022/04/30 09:55:53 ET
Table 'Hold'em (Min 500Max 2500)  1282' 6-max Seat #2 is the button
Seat 1: frostbyte28 ($1691.62 in chips) 
Seat 2: jayakumar2020 ($430 in chips) 
Seat 3: PANCHYOU ($1037.74 in chips) 
Seat 4: papadickkies ($951.98 in chips) 
Seat 5: Lucifer999 ($5335.47 in chips) 
Seat 6: devi7 ($2867.71 in chips) 
papadickkies: posts small blind $10
Lucifer999: posts big blind $25
*** HOLE CARDS ***
Dealt to Lucifer999 [Ah 6c]
devi7: folds
frostbyte28: folds
jayakumar2020: folds
papadickkies: folds
Uncalled bet ($15) returned to Lucifer999
Lucifer999: doesn't show hand
Lucifer999 collected $20 from pot
*** SUMMARY ***
Total pot $20.00 | Rake $0
Board []
Seat 1: frostbyte28 folded before Flop (didn't bet)
Seat 2: jayakumar2020 (button) folded before Flop (didn't bet)
Seat 4: papadickkies (small blind) folded before Flop
Seat 5: Lucifer999 (big blind) collected ($20)
Seat 6: devi7 folded before Flop (didn't bet)



PokerStars Game #00327530800: Hold'em No Limit ($10/$25 USD) - 2022/04/30 09:55:28 ET
Table 'Hold'em (Min 500Max 2500) 1001' 6-max Seat #1 is the button
Seat 1: JaspritBumrah786 ($2100 in chips) 
Seat 2: fishfry123 ($1039.52 in chips) 
Seat 3: allthebest ($2307.16 in chips) 
Seat 4: devi7 ($2170.62 in chips) 
Seat 5: Lucifer999 ($4715.43 in chips) 
Seat 6: spidy02 ($3834.82 in chips) 
fishfry123: posts small blind $10
allthebest: posts big blind $25
*** HOLE CARDS ***
Dealt to Lucifer999 [Kd Ac]
devi7: folds
Lucifer999: raises $55.00 to $80
spidy02: folds
JaspritBumrah786: folds
fishfry123: raises $121.25 to $201.25
allthebest: folds
Lucifer999: raises $4514.18 to $4715.43
fishfry123: calls $838.27
Uncalled bet ($3675.91) returned to Lucifer999
*** FLOP *** [2c Jd 2s]
*** TURN *** [2c Jd 2s] [Ts]
*** RIVER *** [2c Jd 2s Ts] [3c]
*** SHOW DOWN ***
fishfry123: shows [Kc As] (Pair, 22)
Lucifer999: shows [Kd Ac] (Pair, 22)
fishfry123 collected $994.29 from pot
Lucifer999 collected $994.29 from pot
*** SUMMARY ***
Total pot $2104.04 | Rake $115.46
Board [2c Jd 2s Ts 3c]
Seat 1: JaspritBumrah786 (button) folded before Flop (didn't bet)
Seat 2: fishfry123  (small blind) showed [Kc As] and won ($994.29) with Pair, 22
Seat 3: allthebest (big blind) folded before Flop
Seat 4: devi7 folded before Flop (didn't bet)
Seat 5: Lucifer999  showed [Kd Ac] and won ($994.29) with Pair, 22
Seat 6: spidy02 folded before Flop (didn't bet)



PokerStars Game #00327530821: Hold'em No Limit ($50/$100 USD) - 2022/04/30 09:55:34 ET
Table 'Hold'em (Min 25KMax 10K)    69' 6-max Seat #5 is the button
Seat 1: Lucifer999 ($12212.77 in chips) 
Seat 2: vinuth ($23366.92 in chips) 
Seat 5: tabby20 ($22938.59 in chips) 
tabby20: posts small blind $50
Lucifer999: posts big blind $100
*** HOLE CARDS ***
Dealt to Lucifer999 [4c 3c]
tabby20: raises $100.00 to $200
Lucifer999: calls $100
*** FLOP *** [4h 2d 5h]
Lucifer999: checks
tabby20: checks
*** TURN *** [4h 2d 5h] [7c]
Lucifer999: bets $300
tabby20: calls $300
*** RIVER *** [4h 2d 5h 7c] [5d]
Lucifer999: checks
tabby20: bets $961
Lucifer999: folds
Uncalled bet ($961) returned to tabby20
tabby20: doesn't show hand
tabby20 collected $961 from pot
*** SUMMARY ***
Total pot $1000.00 | Rake $39
Board [4h 2d 5h 7c 5d]
Seat 1: Lucifer999 (big blind) folded on the River
Seat 5: tabby20 (button) (small blind) collected ($961)



PokerStars Game #00327530891: Hold'em No Limit ($10/$25 USD) - 2022/04/30 09:56:02 ET
Table 'Hold'em (Min 500Max 2500)  1282' 6-max Seat #4 is the button
Seat 1: frostbyte28 ($1691.62 in chips) 
Seat 2: jayakumar2020 ($430 in chips) 
Seat 3: PANCHYOU ($1037.74 in chips) 
Seat 4: papadickkies ($941.98 in chips) 
Seat 5: Lucifer999 ($5345.47 in chips) 
Seat 6: devi7 ($2867.71 in chips) 
Lucifer999: posts small blind $10
devi7: posts big blind $25
PANCHYOU: posts big blind $25
*** HOLE CARDS ***
Dealt to Lucifer999 [2h Ks]
frostbyte28: folds
jayakumar2020: folds
PANCHYOU: checks
papadickkies: folds
Lucifer999: raises $75.00 to $100
devi7: folds
PANCHYOU: folds
Uncalled bet ($75) returned to Lucifer999
Lucifer999: doesn't show hand
Lucifer999 collected $75 from pot
*** SUMMARY ***
Total pot $75.00 | Rake $0
Board []
Seat 1: frostbyte28 folded before Flop (didn't bet)
Seat 2: jayakumar2020 folded before Flop (didn't bet)
Seat 3: PANCHYOU folded before Flop
Seat 4: papadickkies (button) folded before Flop (didn't bet)
Seat 5: Lucifer999 (small blind) collected ($75)
Seat 6: devi7 (big blind) folded before Flop



PokerStars Game #00327530920: Hold'em No Limit ($10/$25 USD) - 2022/04/30 09:56:15 ET
Table 'Hold'em (Min 500Max 2500) 1001' 6-max Seat #2 is the button
Seat 1: JaspritBumrah786 ($2100 in chips) 
Seat 2: fishfry123 ($994.29 in chips) 
Seat 3: allthebest ($2282.16 in chips) 
Seat 4: devi7 ($2170.62 in chips) 
Seat 5: Lucifer999 ($4670.2 in chips) 
Seat 6: spidy02 ($3834.82 in chips) 
allthebest: posts small blind $10
devi7: posts big blind $25
*** HOLE CARDS ***
Dealt to Lucifer999 [Jh 7s]
Lucifer999: folds
spidy02: folds
JaspritBumrah786: folds
fishfry123: folds
allthebest: folds
Uncalled bet ($15) returned to devi7
devi7: doesn't show hand
devi7 collected $20 from pot
*** SUMMARY ***
Total pot $20.00 | Rake $0
Board []
Seat 1: JaspritBumrah786 folded before Flop (didn't bet)
Seat 2: fishfry123 (button) folded before Flop (didn't bet)
Seat 3: allthebest (small blind) folded before Flop
Seat 4: devi7 (big blind) collected ($20)
Seat 5: Lucifer999 folded before Flop (didn't bet)
Seat 6: spidy02 folded before Flop (didn't bet)



PokerStars Game #00327530875: Hold'em No Limit ($25/$50 USD) - 2022/04/30 09:55:58 ET
Table 'Hold'em (Min 1K Max 5K)   216' 6-max Seat #1 is the button
Seat 1: Lucifer999 ($15293.92 in chips) 
Seat 2: rahulh1 ($4400.02 in chips) 
Seat 5: Avaroni ($6690 in chips) 
rahulh1: posts small blind $25
Avaroni: posts big blind $50
*** HOLE CARDS ***
Dealt to Lucifer999 [Js Qc]
Lucifer999: raises $100.00 to $150
rahulh1: calls $125
Avaroni: folds
*** FLOP *** [4c 5h 7c]
rahulh1: checks
Lucifer999: checks
*** TURN *** [4c 5h 7c] [Jh]
rahulh1: bets $50
Lucifer999: calls $50
*** RIVER *** [4c 5h 7c Jh] [Qh]
rahulh1: checks
Lucifer999: bets $300
rahulh1: folds
Uncalled bet ($300) returned to Lucifer999
Lucifer999: doesn't show hand
Lucifer999 collected $427.5 from pot
*** SUMMARY ***
Total pot $450.00 | Rake $22.5
Board [4c 5h 7c Jh Qh]
Seat 1: Lucifer999 (button) collected ($427.5)
Seat 2: rahulh1 (small blind) folded on the River
Seat 5: Avaroni (big blind) folded before Flop



PokerStars Game #00327531014: Hold'em No Limit ($25/$50 USD) - 2022/04/30 09:56:51 ET
Table 'Hold'em (Min 1K Max 5K)   216' 6-max Seat #2 is the button
Seat 1: Lucifer999 ($15521.42 in chips) 
Seat 2: rahulh1 ($4200.02 in chips) 
Seat 5: Avaroni ($6640 in chips) 
Avaroni: posts small blind $25
Lucifer999: posts big blind $50
*** HOLE CARDS ***
Dealt to Lucifer999 [7s 6c]
rahulh1: folds
Avaroni: folds
Uncalled bet ($25) returned to Lucifer999
Lucifer999: doesn't show hand
Lucifer999 collected $50 from pot
*** SUMMARY ***
Total pot $50.00 | Rake $0
Board []
Seat 1: Lucifer999 (big blind) collected ($50)
Seat 2: rahulh1 (button) folded before Flop (didn't bet)
Seat 5: Avaroni (small blind) folded before Flop



PokerStars Game #00327530938: Hold'em No Limit ($50/$100 USD) - 2022/04/30 09:56:23 ET
Table 'Hold'em (Min 25KMax 10K)    69' 6-max Seat #1 is the button
Seat 1: Lucifer999 ($11712.77 in chips) 
Seat 2: vinuth ($23366.92 in chips) 
Seat 5: tabby20 ($23399.59 in chips) 
Lucifer999: posts small blind $50
tabby20: posts big blind $100
*** HOLE CARDS ***
Dealt to Lucifer999 [7c 5s]
Lucifer999: raises $100.00 to $200
tabby20: calls $100
*** FLOP *** [Qs 8d Td]
tabby20: checks
Lucifer999: checks
*** TURN *** [Qs 8d Td] [6h]
tabby20: bets $300
Lucifer999: folds
Uncalled bet ($300) returned to tabby20
tabby20: doesn't show hand
tabby20 collected $384.4 from pot
*** SUMMARY ***
Total pot $400.00 | Rake $15.6
Board [Qs 8d Td 6h]
Seat 1: Lucifer999 (button) (small blind) folded on the Turn
Seat 5: tabby20 (big blind) collected ($384.4)



PokerStars Game #00327530983: Hold'em No Limit ($10/$25 USD) - 2022/04/30 09:56:42 ET
Table 'Hold'em (Min 500Max 2500) 1001' 6-max Seat #3 is the button
Seat 1: JaspritBumrah786 ($2100 in chips) 
Seat 2: fishfry123 ($994.29 in chips) 
Seat 3: allthebest ($2272.16 in chips) 
Seat 4: devi7 ($2180.62 in chips) 
Seat 5: Lucifer999 ($4670.2 in chips) 
Seat 6: spidy02 ($3834.82 in chips) 
devi7: posts small blind $10
Lucifer999: posts big blind $25
*** HOLE CARDS ***
Dealt to Lucifer999 [2h Js]
spidy02: folds
JaspritBumrah786: folds
fishfry123: folds
allthebest: raises $50.00 to $75
devi7: folds
Lucifer999: folds
Uncalled bet ($50) returned to allthebest
allthebest: doesn't show hand
allthebest collected $60 from pot
*** SUMMARY ***
Total pot $60.00 | Rake $0
Board []
Seat 1: JaspritBumrah786 folded before Flop (didn't bet)
Seat 2: fishfry123 folded before Flop (didn't bet)
Seat 3: allthebest (button) collected ($60)
Seat 4: devi7 (small blind) folded before Flop
Seat 5: Lucifer999 (big blind) folded before Flop
Seat 6: spidy02 folded before Flop (didn't bet)



PokerStars Game #00327531042: Hold'em No Limit ($50/$100 USD) - 2022/04/30 09:57:02 ET
Table 'Hold'em (Min 25KMax 10K)    69' 6-max Seat #5 is the button
Seat 1: Lucifer999 ($11512.77 in chips) 
Seat 2: vinuth ($23366.92 in chips) 
Seat 5: tabby20 ($23583.99 in chips) 
Lucifer999: posts small blind $50
vinuth: posts big blind $100
*** HOLE CARDS ***
Dealt to Lucifer999 [Qh Kc]
tabby20: raises $200.00 to $300
Lucifer999: calls $250
vinuth: folds
*** FLOP *** [Ac Qd 7s]
Lucifer999: checks
tabby20: checks
*** TURN *** [Ac Qd 7s] [Ad]
Lucifer999: bets $550
tabby20: folds
Uncalled bet ($550) returned to Lucifer999
Lucifer999: doesn't show hand
Lucifer999 collected $669.2 from pot
*** SUMMARY ***
Total pot $700.00 | Rake $30.8
Board [Ac Qd 7s Ad]
Seat 1: Lucifer999 (small blind) collected ($669.2)
Seat 2: vinuth (big blind) folded before Flop
Seat 5: tabby20 (button) folded on the Turn



PokerStars Game #00327531038: Hold'em No Limit ($25/$50 USD) - 2022/04/30 09:57:01 ET
Table 'Hold'em (Min 1K Max 5K)   216' 6-max Seat #5 is the button
Seat 1: Lucifer999 ($15546.42 in chips) 
Seat 2: rahulh1 ($4200.02 in chips) 
Seat 5: Avaroni ($6615 in chips) 
Lucifer999: posts small blind $25
rahulh1: posts big blind $50
*** HOLE CARDS ***
Dealt to Lucifer999 [7c 9c]
Avaroni: raises $100.00 to $150
Lucifer999: calls $125
rahulh1: calls $100
*** FLOP *** [7s 9d Jd]
Lucifer999: checks
rahulh1: checks
Avaroni: checks
*** TURN *** [7s 9d Jd] [8c]
Lucifer999: checks
rahulh1: checks
Avaroni: checks
*** RIVER *** [7s 9d Jd 8c] [8h]
Lucifer999: checks
rahulh1: checks
Avaroni: bets $213.75
Lucifer999: folds
rahulh1: folds
Uncalled bet ($213.75) returned to Avaroni
Avaroni: doesn't show hand
Avaroni collected $427.5 from pot
*** SUMMARY ***
Total pot $450.00 | Rake $22.5
Board [7s 9d Jd 8c 8h]
Seat 1: Lucifer999 (small blind) folded on the River
Seat 2: rahulh1 (big blind) folded on the River
Seat 5: Avaroni (button) collected ($427.5)



PokerStars Game #00327530947: Hold'em No Limit ($10/$25 USD) - 2022/04/30 09:56:25 ET
Table 'Hold'em (Min 500Max 2500)  1282' 6-max Seat #5 is the button
Seat 1: frostbyte28 ($1691.62 in chips) 
Seat 2: jayakumar2020 ($430 in chips) 
Seat 3: PANCHYOU ($1012.74 in chips) 
Seat 4: papadickkies ($941.98 in chips) 
Seat 5: Lucifer999 ($5395.47 in chips) 
Seat 6: devi7 ($2842.71 in chips) 
devi7: posts small blind $10
frostbyte28: posts big blind $25
*** HOLE CARDS ***
Dealt to Lucifer999 [Kc 4d]
jayakumar2020: folds
PANCHYOU: folds
papadickkies: raises $25.00 to $50
Lucifer999: folds
devi7: folds
frostbyte28: calls $25
*** FLOP *** [2c 8d Tc]
frostbyte28: checks
papadickkies: checks
*** TURN *** [2c 8d Tc] [9c]
frostbyte28: checks
papadickkies: bets $51.62
frostbyte28: calls $51.62
*** RIVER *** [2c 8d Tc 9c] [Ac]
frostbyte28: checks
papadickkies: bets $100.03
frostbyte28: folds
Uncalled bet ($100.03) returned to papadickkies
papadickkies: doesn't show hand
papadickkies collected $200.06 from pot
*** SUMMARY ***
Total pot $213.24 | Rake $13.18
Board [2c 8d Tc 9c Ac]
Seat 1: frostbyte28 (big blind) folded on the River
Seat 2: jayakumar2020 folded before Flop (didn't bet)
Seat 3: PANCHYOU folded before Flop (didn't bet)
Seat 4: papadickkies collected ($200.06)
Seat 5: Lucifer999 (button) folded before Flop (didn't bet)
Seat 6: devi7 (small blind) folded before Flop



PokerStars Game #00327531058: Hold'em No Limit ($10/$25 USD) - 2022/04/30 09:57:09 ET
Table 'Hold'em (Min 500Max 2500) 1001' 6-max Seat #4 is the button
Seat 1: JaspritBumrah786 ($2100 in chips) 
Seat 2: fishfry123 ($994.29 in chips) 
Seat 3: allthebest ($2307.16 in chips) 
Seat 4: devi7 ($2170.62 in chips) 
Seat 5: Lucifer999 ($4645.2 in chips) 
Seat 6: spidy02 ($3834.82 in chips) 
Lucifer999: posts small blind $10
spidy02: posts big blind $25
*** HOLE CARDS ***
Dealt to Lucifer999 [Kd Qh]
JaspritBumrah786: folds
fishfry123: folds
allthebest: folds
devi7: raises $50.00 to $75
Lucifer999: calls $65
spidy02: folds
*** FLOP *** [6c Qs 2h]
Lucifer999: checks
devi7: checks
*** TURN *** [6c Qs 2h] [3h]
Lucifer999: bets $140
devi7: calls $140
*** RIVER *** [6c Qs 2h 3h] [5d]
Lucifer999: checks
devi7: bets $281.9
Lucifer999: calls $281.9
*** SHOW DOWN ***
devi7: shows [Jc Qd] (Pair, QQ)
Lucifer999: shows [Kd Qh] (Pair, QQ)
Lucifer999 collected $960.36 from pot
*** SUMMARY ***
Total pot $1018.80 | Rake $58.44
Board [6c Qs 2h 3h 5d]
Seat 1: JaspritBumrah786 folded before Flop (didn't bet)
Seat 2: fishfry123 folded before Flop (didn't bet)
Seat 3: allthebest folded before Flop (didn't bet)
Seat 4: devi7 (button) showed [Jc Qd] and lost with Pair, QQ
Seat 5: Lucifer999  (small blind) showed [Kd Qh] and won ($960.36) with Pair, QQ
Seat 6: spidy02 (big blind) folded before Flop



PokerStars Game #00327531175: Hold'em No Limit ($25/$50 USD) - 2022/04/30 09:57:57 ET
Table 'Hold'em (Min 1K Max 5K)   216' 6-max Seat #1 is the button
Seat 1: Lucifer999 ($15396.42 in chips) 
Seat 2: rahulh1 ($4050.02 in chips) 
Seat 3: bettercall7208 ($5000 in chips) 
Seat 5: Avaroni ($6892.5 in chips) 
rahulh1: posts small blind $25
bettercall7208: posts big blind $50
*** HOLE CARDS ***
Dealt to Lucifer999 [8h Ad]
Avaroni: folds
Lucifer999: raises $100.00 to $150
rahulh1: folds
bettercall7208: raises $325.00 to $475
Lucifer999: folds
Uncalled bet ($325) returned to bettercall7208
bettercall7208: doesn't show hand
bettercall7208 collected $325 from pot
*** SUMMARY ***
Total pot $325.00 | Rake $0
Board []
Seat 1: Lucifer999 (button) folded before Flop
Seat 2: rahulh1 (small blind) folded before Flop
Seat 3: bettercall7208 (big blind) collected ($325)
Seat 5: Avaroni folded before Flop (didn't bet)



PokerStars Game #00327531194: Hold'em No Limit ($10/$25 USD) - 2022/04/30 09:58:03 ET
Table 'Hold'em (Min 500Max 2500)  1282' 6-max Seat #6 is the button
Seat 1: frostbyte28 ($1590 in chips) 
Seat 2: jayakumar2020 ($430 in chips) 
Seat 3: PANCHYOU ($1012.74 in chips) 
Seat 4: papadickkies ($1040.42 in chips) 
Seat 5: Lucifer999 ($5395.47 in chips) 
Seat 6: devi7 ($2832.71 in chips) 
frostbyte28: posts small blind $10
jayakumar2020: posts big blind $25
*** HOLE CARDS ***
Dealt to Lucifer999 [2c Kh]
PANCHYOU: folds
papadickkies: folds
Lucifer999: folds
devi7: folds
frostbyte28: folds
Uncalled bet ($15) returned to jayakumar2020
jayakumar2020: doesn't show hand
jayakumar2020 collected $20 from pot
*** SUMMARY ***
Total pot $20.00 | Rake $0
Board []
Seat 1: frostbyte28 (small blind) folded before Flop
Seat 2: jayakumar2020 (big blind) collected ($20)
Seat 3: PANCHYOU folded before Flop (didn't bet)
Seat 4: papadickkies folded before Flop (didn't bet)
Seat 5: Lucifer999 folded before Flop (didn't bet)
Seat 6: devi7 (button) folded before Flop (didn't bet)



PokerStars Game #00327531162: Hold'em No Limit ($50/$100 USD) - 2022/04/30 09:57:48 ET
Table 'Hold'em (Min 25KMax 10K)    69' 6-max Seat #1 is the button
Seat 1: Lucifer999 ($11881.97 in chips) 
Seat 2: vinuth ($23266.92 in chips) 
Seat 5: tabby20 ($23283.99 in chips) 
Lucifer999: posts small blind $50
vinuth: posts big blind $100
*** HOLE CARDS ***
Dealt to Lucifer999 [2d Ah]
Lucifer999: calls $50
vinuth: raises $250.00 to $350
Lucifer999: calls $250
*** FLOP *** [Tc 4s 3d]
vinuth: bets $336.35
Lucifer999: calls $336.35
*** TURN *** [Tc 4s 3d] [7d]
vinuth: bets $989.4
Lucifer999: folds
Uncalled bet ($989.4) returned to vinuth
vinuth: doesn't show hand
vinuth collected $1319.2 from pot
*** SUMMARY ***
Total pot $1372.70 | Rake $53.5
Board [Tc 4s 3d 7d]
Seat 1: Lucifer999 (button) (small blind) folded on the Turn
Seat 2: vinuth (big blind) collected ($1319.2)



PokerStars Game #00327531272: Hold'em No Limit ($50/$100 USD) - 2022/04/30 09:58:35 ET
Table 'Hold'em (Min 25KMax 10K)    69' 6-max Seat #2 is the button
Seat 1: Lucifer999 ($11195.62 in chips) 
Seat 2: vinuth ($23899.77 in chips) 
Seat 5: tabby20 ($23283.99 in chips) 
tabby20: posts small blind $50
Lucifer999: posts big blind $100
*** HOLE CARDS ***
Dealt to Lucifer999 [3c Qs]
vinuth: folds
tabby20: folds
Uncalled bet ($50) returned to Lucifer999
Lucifer999: doesn't show hand
Lucifer999 collected $100 from pot
*** SUMMARY ***
Total pot $100.00 | Rake $0
Board []
Seat 1: Lucifer999 (big blind) collected ($100)
Seat 2: vinuth (button) folded before Flop (didn't bet)
Seat 5: tabby20 (small blind) folded before Flop



PokerStars Game #00327531211: Hold'em No Limit ($10/$25 USD) - 2022/04/30 09:58:11 ET
Table 'Hold'em (Min 500Max 2500) 1001' 6-max Seat #5 is the button
Seat 1: JaspritBumrah786 ($2100 in chips) 
Seat 2: fishfry123 ($994.29 in chips) 
Seat 3: allthebest ($2307.16 in chips) 
Seat 4: devi7 ($2500 in chips) 
Seat 5: Lucifer999 ($5108.66 in chips) 
Seat 6: spidy02 ($3809.82 in chips) 
spidy02: posts small blind $10
JaspritBumrah786: posts big blind $25
*** HOLE CARDS ***
Dealt to Lucifer999 [9h Qh]
fishfry123: raises $38.75 to $63.75
allthebest: folds
devi7: calls $63.75
Lucifer999: folds
spidy02: folds
JaspritBumrah786: folds
*** FLOP *** [3d 6d Ks]
fishfry123: checks
devi7: checks
*** TURN *** [3d 6d Ks] [7d]
fishfry123: bets $76.5
devi7: folds
Uncalled bet ($76.5) returned to fishfry123
fishfry123: doesn't show hand
fishfry123 collected $153 from pot
*** SUMMARY ***
Total pot $162.50 | Rake $9.5
Board [3d 6d Ks 7d]
Seat 1: JaspritBumrah786 (big blind) folded before Flop
Seat 2: fishfry123 collected ($153)
Seat 3: allthebest folded before Flop (didn't bet)
Seat 4: devi7 folded on the Turn
Seat 5: Lucifer999 (button) folded before Flop (didn't bet)
Seat 6: spidy02 (small blind) folded before Flop



PokerStars Game #00327531257: Hold'em No Limit ($25/$50 USD) - 2022/04/30 09:58:28 ET
Table 'Hold'em (Min 1K Max 5K)   216' 6-max Seat #2 is the button
Seat 1: Lucifer999 ($15246.42 in chips) 
Seat 2: rahulh1 ($4025.02 in chips) 
Seat 3: bettercall7208 ($5175 in chips) 
Seat 5: Avaroni ($6892.5 in chips) 
bettercall7208: posts small blind $25
Avaroni: posts big blind $50
*** HOLE CARDS ***
Dealt to Lucifer999 [6c 6d]
Lucifer999: folds
rahulh1: raises $81.25 to $131.25
bettercall7208: folds
Avaroni: folds
Uncalled bet ($81.25) returned to rahulh1
rahulh1: doesn't show hand
rahulh1 collected $125 from pot
*** SUMMARY ***
Total pot $125.00 | Rake $0
Board []
Seat 1: Lucifer999 folded before Flop (didn't bet)
Seat 2: rahulh1 (button) collected ($125)
Seat 3: bettercall7208 (small blind) folded before Flop
Seat 5: Avaroni (big blind) folded before Flop



PokerStars Game #00327531263: Hold'em No Limit ($10/$25 USD) - 2022/04/30 09:58:32 ET
Table 'Hold'em (Min 500Max 2500)  1282' 6-max Seat #1 is the button
Seat 1: frostbyte28 ($1580 in chips) 
Seat 2: jayakumar2020 ($440 in chips) 
Seat 3: PANCHYOU ($1012.74 in chips) 
Seat 4: papadickkies ($1040.42 in chips) 
Seat 5: Lucifer999 ($5395.47 in chips) 
Seat 6: devi7 ($2832.71 in chips) 
jayakumar2020: posts small blind $10
PANCHYOU: posts big blind $25
*** HOLE CARDS ***
Dealt to Lucifer999 [Th 5h]
papadickkies: folds
Lucifer999: folds
devi7: folds
frostbyte28: folds
jayakumar2020: folds
Uncalled bet ($15) returned to PANCHYOU
PANCHYOU: doesn't show hand
PANCHYOU collected $20 from pot
*** SUMMARY ***
Total pot $20.00 | Rake $0
Board []
Seat 1: frostbyte28 (button) folded before Flop (didn't bet)
Seat 2: jayakumar2020 (small blind) folded before Flop
Seat 3: PANCHYOU (big blind) collected ($20)
Seat 4: papadickkies folded before Flop (didn't bet)
Seat 5: Lucifer999 folded before Flop (didn't bet)
Seat 6: devi7 folded before Flop (didn't bet)



PokerStars Game #00327531327: Hold'em No Limit ($10/$25 USD) - 2022/04/30 09:58:54 ET
Table 'Hold'em (Min 500Max 2500) 1001' 6-max Seat #6 is the button
Seat 1: JaspritBumrah786 ($2075 in chips) 
Seat 2: fishfry123 ($1083.54 in chips) 
Seat 3: allthebest ($2307.16 in chips) 
Seat 4: devi7 ($2436.25 in chips) 
Seat 5: Lucifer999 ($5108.66 in chips) 
Seat 6: spidy02 ($3799.82 in chips) 
JaspritBumrah786: posts small blind $10
fishfry123: posts big blind $25
*** HOLE CARDS ***
Dealt to Lucifer999 [6c Tc]
allthebest: folds
devi7: folds
Lucifer999: folds
spidy02: raises $60.00 to $85
JaspritBumrah786: folds
fishfry123: folds
Uncalled bet ($60) returned to spidy02
spidy02: doesn't show hand
spidy02 collected $60 from pot
*** SUMMARY ***
Total pot $60.00 | Rake $0
Board []
Seat 1: JaspritBumrah786 (small blind) folded before Flop
Seat 2: fishfry123 (big blind) folded before Flop
Seat 3: allthebest folded before Flop (didn't bet)
Seat 4: devi7 folded before Flop (didn't bet)
Seat 5: Lucifer999 folded before Flop (didn't bet)
Seat 6: spidy02 (button) collected ($60)



PokerStars Game #00327531307: Hold'em No Limit ($50/$100 USD) - 2022/04/30 09:58:46 ET
Table 'Hold'em (Min 25KMax 10K)    69' 6-max Seat #5 is the button
Seat 1: Lucifer999 ($11245.62 in chips) 
Seat 2: vinuth ($23899.77 in chips) 
Seat 5: tabby20 ($23233.99 in chips) 
Lucifer999: posts small blind $50
vinuth: posts big blind $100
*** HOLE CARDS ***
Dealt to Lucifer999 [3d 3s]
tabby20: folds
Lucifer999: raises $200.00 to $300
vinuth: calls $200
*** FLOP *** [9s 3c 2h]
Lucifer999: checks
vinuth: checks
*** TURN *** [9s 3c 2h] [Kc]
Lucifer999: bets $500
vinuth: calls $500
*** RIVER *** [9s 3c 2h Kc] [Tc]
Lucifer999: checks
vinuth: bets $1529.6
Lucifer999: calls $1529.6
*** SHOW DOWN ***
vinuth: shows [Ad Kd] (Pair, KK)
Lucifer999: shows [3d 3s] (Three of a kind, 333)
Lucifer999 collected $4454.21 from pot
*** SUMMARY ***
Total pot $4659.20 | Rake $204.99
Board [9s 3c 2h Kc Tc]
Seat 1: Lucifer999  (small blind) showed [3d 3s] and won ($4454.21) with Three of a kind, 333
Seat 2: vinuth (big blind) showed [Ad Kd] and lost with Pair, KK
Seat 5: tabby20 (button) folded before Flop (didn't bet)



PokerStars Game #00327531336: Hold'em No Limit ($25/$50 USD) - 2022/04/30 09:58:55 ET
Table 'Hold'em (Min 1K Max 5K)   216' 6-max Seat #3 is the button
Seat 1: Lucifer999 ($15246.42 in chips) 
Seat 2: rahulh1 ($4100.02 in chips) 
Seat 3: bettercall7208 ($5150 in chips) 
Seat 5: Avaroni ($6842.5 in chips) 
Avaroni: posts small blind $25
Lucifer999: posts big blind $50
*** HOLE CARDS ***
Dealt to Lucifer999 [9s 5s]
rahulh1: folds
bettercall7208: raises $100.00 to $150
Avaroni: folds
Lucifer999: calls $100
*** FLOP *** [4c 3c Kh]
Lucifer999: checks
bettercall7208: bets $100
Lucifer999: raises $250.00 to $350
bettercall7208: calls $250
*** TURN *** [4c 3c Kh] [Ah]
Lucifer999: checks
bettercall7208: bets $486.88
Lucifer999: folds
Uncalled bet ($486.88) returned to bettercall7208
bettercall7208: doesn't show hand
bettercall7208 collected $973.75 from pot
*** SUMMARY ***
Total pot $1025.00 | Rake $51.25
Board [4c 3c Kh Ah]
Seat 1: Lucifer999 (big blind) folded on the Turn
Seat 2: rahulh1 folded before Flop (didn't bet)
Seat 3: bettercall7208 (button) collected ($973.75)
Seat 5: Avaroni (small blind) folded before Flop



PokerStars Game #00327531365: Hold'em No Limit ($10/$25 USD) - 2022/04/30 09:59:08 ET
Table 'Hold'em (Min 500Max 2500)  1282' 6-max Seat #2 is the button
Seat 1: frostbyte28 ($1580 in chips) 
Seat 2: jayakumar2020 ($430 in chips) 
Seat 3: PANCHYOU ($1022.74 in chips) 
Seat 4: papadickkies ($1040.42 in chips) 
Seat 5: Lucifer999 ($5395.47 in chips) 
Seat 6: devi7 ($2832.71 in chips) 
PANCHYOU: posts small blind $10
papadickkies: posts big blind $25
*** HOLE CARDS ***
Dealt to Lucifer999 [6s 3c]
Lucifer999: folds
devi7: raises $50.00 to $75
frostbyte28: calls $75
jayakumar2020: folds
PANCHYOU: folds
papadickkies: folds
*** FLOP *** [6h 2h Jc]
devi7: bets $125
frostbyte28: calls $125
*** TURN *** [6h 2h Jc] [3h]
devi7: checks
frostbyte28: checks
*** RIVER *** [6h 2h Jc 3h] [6d]
devi7: bets $269.39
frostbyte28: folds
Uncalled bet ($269.39) returned to devi7
devi7: doesn't show hand
devi7 collected $408.17 from pot
*** SUMMARY ***
Total pot $435.00 | Rake $26.83
Board [6h 2h Jc 3h 6d]
Seat 1: frostbyte28 folded on the River
Seat 2: jayakumar2020 (button) folded before Flop (didn't bet)
Seat 3: PANCHYOU (small blind) folded before Flop
Seat 4: papadickkies (big blind) folded before Flop
Seat 5: Lucifer999 folded before Flop (didn't bet)
Seat 6: devi7 collected ($408.17)



PokerStars Game #00327531408: Hold'em No Limit ($10/$25 USD) - 2022/04/30 09:59:27 ET
Table 'Hold'em (Min 500Max 2500) 1001' 6-max Seat #1 is the button
Seat 1: JaspritBumrah786 ($2065 in chips) 
Seat 2: fishfry123 ($1058.54 in chips) 
Seat 3: allthebest ($2307.16 in chips) 
Seat 4: devi7 ($2436.25 in chips) 
Seat 5: Lucifer999 ($5108.66 in chips) 
Seat 6: spidy02 ($3834.82 in chips) 
fishfry123: posts small blind $10
allthebest: posts big blind $25
*** HOLE CARDS ***
Dealt to Lucifer999 [3d 9c]
devi7: raises $50.00 to $75
Lucifer999: folds
spidy02: calls $75
JaspritBumrah786: folds
fishfry123: folds
allthebest: folds
*** FLOP *** [Kh 5h 3h]
devi7: checks
spidy02: bets $87.15
devi7: folds
Uncalled bet ($87.15) returned to spidy02
spidy02: doesn't show hand
spidy02 collected $174.29 from pot
*** SUMMARY ***
Total pot $185.00 | Rake $10.71
Board [Kh 5h 3h]
Seat 1: JaspritBumrah786 (button) folded before Flop (didn't bet)
Seat 2: fishfry123 (small blind) folded before Flop
Seat 3: allthebest (big blind) folded before Flop
Seat 4: devi7 folded on the Flop
Seat 5: Lucifer999 folded before Flop (didn't bet)
Seat 6: spidy02 collected ($174.29)



PokerStars Game #00327531455: Hold'em No Limit ($50/$100 USD) - 2022/04/30 09:59:44 ET
Table 'Hold'em (Min 25KMax 10K)    69' 6-max Seat #1 is the button
Seat 1: Lucifer999 ($13370.23 in chips) 
Seat 2: vinuth ($21570.17 in chips) 
Seat 5: tabby20 ($23233.99 in chips) 
vinuth: posts small blind $50
tabby20: posts big blind $100
*** HOLE CARDS ***
Dealt to Lucifer999 [Jd Js]
Lucifer999: calls $100
vinuth: raises $250.00 to $350
tabby20: raises $950.00 to $1300
Lucifer999: calls $1200
vinuth: folds
*** FLOP *** [6h 2c Qc]
tabby20: checks
Lucifer999: bets $1400
tabby20: folds
Uncalled bet ($1400) returned to Lucifer999
Lucifer999: doesn't show hand
Lucifer999 collected $2820.2 from pot
*** SUMMARY ***
Total pot $2950.00 | Rake $129.8
Board [6h 2c Qc]
Seat 1: Lucifer999 (button) collected ($2820.2)
Seat 2: vinuth (small blind) folded before Flop
Seat 5: tabby20 (big blind) folded on the Flop



PokerStars Game #00327531485: Hold'em No Limit ($25/$50 USD) - 2022/04/30 09:59:57 ET
Table 'Hold'em (Min 1K Max 5K)   216' 6-max Seat #5 is the button
Seat 1: Lucifer999 ($14746.42 in chips) 
Seat 2: rahulh1 ($4100.02 in chips) 
Seat 3: bettercall7208 ($5623.75 in chips) 
Seat 5: Avaroni ($6817.5 in chips) 
Lucifer999: posts small blind $25
rahulh1: posts big blind $50
*** HOLE CARDS ***
Dealt to Lucifer999 [Jh 8s]
bettercall7208: folds
Avaroni: raises $100.00 to $150
Lucifer999: folds
rahulh1: calls $100
*** FLOP *** [Js 8d 9d]
rahulh1: checks
Avaroni: bets $200
rahulh1: folds
Uncalled bet ($200) returned to Avaroni
Avaroni: doesn't show hand
Avaroni collected $308.75 from pot
*** SUMMARY ***
Total pot $325.00 | Rake $16.25
Board [Js 8d 9d]
Seat 1: Lucifer999 (small blind) folded before Flop
Seat 2: rahulh1 (big blind) folded on the Flop
Seat 3: bettercall7208 folded before Flop (didn't bet)
Seat 5: Avaroni (button) collected ($308.75)



PokerStars Game #00327531529: Hold'em No Limit ($10/$25 USD) - 2022/04/30 10:00:10 ET
Table 'Hold'em (Min 500Max 2500) 1001' 6-max Seat #2 is the button
Seat 1: JaspritBumrah786 ($2065 in chips) 
Seat 2: fishfry123 ($1048.54 in chips) 
Seat 3: allthebest ($2282.16 in chips) 
Seat 4: devi7 ($2361.25 in chips) 
Seat 5: Lucifer999 ($5108.66 in chips) 
Seat 6: spidy02 ($3934.11 in chips) 
allthebest: posts small blind $10
devi7: posts big blind $25
*** HOLE CARDS ***
Dealt to Lucifer999 [Td 3d]
Lucifer999: folds
spidy02: folds
JaspritBumrah786: folds
fishfry123: folds
allthebest: folds
Uncalled bet ($15) returned to devi7
devi7: doesn't show hand
devi7 collected $20 from pot
*** SUMMARY ***
Total pot $20.00 | Rake $0
Board []
Seat 1: JaspritBumrah786 folded before Flop (didn't bet)
Seat 2: fishfry123 (button) folded before Flop (didn't bet)
Seat 3: allthebest (small blind) folded before Flop
Seat 4: devi7 (big blind) collected ($20)
Seat 5: Lucifer999 folded before Flop (didn't bet)
Seat 6: spidy02 folded before Flop (didn't bet)



PokerStars Game #00327531579: Hold'em No Limit ($50/$100 USD) - 2022/04/30 10:00:31 ET
Table 'Hold'em (Min 25KMax 10K)    69' 6-max Seat #2 is the button
Seat 1: Lucifer999 ($14890.43 in chips) 
Seat 2: vinuth ($21220.17 in chips) 
Seat 5: tabby20 ($21933.99 in chips) 
tabby20: posts small blind $50
Lucifer999: posts big blind $100
*** HOLE CARDS ***
Dealt to Lucifer999 [6d 7d]
vinuth: folds
tabby20: raises $200.00 to $300
Lucifer999: calls $200
*** FLOP *** [9h Kd 9s]
tabby20: checks
Lucifer999: bets $350
tabby20: folds
Uncalled bet ($350) returned to Lucifer999
Lucifer999: doesn't show hand
Lucifer999 collected $573.6 from pot
*** SUMMARY ***
Total pot $600.00 | Rake $26.4
Board [9h Kd 9s]
Seat 1: Lucifer999 (big blind) collected ($573.6)
Seat 2: vinuth (button) folded before Flop (didn't bet)
Seat 5: tabby20 (small blind) folded on the Flop



PokerStars Game #00327531585: Hold'em No Limit ($25/$50 USD) - 2022/04/30 10:00:35 ET
Table 'Hold'em (Min 1K Max 5K)   216' 6-max Seat #1 is the button
Seat 1: Lucifer999 ($14721.42 in chips) 
Seat 2: rahulh1 ($3950.02 in chips) 
Seat 3: bettercall7208 ($5623.75 in chips) 
Seat 5: Avaroni ($6976.25 in chips) 
Seat 6: Pablit0 ($1000 in chips) 
rahulh1: posts small blind $25
bettercall7208: posts big blind $50
Pablit0: posts big blind $50
*** HOLE CARDS ***
Dealt to Lucifer999 [3s Jd]
Avaroni: folds
Pablit0: checks
Lucifer999: folds
rahulh1: calls $25
bettercall7208: checks
*** FLOP *** [8c 5s Ks]
rahulh1: checks
bettercall7208: checks
Pablit0: bets $75
rahulh1: folds
bettercall7208: folds
Uncalled bet ($75) returned to Pablit0
Pablit0: doesn't show hand
Pablit0 collected $142.5 from pot
*** SUMMARY ***
Total pot $150.00 | Rake $7.5
Board [8c 5s Ks]
Seat 1: Lucifer999 (button) folded before Flop (didn't bet)
Seat 2: rahulh1 (small blind) folded on the Flop
Seat 3: bettercall7208 (big blind) folded on the Flop
Seat 5: Avaroni folded before Flop (didn't bet)
Seat 6: Pablit0 collected ($142.5)



PokerStars Game #00327531668: Hold'em No Limit ($25/$50 USD) - 2022/04/30 10:01:01 ET
Table 'Hold'em (Min 1K Max 5K)   216' 6-max Seat #2 is the button
Seat 1: Lucifer999 ($14721.42 in chips) 
Seat 2: rahulh1 ($3900.02 in chips) 
Seat 3: bettercall7208 ($5573.75 in chips) 
Seat 5: Avaroni ($6976.25 in chips) 
Seat 6: Pablit0 ($1092.5 in chips) 
bettercall7208: posts small blind $25
Avaroni: posts big blind $50
*** HOLE CARDS ***
Dealt to Lucifer999 [Th 5d]
Pablit0: folds
Lucifer999: folds
rahulh1: folds
bettercall7208: folds
Uncalled bet ($25) returned to Avaroni
Avaroni: doesn't show hand
Avaroni collected $50 from pot
*** SUMMARY ***
Total pot $50.00 | Rake $0
Board []
Seat 1: Lucifer999 folded before Flop (didn't bet)
Seat 2: rahulh1 (button) folded before Flop (didn't bet)
Seat 3: bettercall7208 (small blind) folded before Flop
Seat 5: Avaroni (big blind) collected ($50)
Seat 6: Pablit0 folded before Flop (didn't bet)



PokerStars Game #00327531732: Hold'em No Limit ($50/$100 USD) - 2022/04/30 10:01:25 ET
Table 'Hold'em (Min 25KMax 10K)    69' 6-max Seat #1 is the button
Seat 1: Lucifer999 ($15164.03 in chips) 
Seat 2: vinuth ($21220.17 in chips) 
Seat 6: DM0507 ($2829.7 in chips) 
Lucifer999: posts small blind $50
DM0507: posts big blind $100
*** HOLE CARDS ***
Dealt to Lucifer999 [7s Jh]
Lucifer999: raises $150.00 to $250
DM0507: folds
Uncalled bet ($150) returned to Lucifer999
Lucifer999: doesn't show hand
Lucifer999 collected $200 from pot
*** SUMMARY ***
Total pot $200.00 | Rake $0
Board []
Seat 1: Lucifer999 (button) (small blind) collected ($200)
Seat 6: DM0507 (big blind) folded before Flop



PokerStars Game #00327531593: Hold'em No Limit ($10/$25 USD) - 2022/04/30 10:00:36 ET
Table 'Hold'em (Min 500Max 2500) 1001' 6-max Seat #3 is the button
Seat 1: JaspritBumrah786 ($2065 in chips) 
Seat 2: fishfry123 ($1048.54 in chips) 
Seat 3: allthebest ($2272.16 in chips) 
Seat 4: devi7 ($2371.25 in chips) 
Seat 5: Lucifer999 ($5108.66 in chips) 
Seat 6: spidy02 ($3934.11 in chips) 
devi7: posts small blind $10
Lucifer999: posts big blind $25
*** HOLE CARDS ***
Dealt to Lucifer999 [Ks 3c]
spidy02: folds
JaspritBumrah786: folds
fishfry123: folds
allthebest: calls $25
devi7: folds
Lucifer999: checks
*** FLOP *** [Jh 6h Js]
Lucifer999: bets $50
allthebest: calls $50
*** TURN *** [Jh 6h Js] [Td]
Lucifer999: checks
allthebest: checks
*** RIVER *** [Jh 6h Js Td] [Jd]
Lucifer999: checks
allthebest: bets $100
Lucifer999: folds
Uncalled bet ($100) returned to allthebest
allthebest: doesn't show hand
allthebest collected $150.6 from pot
*** SUMMARY ***
Total pot $160.00 | Rake $9.4
Board [Jh 6h Js Td Jd]
Seat 1: JaspritBumrah786 folded before Flop (didn't bet)
Seat 2: fishfry123 folded before Flop (didn't bet)
Seat 3: allthebest (button) collected ($150.6)
Seat 4: devi7 (small blind) folded before Flop
Seat 5: Lucifer999 (big blind) folded on the River
Seat 6: spidy02 folded before Flop (didn't bet)



PokerStars Game #00327531494: Hold'em No Limit ($10/$25 USD) - 2022/04/30 10:00:00 ET
Table 'Hold'em (Min 500Max 2500)  1282' 6-max Seat #3 is the button
Seat 1: frostbyte28 ($1380 in chips) 
Seat 2: jayakumar2020 ($430 in chips) 
Seat 3: PANCHYOU ($1012.74 in chips) 
Seat 4: papadickkies ($1015.42 in chips) 
Seat 5: Lucifer999 ($5395.47 in chips) 
Seat 6: devi7 ($3040.88 in chips) 
papadickkies: posts small blind $10
Lucifer999: posts big blind $25
*** HOLE CARDS ***
Dealt to Lucifer999 [Ks 2c]
devi7: folds
frostbyte28: folds
jayakumar2020: folds
PANCHYOU: folds
papadickkies: calls $15
Lucifer999: raises $65.00 to $90
papadickkies: calls $65
*** FLOP *** [3d Qs Qh]
papadickkies: checks
Lucifer999: bets $110
papadickkies: folds
Uncalled bet ($110) returned to Lucifer999
Lucifer999: doesn't show hand
Lucifer999 collected $169.55 from pot
*** SUMMARY ***
Total pot $180.00 | Rake $10.45
Board [3d Qs Qh]
Seat 1: frostbyte28 folded before Flop (didn't bet)
Seat 2: jayakumar2020 folded before Flop (didn't bet)
Seat 3: PANCHYOU (button) folded before Flop (didn't bet)
Seat 4: papadickkies (small blind) folded on the Flop
Seat 5: Lucifer999 (big blind) collected ($169.55)
Seat 6: devi7 folded before Flop (didn't bet)



PokerStars Game #00327531829: Hold'em No Limit ($10/$25 USD) - 2022/04/30 10:01:48 ET
Table 'Hold'em (Min 500Max 2500)  1282' 6-max Seat #4 is the button
Seat 1: frostbyte28 ($2500 in chips) 
Seat 2: jayakumar2020 ($430 in chips) 
Seat 3: PANCHYOU ($1012.74 in chips) 
Seat 4: papadickkies ($925.42 in chips) 
Seat 5: Lucifer999 ($5475.02 in chips) 
Seat 6: devi7 ($3040.88 in chips) 
Lucifer999: posts small blind $10
devi7: posts big blind $25
*** HOLE CARDS ***
Dealt to Lucifer999 [9s Tc]
frostbyte28: folds
jayakumar2020: folds
PANCHYOU: folds
papadickkies: folds
Lucifer999: raises $55.00 to $80
devi7: folds
Uncalled bet ($55) returned to Lucifer999
Lucifer999: doesn't show hand
Lucifer999 collected $50 from pot
*** SUMMARY ***
Total pot $50.00 | Rake $0
Board []
Seat 1: frostbyte28 folded before Flop (didn't bet)
Seat 2: jayakumar2020 folded before Flop (didn't bet)
Seat 3: PANCHYOU folded before Flop (didn't bet)
Seat 4: papadickkies (button) folded before Flop (didn't bet)
Seat 5: Lucifer999 (small blind) collected ($50)
Seat 6: devi7 (big blind) folded before Flop



PokerStars Game #00327531790: Hold'em No Limit ($50/$100 USD) - 2022/04/30 10:01:39 ET
Table 'Hold'em (Min 25KMax 10K)    69' 6-max Seat #6 is the button
Seat 1: Lucifer999 ($15264.03 in chips) 
Seat 2: vinuth ($21220.17 in chips) 
Seat 6: DM0507 ($2729.7 in chips) 
DM0507: posts small blind $50
Lucifer999: posts big blind $100
*** HOLE CARDS ***
Dealt to Lucifer999 [Qd 3d]
DM0507: calls $50
Lucifer999: checks
*** FLOP *** [5s 9s 6s]
Lucifer999: checks
DM0507: bets $192.2
Lucifer999: folds
Uncalled bet ($192.2) returned to DM0507
DM0507: doesn't show hand
DM0507 collected $192.2 from pot
*** SUMMARY ***
Total pot $200.00 | Rake $7.8
Board [5s 9s 6s]
Seat 1: Lucifer999 (big blind) folded on the Flop
Seat 6: DM0507 (button) (small blind) collected ($192.2)



PokerStars Game #00327531734: Hold'em No Limit ($25/$50 USD) - 2022/04/30 10:01:25 ET
Table 'Hold'em (Min 1K Max 5K)   216' 6-max Seat #3 is the button
Seat 1: Lucifer999 ($14721.42 in chips) 
Seat 2: rahulh1 ($3900.02 in chips) 
Seat 3: bettercall7208 ($5548.75 in chips) 
Seat 5: Avaroni ($7001.25 in chips) 
Seat 6: Pablit0 ($1092.5 in chips) 
Avaroni: posts small blind $25
Pablit0: posts big blind $50
*** HOLE CARDS ***
Dealt to Lucifer999 [Qd 4d]
Lucifer999: folds
rahulh1: raises $81.25 to $131.25
bettercall7208: folds
Avaroni: folds
Pablit0: calls $81.25
*** FLOP *** [4c 3d 3h]
Pablit0: checks
rahulh1: bets $204.86
Pablit0: folds
Uncalled bet ($204.86) returned to rahulh1
rahulh1: doesn't show hand
rahulh1 collected $273.15 from pot
*** SUMMARY ***
Total pot $287.50 | Rake $14.35
Board [4c 3d 3h]
Seat 1: Lucifer999 folded before Flop (didn't bet)
Seat 2: rahulh1 collected ($273.15)
Seat 3: bettercall7208 (button) folded before Flop (didn't bet)
Seat 5: Avaroni (small blind) folded before Flop
Seat 6: Pablit0 (big blind) folded on the Flop



PokerStars Game #00327531872: Hold'em No Limit ($10/$25 USD) - 2022/04/30 10:02:05 ET
Table 'Hold'em (Min 500Max 2500)  1282' 6-max Seat #5 is the button
Seat 1: frostbyte28 ($2500 in chips) 
Seat 2: jayakumar2020 ($430 in chips) 
Seat 3: PANCHYOU ($1012.74 in chips) 
Seat 4: papadickkies ($925.42 in chips) 
Seat 5: Lucifer999 ($5500.02 in chips) 
Seat 6: devi7 ($3015.88 in chips) 
devi7: posts small blind $10
frostbyte28: posts big blind $25
*** HOLE CARDS ***
Dealt to Lucifer999 [Th 4h]
jayakumar2020: folds
PANCHYOU: folds
papadickkies: raises $45.00 to $70
Lucifer999: folds
devi7: folds
frostbyte28: calls $45
*** FLOP *** [Kh 3s Qd]
frostbyte28: checks
papadickkies: bets $75
frostbyte28: folds
Uncalled bet ($75) returned to papadickkies
papadickkies: doesn't show hand
papadickkies collected $141.13 from pot
*** SUMMARY ***
Total pot $150.00 | Rake $8.87
Board [Kh 3s Qd]
Seat 1: frostbyte28 (big blind) folded on the Flop
Seat 2: jayakumar2020 folded before Flop (didn't bet)
Seat 3: PANCHYOU folded before Flop (didn't bet)
Seat 4: papadickkies collected ($141.13)
Seat 5: Lucifer999 (button) folded before Flop (didn't bet)
Seat 6: devi7 (small blind) folded before Flop



PokerStars Game #00327531808: Hold'em No Limit ($10/$25 USD) - 2022/04/30 10:01:44 ET
Table 'Hold'em (Min 500Max 2500) 1001' 6-max Seat #4 is the button
Seat 1: JaspritBumrah786 ($2065 in chips) 
Seat 2: fishfry123 ($1048.54 in chips) 
Seat 3: allthebest ($2347.76 in chips) 
Seat 4: devi7 ($2361.25 in chips) 
Seat 5: Lucifer999 ($5033.66 in chips) 
Seat 6: spidy02 ($3934.11 in chips) 
Lucifer999: posts small blind $10
spidy02: posts big blind $25
*** HOLE CARDS ***
Dealt to Lucifer999 [Tc Jh]
JaspritBumrah786: raises $50.00 to $75
fishfry123: calls $75
allthebest: folds
devi7: folds
Lucifer999: folds
spidy02: raises $211.43 to $286.43
JaspritBumrah786: folds
fishfry123: calls $211.43
*** FLOP *** [9d 3d Qd]
spidy02: checks
fishfry123: bets $762.11
spidy02: folds
Uncalled bet ($762.11) returned to fishfry123
fishfry123: doesn't show hand
fishfry123 collected $618.37 from pot
*** SUMMARY ***
Total pot $657.86 | Rake $39.49
Board [9d 3d Qd]
Seat 1: JaspritBumrah786 folded before Flop
Seat 2: fishfry123 collected ($618.37)
Seat 3: allthebest folded before Flop (didn't bet)
Seat 4: devi7 (button) folded before Flop (didn't bet)
Seat 5: Lucifer999 (small blind) folded before Flop
Seat 6: spidy02 (big blind) folded on the Flop



PokerStars Game #00327531899: Hold'em No Limit ($50/$100 USD) - 2022/04/30 10:02:15 ET
Table 'Hold'em (Min 25KMax 10K)    69' 6-max Seat #1 is the button
Seat 1: Lucifer999 ($15164.03 in chips) 
Seat 2: vinuth ($21220.17 in chips) 
Seat 5: tabby20 ($21633.99 in chips) 
Seat 6: DM0507 ($2821.9 in chips) 
Lucifer999: posts small blind $50
DM0507: posts big blind $100
*** HOLE CARDS ***
Dealt to Lucifer999 [7d 3d]
Lucifer999: calls $50
DM0507: checks
*** FLOP *** [4c 3h 5d]
DM0507: checks
Lucifer999: bets $150
DM0507: calls $150
*** TURN *** [4c 3h 5d] [Qs]
DM0507: checks
Lucifer999: checks
*** RIVER *** [4c 3h 5d Qs] [2s]
DM0507: checks
Lucifer999: checks
*** SHOW DOWN ***
Lucifer999: shows [7d 3d] (Pair, 33)
DM0507: shows [9s 4s] (Pair, 44)
DM0507 collected $480.5 from pot
*** SUMMARY ***
Total pot $500.00 | Rake $19.5
Board [4c 3h 5d Qs 2s]
Seat 1: Lucifer999 (button) (small blind) showed [7d 3d] and lost with Pair, 33
Seat 6: DM0507  (big blind) showed [9s 4s] and won ($480.5) with Pair, 44



PokerStars Game #00327532043: Hold'em No Limit ($50/$100 USD) - 2022/04/30 10:03:00 ET
Table 'Hold'em (Min 25KMax 10K)    69' 6-max Seat #6 is the button
Seat 1: Lucifer999 ($14914.03 in chips) 
Seat 2: vinuth ($21220.17 in chips) 
Seat 5: tabby20 ($21633.99 in chips) 
Seat 6: DM0507 ($3052.4 in chips) 
Lucifer999: posts small blind $50
tabby20: posts big blind $100
*** HOLE CARDS ***
Dealt to Lucifer999 [Qs 4h]
DM0507: folds
Lucifer999: folds
Uncalled bet ($50) returned to tabby20
tabby20: doesn't show hand
tabby20 collected $100 from pot
*** SUMMARY ***
Total pot $100.00 | Rake $0
Board []
Seat 1: Lucifer999 (small blind) folded before Flop
Seat 5: tabby20 (big blind) collected ($100)
Seat 6: DM0507 (button) folded before Flop (didn't bet)



PokerStars Game #00327531908: Hold'em No Limit ($25/$50 USD) - 2022/04/30 10:02:18 ET
Table 'Hold'em (Min 1K Max 5K)   216' 6-max Seat #5 is the button
Seat 1: Lucifer999 ($14721.42 in chips) 
Seat 2: rahulh1 ($4041.92 in chips) 
Seat 3: bettercall7208 ($5548.75 in chips) 
Seat 4: No username ($5000 in chips) 
Seat 5: Avaroni ($6976.25 in chips) 
Seat 6: Pablit0 ($961.25 in chips) 
Pablit0: posts small blind $25
Lucifer999: posts big blind $50
No username: posts big blind $50
*** HOLE CARDS ***
Dealt to Lucifer999 [5d 7c]
rahulh1: folds
bettercall7208: folds
No username: checks
Avaroni: folds
Pablit0: folds
Lucifer999: raises $125.00 to $175
No username: folds
Uncalled bet ($125) returned to Lucifer999
Lucifer999: doesn't show hand
Lucifer999 collected $125 from pot
*** SUMMARY ***
Total pot $125.00 | Rake $0
Board []
Seat 1: Lucifer999 (big blind) collected ($125)
Seat 2: rahulh1 folded before Flop (didn't bet)
Seat 3: bettercall7208 folded before Flop (didn't bet)
Seat 4: No username folded before Flop
Seat 5: Avaroni (button) folded before Flop (didn't bet)
Seat 6: Pablit0 (small blind) folded before Flop



PokerStars Game #00327532025: Hold'em No Limit ($10/$25 USD) - 2022/04/30 10:02:55 ET
Table 'Hold'em (Min 500Max 2500) 1001' 6-max Seat #5 is the button
Seat 1: JaspritBumrah786 ($2025 in chips) 
Seat 2: fishfry123 ($1380.48 in chips) 
Seat 3: allthebest ($2347.76 in chips) 
Seat 4: devi7 ($2361.25 in chips) 
Seat 5: Lucifer999 ($5023.66 in chips) 
Seat 6: spidy02 ($3647.68 in chips) 
spidy02: posts small blind $10
JaspritBumrah786: posts big blind $25
*** HOLE CARDS ***
Dealt to Lucifer999 [9c 6h]
fishfry123: folds
allthebest: folds
devi7: raises $50.00 to $75
Lucifer999: folds
spidy02: folds
JaspritBumrah786: folds
Uncalled bet ($50) returned to devi7
devi7: doesn't show hand
devi7 collected $60 from pot
*** SUMMARY ***
Total pot $60.00 | Rake $0
Board []
Seat 1: JaspritBumrah786 (big blind) folded before Flop
Seat 2: fishfry123 folded before Flop (didn't bet)
Seat 3: allthebest folded before Flop (didn't bet)
Seat 4: devi7 collected ($60)
Seat 5: Lucifer999 (button) folded before Flop (didn't bet)
Seat 6: spidy02 (small blind) folded before Flop



PokerStars Game #00327532078: Hold'em No Limit ($50/$100 USD) - 2022/04/30 10:03:10 ET
Table 'Hold'em (Min 25KMax 10K)    69' 6-max Seat #1 is the button
Seat 1: Lucifer999 ($14864.03 in chips) 
Seat 2: vinuth ($21220.17 in chips) 
Seat 5: tabby20 ($21683.99 in chips) 
Seat 6: DM0507 ($3052.4 in chips) 
tabby20: posts small blind $50
DM0507: posts big blind $100
*** HOLE CARDS ***
Dealt to Lucifer999 [5c 7d]
Lucifer999: folds
tabby20: folds
Uncalled bet ($50) returned to DM0507
DM0507: doesn't show hand
DM0507 collected $100 from pot
*** SUMMARY ***
Total pot $100.00 | Rake $0
Board []
Seat 1: Lucifer999 (button) folded before Flop (didn't bet)
Seat 5: tabby20 (small blind) folded before Flop
Seat 6: DM0507 (big blind) collected ($100)



PokerStars Game #00327532009: Hold'em No Limit ($10/$25 USD) - 2022/04/30 10:02:52 ET
Table 'Hold'em (Min 500Max 2500)  1282' 6-max Seat #6 is the button
Seat 1: frostbyte28 ($2430 in chips) 
Seat 2: jayakumar2020 ($430 in chips) 
Seat 3: PANCHYOU ($1012.74 in chips) 
Seat 4: papadickkies ($996.55 in chips) 
Seat 5: Lucifer999 ($5500.02 in chips) 
Seat 6: devi7 ($3005.88 in chips) 
frostbyte28: posts small blind $10
jayakumar2020: posts big blind $25
*** HOLE CARDS ***
Dealt to Lucifer999 [9h Td]
PANCHYOU: folds
papadickkies: raises $28.17 to $53.17
Lucifer999: folds
devi7: folds
frostbyte28: calls $43.17
jayakumar2020: folds
*** FLOP *** [3s Jh 9c]
frostbyte28: checks
papadickkies: bets $105
frostbyte28: folds
Uncalled bet ($105) returned to papadickkies
papadickkies: doesn't show hand
papadickkies collected $123.47 from pot
*** SUMMARY ***
Total pot $131.34 | Rake $7.87
Board [3s Jh 9c]
Seat 1: frostbyte28 (small blind) folded on the Flop
Seat 2: jayakumar2020 (big blind) folded before Flop
Seat 3: PANCHYOU folded before Flop (didn't bet)
Seat 4: papadickkies collected ($123.47)
Seat 5: Lucifer999 folded before Flop (didn't bet)
Seat 6: devi7 (button) folded before Flop (didn't bet)



PokerStars Game #00327532150: Hold'em No Limit ($10/$25 USD) - 2022/04/30 10:03:34 ET
Table 'Hold'em (Min 500Max 2500)  1282' 6-max Seat #1 is the button
Seat 1: frostbyte28 ($2376.83 in chips) 
Seat 2: jayakumar2020 ($405 in chips) 
Seat 3: PANCHYOU ($1012.74 in chips) 
Seat 4: papadickkies ($1066.85 in chips) 
Seat 5: Lucifer999 ($5500.02 in chips) 
Seat 6: devi7 ($3005.88 in chips) 
jayakumar2020: posts small blind $10
PANCHYOU: posts big blind $25
*** HOLE CARDS ***
Dealt to Lucifer999 [3h 9h]
papadickkies: folds
Lucifer999: folds
devi7: folds
frostbyte28: raises $60.00 to $85
jayakumar2020: folds
PANCHYOU: folds
Uncalled bet ($60) returned to frostbyte28
frostbyte28: doesn't show hand
frostbyte28 collected $60 from pot
*** SUMMARY ***
Total pot $60.00 | Rake $0
Board []
Seat 1: frostbyte28 (button) collected ($60)
Seat 2: jayakumar2020 (small blind) folded before Flop
Seat 3: PANCHYOU (big blind) folded before Flop
Seat 4: papadickkies folded before Flop (didn't bet)
Seat 5: Lucifer999 folded before Flop (didn't bet)
Seat 6: devi7 folded before Flop (didn't bet)



PokerStars Game #00327532099: Hold'em No Limit ($25/$50 USD) - 2022/04/30 10:03:16 ET
Table 'Hold'em (Min 1K Max 5K)   216' 6-max Seat #6 is the button
Seat 1: Lucifer999 ($14796.42 in chips) 
Seat 2: rahulh1 ($4041.92 in chips) 
Seat 3: bettercall7208 ($5548.75 in chips) 
Seat 4: No username ($4950 in chips) 
Seat 5: Avaroni ($6976.25 in chips) 
Seat 6: Pablit0 ($936.25 in chips) 
Lucifer999: posts small blind $25
rahulh1: posts big blind $50
*** HOLE CARDS ***
Dealt to Lucifer999 [4c Js]
bettercall7208: folds
No username: folds
Avaroni: folds
Pablit0: folds
Lucifer999: raises $100.00 to $150
rahulh1: calls $100
*** FLOP *** [Jh Tc 8s]
Lucifer999: checks
rahulh1: bets $130.89
Lucifer999: calls $130.89
*** TURN *** [Jh Tc 8s] [9c]
Lucifer999: checks
rahulh1: bets $204.7
Lucifer999: folds
Uncalled bet ($204.7) returned to rahulh1
rahulh1: doesn't show hand
rahulh1 collected $533.73 from pot
*** SUMMARY ***
Total pot $561.78 | Rake $28.05
Board [Jh Tc 8s 9c]
Seat 1: Lucifer999 (small blind) folded on the Turn
Seat 2: rahulh1 (big blind) collected ($533.73)
Seat 3: bettercall7208 folded before Flop (didn't bet)
Seat 4: No username folded before Flop (didn't bet)
Seat 5: Avaroni folded before Flop (didn't bet)
Seat 6: Pablit0 (button) folded before Flop (didn't bet)



PokerStars Game #00327532142: Hold'em No Limit ($50/$100 USD) - 2022/04/30 10:03:30 ET
Table 'Hold'em (Min 25KMax 10K)    69' 6-max Seat #5 is the button
Seat 1: Lucifer999 ($14864.03 in chips) 
Seat 2: vinuth ($21220.17 in chips) 
Seat 5: tabby20 ($21633.99 in chips) 
Seat 6: DM0507 ($3102.4 in chips) 
DM0507: posts small blind $50
Lucifer999: posts big blind $100
*** HOLE CARDS ***
Dealt to Lucifer999 [3s Qs]
tabby20: folds
DM0507: calls $50
Lucifer999: raises $250.00 to $350
DM0507: calls $250
*** FLOP *** [Qc 4d Ad]
DM0507: checks
Lucifer999: checks
*** TURN *** [Qc 4d Ad] [9d]
DM0507: checks
Lucifer999: bets $300
DM0507: folds
Uncalled bet ($300) returned to Lucifer999
Lucifer999: doesn't show hand
Lucifer999 collected $669.2 from pot
*** SUMMARY ***
Total pot $700.00 | Rake $30.8
Board [Qc 4d Ad 9d]
Seat 1: Lucifer999 (big blind) collected ($669.2)
Seat 5: tabby20 (button) folded before Flop (didn't bet)
Seat 6: DM0507 (small blind) folded on the Turn



PokerStars Game #00327532121: Hold'em No Limit ($10/$25 USD) - 2022/04/30 10:03:25 ET
Table 'Hold'em (Min 500Max 2500) 1001' 6-max Seat #6 is the button
Seat 1: JaspritBumrah786 ($2000 in chips) 
Seat 2: fishfry123 ($1380.48 in chips) 
Seat 3: allthebest ($2347.76 in chips) 
Seat 4: devi7 ($2396.25 in chips) 
Seat 5: Lucifer999 ($5023.66 in chips) 
Seat 6: spidy02 ($3637.68 in chips) 
JaspritBumrah786: posts small blind $10
fishfry123: posts big blind $25
*** HOLE CARDS ***
Dealt to Lucifer999 [Th 4s]
allthebest: raises $50.00 to $75
devi7: folds
Lucifer999: folds
spidy02: folds
JaspritBumrah786: folds
fishfry123: folds
Uncalled bet ($50) returned to allthebest
allthebest: doesn't show hand
allthebest collected $60 from pot
*** SUMMARY ***
Total pot $60.00 | Rake $0
Board []
Seat 1: JaspritBumrah786 (small blind) folded before Flop
Seat 2: fishfry123 (big blind) folded before Flop
Seat 3: allthebest collected ($60)
Seat 4: devi7 folded before Flop (didn't bet)
Seat 5: Lucifer999 folded before Flop (didn't bet)
Seat 6: spidy02 (button) folded before Flop (didn't bet)



PokerStars Game #00327532269: Hold'em No Limit ($50/$100 USD) - 2022/04/30 10:04:14 ET
Table 'Hold'em (Min 25KMax 10K)    69' 6-max Seat #6 is the button
Seat 1: Lucifer999 ($15183.23 in chips) 
Seat 2: vinuth ($21220.17 in chips) 
Seat 5: tabby20 ($21633.99 in chips) 
Seat 6: DM0507 ($2752.4 in chips) 
Lucifer999: posts small blind $50
tabby20: posts big blind $100
*** HOLE CARDS ***
Dealt to Lucifer999 [8c 8h]
DM0507: folds
Lucifer999: raises $200.00 to $300
tabby20: calls $200
*** FLOP *** [Jd 6h 9h]
Lucifer999: checks
tabby20: bets $21333.99
Lucifer999: folds
Uncalled bet ($21333.99) returned to tabby20
tabby20: doesn't show hand
tabby20 collected $573.6 from pot
*** SUMMARY ***
Total pot $600.00 | Rake $26.4
Board [Jd 6h 9h]
Seat 1: Lucifer999 (small blind) folded on the Flop
Seat 5: tabby20 (big blind) collected ($573.6)
Seat 6: DM0507 (button) folded before Flop (didn't bet)



PokerStars Game #00327532241: Hold'em No Limit ($10/$25 USD) - 2022/04/30 10:04:05 ET
Table 'Hold'em (Min 500Max 2500)  1282' 6-max Seat #2 is the button
Seat 1: frostbyte28 ($2411.83 in chips) 
Seat 2: jayakumar2020 ($395 in chips) 
Seat 3: PANCHYOU ($987.74 in chips) 
Seat 4: papadickkies ($1066.85 in chips) 
Seat 5: Lucifer999 ($5500.02 in chips) 
Seat 6: devi7 ($3005.88 in chips) 
PANCHYOU: posts small blind $10
papadickkies: posts big blind $25
*** HOLE CARDS ***
Dealt to Lucifer999 [Jh 5s]
Lucifer999: folds
devi7: folds
frostbyte28: calls $25
jayakumar2020: folds
PANCHYOU: folds
papadickkies: checks
*** FLOP *** [5d 5h 6c]
papadickkies: checks
frostbyte28: checks
*** TURN *** [5d 5h 6c] [As]
papadickkies: checks
frostbyte28: checks
*** RIVER *** [5d 5h 6c As] [6d]
papadickkies: bets $42.64
frostbyte28: calls $42.64
*** SHOW DOWN ***
papadickkies: shows [Kh 4c] (Two pairs, 6655)
frostbyte28: shows [Jc 9d] (Two pairs, 6655)
papadickkies collected $68.34 from pot
frostbyte28 collected $68.33 from pot
*** SUMMARY ***
Total pot $145.28 | Rake $8.61
Board [5d 5h 6c As 6d]
Seat 1: frostbyte28  showed [Jc 9d] and won ($68.33) with Two pairs, 6655
Seat 2: jayakumar2020 (button) folded before Flop (didn't bet)
Seat 3: PANCHYOU (small blind) folded before Flop
Seat 4: papadickkies  (big blind) showed [Kh 4c] and won ($68.34) with Two pairs, 6655
Seat 5: Lucifer999 folded before Flop (didn't bet)
Seat 6: devi7 folded before Flop (didn't bet)



PokerStars Game #00327532387: Hold'em No Limit ($50/$100 USD) - 2022/04/30 10:04:48 ET
Table 'Hold'em (Min 25KMax 10K)    69' 6-max Seat #1 is the button
Seat 1: Lucifer999 ($14883.23 in chips) 
Seat 2: vinuth ($21220.17 in chips) 
Seat 5: tabby20 ($21907.59 in chips) 
Seat 6: DM0507 ($2752.4 in chips) 
tabby20: posts small blind $50
DM0507: posts big blind $100
*** HOLE CARDS ***
Dealt to Lucifer999 [Ac 7s]
Lucifer999: folds
tabby20: folds
Uncalled bet ($50) returned to DM0507
DM0507: doesn't show hand
DM0507 collected $100 from pot
*** SUMMARY ***
Total pot $100.00 | Rake $0
Board []
Seat 1: Lucifer999 (button) folded before Flop (didn't bet)
Seat 5: tabby20 (small blind) folded before Flop
Seat 6: DM0507 (big blind) collected ($100)



PokerStars Game #00327532384: Hold'em No Limit ($10/$25 USD) - 2022/04/30 10:04:47 ET
Table 'Hold'em (Min 500Max 2500) 1001' 6-max Seat #1 is the button
Seat 1: JaspritBumrah786 ($2025 in chips) 
Seat 2: fishfry123 ($1355.48 in chips) 
Seat 3: allthebest ($2382.76 in chips) 
Seat 4: devi7 ($2396.25 in chips) 
Seat 5: Lucifer999 ($5023.66 in chips) 
Seat 6: spidy02 ($3637.68 in chips) 
allthebest: posts small blind $10
devi7: posts big blind $25
*** HOLE CARDS ***
Dealt to Lucifer999 [Td 9s]
Lucifer999: folds
spidy02: raises $38.75 to $63.75
JaspritBumrah786: folds
allthebest: folds
devi7: folds
Uncalled bet ($38.75) returned to spidy02
spidy02: doesn't show hand
spidy02 collected $60 from pot
*** SUMMARY ***
Total pot $60.00 | Rake $0
Board []
Seat 1: JaspritBumrah786 (button) folded before Flop (didn't bet)
Seat 3: allthebest (small blind) folded before Flop
Seat 4: devi7 (big blind) folded before Flop
Seat 5: Lucifer999 folded before Flop (didn't bet)
Seat 6: spidy02 collected ($60)



PokerStars Game #00327532268: Hold'em No Limit ($25/$50 USD) - 2022/04/30 10:04:14 ET
Table 'Hold'em (Min 1K Max 5K)   216' 6-max Seat #1 is the button
Seat 1: Lucifer999 ($14515.53 in chips) 
Seat 2: rahulh1 ($4294.76 in chips) 
Seat 3: bettercall7208 ($5548.75 in chips) 
Seat 4: No username ($4950 in chips) 
Seat 5: Avaroni ($6976.25 in chips) 
Seat 6: Pablit0 ($936.25 in chips) 
rahulh1: posts small blind $25
bettercall7208: posts big blind $50
*** HOLE CARDS ***
Dealt to Lucifer999 [2c 7c]
No username: raises $81.25 to $131.25
Avaroni: calls $131.25
Pablit0: folds
Lucifer999: folds
rahulh1: folds
bettercall7208: calls $81.25
*** FLOP *** [Ts 4h 6s]
bettercall7208: checks
No username: bets $136.32
Avaroni: calls $136.32
bettercall7208: raises $335.24 to $471.56
No username: folds
Avaroni: calls $335.24
*** TURN *** [Ts 4h 6s] [4s]
bettercall7208: bets $948.86
Avaroni: folds
Uncalled bet ($948.86) returned to bettercall7208
bettercall7208: doesn't show hand
bettercall7208 collected $1423.29 from pot
*** SUMMARY ***
Total pot $1498.19 | Rake $74.9
Board [Ts 4h 6s 4s]
Seat 1: Lucifer999 (button) folded before Flop (didn't bet)
Seat 2: rahulh1 (small blind) folded before Flop
Seat 3: bettercall7208 (big blind) collected ($1423.29)
Seat 4: No username folded on the Flop
Seat 5: Avaroni folded on the Turn
Seat 6: Pablit0 folded before Flop (didn't bet)



PokerStars Game #00327532453: Hold'em No Limit ($50/$100 USD) - 2022/04/30 10:05:08 ET
Table 'Hold'em (Min 25KMax 10K)    69' 6-max Seat #5 is the button
Seat 1: Lucifer999 ($14883.23 in chips) 
Seat 2: vinuth ($21220.17 in chips) 
Seat 5: tabby20 ($21857.59 in chips) 
Seat 6: DM0507 ($2802.4 in chips) 
DM0507: posts small blind $50
Lucifer999: posts big blind $100
*** HOLE CARDS ***
Dealt to Lucifer999 [6s 7c]
tabby20: raises $250.00 to $350
DM0507: calls $300
Lucifer999: folds
*** FLOP *** [3s 4c 5h]
DM0507: checks
tabby20: checks
*** TURN *** [3s 4c 5h] [9d]
DM0507: bets $382.4
tabby20: calls $382.4
*** RIVER *** [3s 4c 5h 9d] [Ks]
DM0507: checks
tabby20: checks
*** SHOW DOWN ***
DM0507: shows [Qh Ts] (High card, K)
tabby20: shows [Ac Tc] (High card, A)
tabby20 collected $1495.99 from pot
*** SUMMARY ***
Total pot $1564.80 | Rake $68.81
Board [3s 4c 5h 9d Ks]
Seat 1: Lucifer999 (big blind) folded before Flop
Seat 5: tabby20  (button) showed [Ac Tc] and won ($1495.99) with High card, A
Seat 6: DM0507 (small blind) showed [Qh Ts] and lost with High card, K



PokerStars Game #00327532474: Hold'em No Limit ($10/$25 USD) - 2022/04/30 10:05:15 ET
Table 'Hold'em (Min 500Max 2500) 1001' 6-max Seat #3 is the button
Seat 1: JaspritBumrah786 ($2025 in chips) 
Seat 2: fishfry123 ($1355.48 in chips) 
Seat 3: allthebest ($2372.76 in chips) 
Seat 4: devi7 ($2371.25 in chips) 
Seat 5: Lucifer999 ($5023.66 in chips) 
Seat 6: spidy02 ($3672.68 in chips) 
devi7: posts small blind $10
Lucifer999: posts big blind $25
*** HOLE CARDS ***
Dealt to Lucifer999 [8h 9c]
spidy02: calls $25
JaspritBumrah786: folds
allthebest: calls $25
devi7: folds
Lucifer999: checks
*** FLOP *** [Qh Kc Kd]
Lucifer999: checks
spidy02: checks
allthebest: bets $50
Lucifer999: folds
spidy02: folds
Uncalled bet ($50) returned to allthebest
allthebest: doesn't show hand
allthebest collected $80.54 from pot
*** SUMMARY ***
Total pot $85.00 | Rake $4.46
Board [Qh Kc Kd]
Seat 1: JaspritBumrah786 folded before Flop (didn't bet)
Seat 3: allthebest (button) collected ($80.54)
Seat 4: devi7 (small blind) folded before Flop
Seat 5: Lucifer999 (big blind) folded on the Flop
Seat 6: spidy02 folded on the Flop



PokerStars Game #00327532584: Hold'em No Limit ($50/$100 USD) - 2022/04/30 10:05:52 ET
Table 'Hold'em (Min 25KMax 10K)    69' 6-max Seat #6 is the button
Seat 1: Lucifer999 ($14783.23 in chips) 
Seat 5: tabby20 ($22621.18 in chips) 
Seat 6: DM0507 ($2070 in chips) 
Lucifer999: posts small blind $50
tabby20: posts big blind $100
*** HOLE CARDS ***
Dealt to Lucifer999 [Jc 9d]
DM0507: calls $100
Lucifer999: calls $50
tabby20: checks
*** FLOP *** [6h 7c Qs]
Lucifer999: bets $200
tabby20: folds
DM0507: folds
Uncalled bet ($200) returned to Lucifer999
Lucifer999: doesn't show hand
Lucifer999 collected $286.8 from pot
*** SUMMARY ***
Total pot $300.00 | Rake $13.2
Board [6h 7c Qs]
Seat 1: Lucifer999 (small blind) collected ($286.8)
Seat 5: tabby20 (big blind) folded on the Flop
Seat 6: DM0507 (button) folded on the Flop



PokerStars Game #00327532482: Hold'em No Limit ($25/$50 USD) - 2022/04/30 10:05:18 ET
Table 'Hold'em (Min 1K Max 5K)   216' 6-max Seat #2 is the button
Seat 1: Lucifer999 ($14515.53 in chips) 
Seat 2: rahulh1 ($4269.76 in chips) 
Seat 3: bettercall7208 ($6369.23 in chips) 
Seat 4: No username ($4682.43 in chips) 
Seat 5: Avaroni ($6373.44 in chips) 
Seat 6: Pablit0 ($936.25 in chips) 
bettercall7208: posts small blind $25
No username: posts big blind $50
*** HOLE CARDS ***
Dealt to Lucifer999 [Ad 5d]
Avaroni: folds
Pablit0: folds
Lucifer999: raises $100.00 to $150
rahulh1: folds
bettercall7208: calls $125
No username: calls $100
*** FLOP *** [3s Qh 5c]
bettercall7208: checks
No username: checks
Lucifer999: bets $150
bettercall7208: calls $150
No username: folds
*** TURN *** [3s Qh 5c] [8h]
bettercall7208: checks
Lucifer999: checks
*** RIVER *** [3s Qh 5c 8h] [9c]
bettercall7208: bets $612.5
Lucifer999: folds
Uncalled bet ($612.5) returned to bettercall7208
bettercall7208: doesn't show hand
bettercall7208 collected $712.5 from pot
*** SUMMARY ***
Total pot $750.00 | Rake $37.5
Board [3s Qh 5c 8h 9c]
Seat 1: Lucifer999 folded on the River
Seat 2: rahulh1 (button) folded before Flop (didn't bet)
Seat 3: bettercall7208 (small blind) collected ($712.5)
Seat 4: No username (big blind) folded on the Flop
Seat 5: Avaroni folded before Flop (didn't bet)
Seat 6: Pablit0 folded before Flop (didn't bet)



PokerStars Game #00327532431: Hold'em No Limit ($10/$25 USD) - 2022/04/30 10:05:01 ET
Table 'Hold'em (Min 500Max 2500)  1282' 6-max Seat #3 is the button
Seat 1: frostbyte28 ($2412.52 in chips) 
Seat 2: jayakumar2020 ($395 in chips) 
Seat 3: PANCHYOU ($977.74 in chips) 
Seat 4: papadickkies ($1067.55 in chips) 
Seat 5: Lucifer999 ($5500.02 in chips) 
Seat 6: devi7 ($3005.88 in chips) 
papadickkies: posts small blind $10
Lucifer999: posts big blind $25
*** HOLE CARDS ***
Dealt to Lucifer999 [Ah 4h]
devi7: folds
frostbyte28: calls $25
jayakumar2020: folds
PANCHYOU: folds
papadickkies: folds
Lucifer999: raises $75.00 to $100
frostbyte28: calls $75
*** FLOP *** [4c 8h 9s]
Lucifer999: checks
frostbyte28: checks
*** TURN *** [4c 8h 9s] [8d]
Lucifer999: bets $130
frostbyte28: calls $130
*** RIVER *** [4c 8h 9s 8d] [Ac]
Lucifer999: bets $320
frostbyte28: calls $320
*** SHOW DOWN ***
Lucifer999: shows [Ah 4h] (Two pairs, AA88)
frostbyte28: shows [8s Ts] (Three of a kind, 888)
frostbyte28 collected $1046.73 from pot
*** SUMMARY ***
Total pot $1110.00 | Rake $63.27
Board [4c 8h 9s 8d Ac]
Seat 1: frostbyte28  showed [8s Ts] and won ($1046.73) with Three of a kind, 888
Seat 2: jayakumar2020 folded before Flop (didn't bet)
Seat 3: PANCHYOU (button) folded before Flop (didn't bet)
Seat 4: papadickkies (small blind) folded before Flop
Seat 5: Lucifer999 (big blind) showed [Ah 4h] and lost with Two pairs, AA88
Seat 6: devi7 folded before Flop (didn't bet)



PokerStars Game #00327532648: Hold'em No Limit ($10/$25 USD) - 2022/04/30 10:06:11 ET
Table 'Hold'em (Min 500Max 2500) 1001' 6-max Seat #4 is the button
Seat 1: JaspritBumrah786 ($2025 in chips) 
Seat 2: fishfry123 ($1355.48 in chips) 
Seat 3: allthebest ($2428.3 in chips) 
Seat 4: devi7 ($2361.25 in chips) 
Seat 5: Lucifer999 ($4998.66 in chips) 
Seat 6: spidy02 ($3647.68 in chips) 
Lucifer999: posts small blind $10
spidy02: posts big blind $25
fishfry123: posts small blind $10
*** HOLE CARDS ***
Dealt to Lucifer999 [Ac 5d]
JaspritBumrah786: folds
fishfry123: calls $15
allthebest: raises $75.00 to $100
devi7: folds
Lucifer999: folds
spidy02: folds
fishfry123: folds
Uncalled bet ($75) returned to allthebest
allthebest: doesn't show hand
allthebest collected $85 from pot
*** SUMMARY ***
Total pot $85.00 | Rake $0
Board []
Seat 1: JaspritBumrah786 folded before Flop (didn't bet)
Seat 2: fishfry123 folded before Flop
Seat 3: allthebest collected ($85)
Seat 4: devi7 (button) folded before Flop (didn't bet)
Seat 5: Lucifer999 (small blind) folded before Flop
Seat 6: spidy02 (big blind) folded before Flop



PokerStars Game #00327532717: Hold'em No Limit ($25/$50 USD) - 2022/04/30 10:06:28 ET
Table 'Hold'em (Min 1K Max 5K)   216' 6-max Seat #3 is the button
Seat 1: Lucifer999 ($14215.53 in chips) 
Seat 2: rahulh1 ($4269.76 in chips) 
Seat 3: bettercall7208 ($6781.73 in chips) 
Seat 4: No username ($4532.43 in chips) 
Seat 5: Avaroni ($6373.44 in chips) 
Seat 6: Pablit0 ($936.25 in chips) 
No username: posts small blind $25
Avaroni: posts big blind $50
*** HOLE CARDS ***
Dealt to Lucifer999 [5c 9c]
Pablit0: folds
Lucifer999: folds
rahulh1: folds
bettercall7208: folds
No username: raises $100.00 to $150
Avaroni: folds
Uncalled bet ($100) returned to No username
No username: doesn't show hand
No username collected $100 from pot
*** SUMMARY ***
Total pot $100.00 | Rake $0
Board []
Seat 1: Lucifer999 folded before Flop (didn't bet)
Seat 2: rahulh1 folded before Flop (didn't bet)
Seat 3: bettercall7208 (button) folded before Flop (didn't bet)
Seat 4: No username (small blind) collected ($100)
Seat 5: Avaroni (big blind) folded before Flop
Seat 6: Pablit0 folded before Flop (didn't bet)



PokerStars Game #00327532677: Hold'em No Limit ($50/$100 USD) - 2022/04/30 10:06:18 ET
Table 'Hold'em (Min 25KMax 10K)    69' 6-max Seat #1 is the button
Seat 1: Lucifer999 ($14970.03 in chips) 
Seat 5: tabby20 ($22521.18 in chips) 
Seat 6: DM0507 ($1970 in chips) 
tabby20: posts small blind $50
DM0507: posts big blind $100
*** HOLE CARDS ***
Dealt to Lucifer999 [6h 6d]
Lucifer999: raises $250.00 to $350
tabby20: folds
DM0507: raises $750.00 to $1100
Lucifer999: raises $13870.03 to $14970.03
DM0507: calls $870
Uncalled bet ($13000.03) returned to Lucifer999
*** FLOP *** [3c 2c Qs]
*** FLOP *** [Qh 8c Td]
*** TURN *** [3c 2c Qs] [8s]
*** TURN *** [3c 2c Qs] [Jd]
*** RIVER *** [3c 2c Qs 8s] [5s]
*** RIVER *** [3c 2c Qs 8s] [5d]
*** SHOW DOWN ***
Lucifer999: shows [6h 6d] (Pair, 66)
DM0507: shows [Kd Ac] (Straight, A-T)
Lucifer999 collected $1907.22 from pot
DM0507 collected $1907.22 from pot
*** SUMMARY ***
Total pot $3990.00 | Rake $175.56
Board [3c 2c Qs 8s 5s]
Seat 1: Lucifer999  (button) showed [6h 6d] and won ($1907.22) with Pair, 66
Seat 5: tabby20 (small blind) folded before Flop
Seat 6: DM0507  (big blind) showed [Kd Ac] and won ($1907.22) with Straight, A-T



PokerStars Game #00327532814: Hold'em No Limit ($50/$100 USD) - 2022/04/30 10:06:57 ET
Table 'Hold'em (Min 25KMax 10K)    69' 6-max Seat #5 is the button
Seat 1: Lucifer999 ($14907.25 in chips) 
Seat 5: tabby20 ($22471.18 in chips) 
Seat 6: DM0507 ($1907.22 in chips) 
DM0507: posts small blind $50
Lucifer999: posts big blind $100
*** HOLE CARDS ***
Dealt to Lucifer999 [3s Td]
tabby20: folds
DM0507: folds
Uncalled bet ($50) returned to Lucifer999
Lucifer999: doesn't show hand
Lucifer999 collected $100 from pot
*** SUMMARY ***
Total pot $100.00 | Rake $0
Board []
Seat 1: Lucifer999 (big blind) collected ($100)
Seat 5: tabby20 (button) folded before Flop (didn't bet)
Seat 6: DM0507 (small blind) folded before Flop



PokerStars Game #00327532719: Hold'em No Limit ($10/$25 USD) - 2022/04/30 10:06:29 ET
Table 'Hold'em (Min 500Max 2500)  1282' 6-max Seat #4 is the button
Seat 1: frostbyte28 ($2909.25 in chips) 
Seat 2: jayakumar2020 ($395 in chips) 
Seat 3: PANCHYOU ($977.74 in chips) 
Seat 4: papadickkies ($1057.55 in chips) 
Seat 5: Lucifer999 ($4950.02 in chips) 
Seat 6: devi7 ($3005.88 in chips) 
Lucifer999: posts small blind $10
devi7: posts big blind $25
*** HOLE CARDS ***
Dealt to Lucifer999 [8c 3s]
frostbyte28: calls $25
jayakumar2020: folds
PANCHYOU: folds
papadickkies: folds
Lucifer999: folds
devi7: checks
*** FLOP *** [Ah 7h 4s]
devi7: checks
frostbyte28: checks
*** TURN *** [Ah 7h 4s] [4h]
devi7: bets $50
frostbyte28: calls $50
*** RIVER *** [Ah 7h 4s 4h] [9c]
devi7: checks
frostbyte28: checks
*** SHOW DOWN ***
devi7: shows [5h 7s] (Two pairs, 7744)
frostbyte28: shows [Jd 7d] (Two pairs, 7744)
devi7 collected $75.3 from pot
frostbyte28 collected $75.3 from pot
*** SUMMARY ***
Total pot $160.00 | Rake $9.4
Board [Ah 7h 4s 4h 9c]
Seat 1: frostbyte28  showed [Jd 7d] and won ($75.3) with Two pairs, 7744
Seat 2: jayakumar2020 folded before Flop (didn't bet)
Seat 3: PANCHYOU folded before Flop (didn't bet)
Seat 4: papadickkies (button) folded before Flop (didn't bet)
Seat 5: Lucifer999 (small blind) folded before Flop
Seat 6: devi7  (big blind) showed [5h 7s] and won ($75.3) with Two pairs, 7744



PokerStars Game #00327532890: Hold'em No Limit ($10/$25 USD) - 2022/04/30 10:07:16 ET
Table 'Hold'em (Min 500Max 2500)  1282' 6-max Seat #5 is the button
Seat 1: frostbyte28 ($2909.55 in chips) 
Seat 2: jayakumar2020 ($395 in chips) 
Seat 3: PANCHYOU ($977.74 in chips) 
Seat 4: papadickkies ($1057.55 in chips) 
Seat 5: Lucifer999 ($4940.02 in chips) 
Seat 6: devi7 ($3006.18 in chips) 
devi7: posts small blind $10
frostbyte28: posts big blind $25
*** HOLE CARDS ***
Dealt to Lucifer999 [Jd Th]
jayakumar2020: folds
PANCHYOU: raises $55.00 to $80
papadickkies: folds
Lucifer999: folds
devi7: folds
frostbyte28: folds
Uncalled bet ($55) returned to PANCHYOU
PANCHYOU: doesn't show hand
PANCHYOU collected $60 from pot
*** SUMMARY ***
Total pot $60.00 | Rake $0
Board []
Seat 1: frostbyte28 (big blind) folded before Flop
Seat 2: jayakumar2020 folded before Flop (didn't bet)
Seat 3: PANCHYOU collected ($60)
Seat 4: papadickkies folded before Flop (didn't bet)
Seat 5: Lucifer999 (button) folded before Flop (didn't bet)
Seat 6: devi7 (small blind) folded before Flop



PokerStars Game #00327532778: Hold'em No Limit ($10/$25 USD) - 2022/04/30 10:06:45 ET
Table 'Hold'em (Min 500Max 2500) 1001' 6-max Seat #5 is the button
Seat 1: JaspritBumrah786 ($2025 in chips) 
Seat 2: fishfry123 ($1330.48 in chips) 
Seat 3: allthebest ($2488.3 in chips) 
Seat 4: devi7 ($2361.25 in chips) 
Seat 5: Lucifer999 ($4988.66 in chips) 
Seat 6: spidy02 ($3622.68 in chips) 
spidy02: posts small blind $10
JaspritBumrah786: posts big blind $25
*** HOLE CARDS ***
Dealt to Lucifer999 [2c Jd]
fishfry123: calls $25
allthebest: folds
devi7: folds
Lucifer999: folds
spidy02: raises $75.00 to $100
JaspritBumrah786: calls $75
fishfry123: calls $75
*** FLOP *** [9c 9d 8c]
spidy02: bets $210.94
JaspritBumrah786: calls $210.94
fishfry123: folds
*** TURN *** [9c 9d 8c] [5d]
spidy02: checks
JaspritBumrah786: checks
*** RIVER *** [9c 9d 8c 5d] [3d]
spidy02: checks
JaspritBumrah786: bets $475
spidy02: calls $475
*** SHOW DOWN ***
JaspritBumrah786: shows [Qh Th] (Pair, 99)
spidy02: shows [Qc Qs] (Two pairs, QQ99)
spidy02 collected $1579.16 from pot
*** SUMMARY ***
Total pot $1671.88 | Rake $92.72
Board [9c 9d 8c 5d 3d]
Seat 1: JaspritBumrah786 (big blind) showed [Qh Th] and lost with Pair, 99
Seat 2: fishfry123 folded on the Flop
Seat 3: allthebest folded before Flop (didn't bet)
Seat 4: devi7 folded before Flop (didn't bet)
Seat 5: Lucifer999 (button) folded before Flop (didn't bet)
Seat 6: spidy02  (small blind) showed [Qc Qs] and won ($1579.16) with Two pairs, QQ99



PokerStars Game #00327532851: Hold'em No Limit ($50/$100 USD) - 2022/04/30 10:07:07 ET
Table 'Hold'em (Min 25KMax 10K)    69' 6-max Seat #6 is the button
Seat 1: Lucifer999 ($14957.25 in chips) 
Seat 5: tabby20 ($22471.18 in chips) 
Seat 6: DM0507 ($1857.22 in chips) 
Lucifer999: posts small blind $50
tabby20: posts big blind $100
*** HOLE CARDS ***
Dealt to Lucifer999 [8d 9c]
DM0507: calls $100
Lucifer999: calls $50
tabby20: checks
*** FLOP *** [9s 5d Kc]
Lucifer999: checks
tabby20: bets $200
DM0507: folds
Lucifer999: calls $200
*** TURN *** [9s 5d Kc] [Ac]
Lucifer999: checks
tabby20: bets $550
Lucifer999: folds
Uncalled bet ($550) returned to tabby20
tabby20: doesn't show hand
tabby20 collected $669.2 from pot
*** SUMMARY ***
Total pot $700.00 | Rake $30.8
Board [9s 5d Kc Ac]
Seat 1: Lucifer999 (small blind) folded on the Turn
Seat 5: tabby20 (big blind) collected ($669.2)
Seat 6: DM0507 (button) folded on the Flop



PokerStars Game #00327532986: Hold'em No Limit ($50/$100 USD) - 2022/04/30 10:07:50 ET
Table 'Hold'em (Min 25KMax 10K)    69' 6-max Seat #1 is the button
Seat 1: Lucifer999 ($14657.25 in chips) 
Seat 5: tabby20 ($22840.38 in chips) 
Seat 6: DM0507 ($1757.22 in chips) 
tabby20: posts small blind $50
DM0507: posts big blind $100
*** HOLE CARDS ***
Dealt to Lucifer999 [4d 2c]
Lucifer999: folds
tabby20: folds
Uncalled bet ($50) returned to DM0507
DM0507: doesn't show hand
DM0507 collected $100 from pot
*** SUMMARY ***
Total pot $100.00 | Rake $0
Board []
Seat 1: Lucifer999 (button) folded before Flop (didn't bet)
Seat 5: tabby20 (small blind) folded before Flop
Seat 6: DM0507 (big blind) collected ($100)



PokerStars Game #00327532972: Hold'em No Limit ($10/$25 USD) - 2022/04/30 10:07:45 ET
Table 'Hold'em (Min 500Max 2500)  1282' 6-max Seat #6 is the button
Seat 1: frostbyte28 ($2884.55 in chips) 
Seat 2: jayakumar2020 ($395 in chips) 
Seat 3: PANCHYOU ($1012.74 in chips) 
Seat 4: papadickkies ($1057.55 in chips) 
Seat 5: Lucifer999 ($4940.02 in chips) 
Seat 6: devi7 ($2996.18 in chips) 
frostbyte28: posts small blind $10
jayakumar2020: posts big blind $25
*** HOLE CARDS ***
Dealt to Lucifer999 [Ac 6h]
PANCHYOU: folds
papadickkies: raises $30.00 to $55
Lucifer999: folds
devi7: folds
frostbyte28: folds
jayakumar2020: folds
Uncalled bet ($30) returned to papadickkies
papadickkies: doesn't show hand
papadickkies collected $60 from pot
*** SUMMARY ***
Total pot $60.00 | Rake $0
Board []
Seat 1: frostbyte28 (small blind) folded before Flop
Seat 2: jayakumar2020 (big blind) folded before Flop
Seat 3: PANCHYOU folded before Flop (didn't bet)
Seat 4: papadickkies collected ($60)
Seat 5: Lucifer999 folded before Flop (didn't bet)
Seat 6: devi7 (button) folded before Flop (didn't bet)



PokerStars Game #00327532817: Hold'em No Limit ($25/$50 USD) - 2022/04/30 10:06:58 ET
Table 'Hold'em (Min 1K Max 5K)   216' 6-max Seat #4 is the button
Seat 1: Lucifer999 ($14215.53 in chips) 
Seat 2: rahulh1 ($4269.76 in chips) 
Seat 3: bettercall7208 ($6781.73 in chips) 
Seat 4: No username ($4582.43 in chips) 
Seat 5: Avaroni ($6323.44 in chips) 
Seat 6: Pablit0 ($936.25 in chips) 
Avaroni: posts small blind $25
Pablit0: posts big blind $50
*** HOLE CARDS ***
Dealt to Lucifer999 [Qh Tc]
Lucifer999: folds
rahulh1: calls $50
bettercall7208: folds
No username: raises $118.75 to $168.75
Avaroni: calls $143.75
Pablit0: folds
rahulh1: folds
*** FLOP *** [Jh 5d Js]
Avaroni: checks
No username: checks
*** TURN *** [Jh 5d Js] [3c]
Avaroni: checks
No username: bets $152.03
Avaroni: raises $283.84 to $435.87
No username: calls $283.84
*** RIVER *** [Jh 5d Js 3c] [4d]
Avaroni: bets $800
No username: calls $800
*** SHOW DOWN ***
Avaroni: shows [Jd Qd] (Three of a kind, JJJ)
No username: doesn't show hand
Avaroni collected $2763.79 from pot
*** SUMMARY ***
Total pot $2909.24 | Rake $145.45
Board [Jh 5d Js 3c 4d]
Seat 1: Lucifer999 folded before Flop (didn't bet)
Seat 2: rahulh1 folded before Flop
Seat 3: bettercall7208 folded before Flop (didn't bet)
Seat 4: No username (button) mucked
Seat 5: Avaroni  (small blind) showed [Jd Qd] and won ($2763.79) with Three of a kind, JJJ
Seat 6: Pablit0 (big blind) folded before Flop



PokerStars Game #00327532968: Hold'em No Limit ($10/$25 USD) - 2022/04/30 10:07:45 ET
Table 'Hold'em (Min 500Max 2500) 1001' 6-max Seat #6 is the button
Seat 1: JaspritBumrah786 ($1339.06 in chips) 
Seat 2: fishfry123 ($1230.48 in chips) 
Seat 3: allthebest ($2488.3 in chips) 
Seat 4: devi7 ($2361.25 in chips) 
Seat 5: Lucifer999 ($4988.66 in chips) 
Seat 6: spidy02 ($4415.9 in chips) 
JaspritBumrah786: posts small blind $10
fishfry123: posts big blind $25
*** HOLE CARDS ***
Dealt to Lucifer999 [7s 2d]
allthebest: folds
devi7: raises $50.00 to $75
Lucifer999: folds
spidy02: calls $75
JaspritBumrah786: folds
fishfry123: folds
*** FLOP *** [Ts 8s 9c]
devi7: checks
spidy02: bets $130.72
devi7: folds
Uncalled bet ($130.72) returned to spidy02
spidy02: doesn't show hand
spidy02 collected $174.29 from pot
*** SUMMARY ***
Total pot $185.00 | Rake $10.71
Board [Ts 8s 9c]
Seat 1: JaspritBumrah786 (small blind) folded before Flop
Seat 2: fishfry123 (big blind) folded before Flop
Seat 3: allthebest folded before Flop (didn't bet)
Seat 4: devi7 folded on the Flop
Seat 5: Lucifer999 folded before Flop (didn't bet)
Seat 6: spidy02 (button) collected ($174.29)



PokerStars Game #00327533059: Hold'em No Limit ($25/$50 USD) - 2022/04/30 10:08:14 ET
Table 'Hold'em (Min 1K Max 5K)   216' 6-max Seat #5 is the button
Seat 1: Lucifer999 ($14215.53 in chips) 
Seat 2: rahulh1 ($4219.76 in chips) 
Seat 3: bettercall7208 ($6781.73 in chips) 
Seat 4: No username ($3177.81 in chips) 
Seat 5: Avaroni ($7682.61 in chips) 
Seat 6: Pablit0 ($886.25 in chips) 
Pablit0: posts small blind $25
Lucifer999: posts big blind $50
*** HOLE CARDS ***
Dealt to Lucifer999 [6h Ad]
rahulh1: folds
bettercall7208: folds
No username: folds
Avaroni: raises $100.00 to $150
Pablit0: folds
Lucifer999: folds
Uncalled bet ($100) returned to Avaroni
Avaroni: doesn't show hand
Avaroni collected $125 from pot
*** SUMMARY ***
Total pot $125.00 | Rake $0
Board []
Seat 1: Lucifer999 (big blind) folded before Flop
Seat 2: rahulh1 folded before Flop (didn't bet)
Seat 3: bettercall7208 folded before Flop (didn't bet)
Seat 4: No username folded before Flop (didn't bet)
Seat 5: Avaroni (button) collected ($125)
Seat 6: Pablit0 (small blind) folded before Flop



PokerStars Game #00327533053: Hold'em No Limit ($50/$100 USD) - 2022/04/30 10:08:11 ET
Table 'Hold'em (Min 25KMax 10K)    69' 6-max Seat #5 is the button
Seat 1: Lucifer999 ($14657.25 in chips) 
Seat 5: tabby20 ($22790.38 in chips) 
Seat 6: DM0507 ($1807.22 in chips) 
DM0507: posts small blind $50
Lucifer999: posts big blind $100
*** HOLE CARDS ***
Dealt to Lucifer999 [Tc Js]
tabby20: folds
DM0507: calls $50
Lucifer999: raises $300.00 to $400
DM0507: calls $300
*** FLOP *** [Ah 4h 7d]
DM0507: checks
Lucifer999: checks
*** TURN *** [Ah 4h 7d] [3d]
DM0507: checks
Lucifer999: checks
*** RIVER *** [Ah 4h 7d 3d] [Ts]
DM0507: checks
Lucifer999: checks
*** SHOW DOWN ***
Lucifer999: shows [Tc Js] (Pair, TT)
DM0507: doesn't show hand
Lucifer999 collected $764.8 from pot
*** SUMMARY ***
Total pot $800.00 | Rake $35.2
Board [Ah 4h 7d 3d Ts]
Seat 1: Lucifer999  (big blind) showed [Tc Js] and won ($764.8) with Pair, TT
Seat 5: tabby20 (button) folded before Flop (didn't bet)
Seat 6: DM0507 (small blind) mucked



PokerStars Game #00327533101: Hold'em No Limit ($10/$25 USD) - 2022/04/30 10:08:26 ET
Table 'Hold'em (Min 500Max 2500) 1001' 6-max Seat #1 is the button
Seat 1: JaspritBumrah786 ($2025 in chips) 
Seat 2: fishfry123 ($1205.48 in chips) 
Seat 3: allthebest ($2488.3 in chips) 
Seat 4: devi7 ($2286.25 in chips) 
Seat 5: Lucifer999 ($4988.66 in chips) 
Seat 6: spidy02 ($4515.19 in chips) 
fishfry123: posts small blind $10
allthebest: posts big blind $25
*** HOLE CARDS ***
Dealt to Lucifer999 [4d Ks]
devi7: folds
Lucifer999: folds
spidy02: calls $25
JaspritBumrah786: folds
fishfry123: calls $15
allthebest: raises $100.00 to $125
spidy02: folds
fishfry123: folds
Uncalled bet ($100) returned to allthebest
allthebest: doesn't show hand
allthebest collected $75 from pot
*** SUMMARY ***
Total pot $75.00 | Rake $0
Board []
Seat 1: JaspritBumrah786 (button) folded before Flop (didn't bet)
Seat 2: fishfry123 (small blind) folded before Flop
Seat 3: allthebest (big blind) collected ($75)
Seat 4: devi7 folded before Flop (didn't bet)
Seat 5: Lucifer999 folded before Flop (didn't bet)
Seat 6: spidy02 folded before Flop



PokerStars Game #00327533062: Hold'em No Limit ($10/$25 USD) - 2022/04/30 10:08:14 ET
Table 'Hold'em (Min 500Max 2500)  1282' 6-max Seat #1 is the button
Seat 1: frostbyte28 ($2874.55 in chips) 
Seat 2: jayakumar2020 ($370 in chips) 
Seat 3: PANCHYOU ($1012.74 in chips) 
Seat 4: papadickkies ($1092.55 in chips) 
Seat 5: Lucifer999 ($4940.02 in chips) 
Seat 6: devi7 ($2996.18 in chips) 
jayakumar2020: posts small blind $10
papadickkies: posts big blind $25
*** HOLE CARDS ***
Dealt to Lucifer999 [5c 5s]
Lucifer999: folds
devi7: folds
frostbyte28: calls $25
jayakumar2020: folds
papadickkies: checks
*** FLOP *** [4c 3s 2h]
papadickkies: checks
frostbyte28: checks
*** TURN *** [4c 3s 2h] [3c]
papadickkies: checks
frostbyte28: checks
*** RIVER *** [4c 3s 2h 3c] [7c]
papadickkies: checks
frostbyte28: checks
*** SHOW DOWN ***
papadickkies: shows [9s 6h] (Pair, 33)
frostbyte28: shows [Qd Jc] (Pair, 33)
frostbyte28 collected $56.85 from pot
*** SUMMARY ***
Total pot $60.00 | Rake $3.15
Board [4c 3s 2h 3c 7c]
Seat 1: frostbyte28  (button) showed [Qd Jc] and won ($56.85) with Pair, 33
Seat 2: jayakumar2020 (small blind) folded before Flop
Seat 4: papadickkies (big blind) showed [9s 6h] and lost with Pair, 33
Seat 5: Lucifer999 folded before Flop (didn't bet)
Seat 6: devi7 folded before Flop (didn't bet)



PokerStars Game #00327533191: Hold'em No Limit ($50/$100 USD) - 2022/04/30 10:08:57 ET
Table 'Hold'em (Min 25KMax 10K)    69' 6-max Seat #6 is the button
Seat 1: Lucifer999 ($15022.05 in chips) 
Seat 5: tabby20 ($22790.38 in chips) 
Seat 6: DM0507 ($1407.22 in chips) 
Lucifer999: posts small blind $50
tabby20: posts big blind $100
*** HOLE CARDS ***
Dealt to Lucifer999 [Qd 5h]
DM0507: raises $250.00 to $350
Lucifer999: folds
tabby20: folds
Uncalled bet ($250) returned to DM0507
DM0507: doesn't show hand
DM0507 collected $250 from pot
*** SUMMARY ***
Total pot $250.00 | Rake $0
Board []
Seat 1: Lucifer999 (small blind) folded before Flop
Seat 5: tabby20 (big blind) folded before Flop
Seat 6: DM0507 (button) collected ($250)



PokerStars Game #00327533208: Hold'em No Limit ($10/$25 USD) - 2022/04/30 10:09:04 ET
Table 'Hold'em (Min 500Max 2500) 1001' 6-max Seat #2 is the button
Seat 1: JaspritBumrah786 ($2025 in chips) 
Seat 2: fishfry123 ($1180.48 in chips) 
Seat 3: allthebest ($2538.3 in chips) 
Seat 4: devi7 ($2286.25 in chips) 
Seat 5: Lucifer999 ($4988.66 in chips) 
Seat 6: spidy02 ($4490.19 in chips) 
allthebest: posts small blind $10
devi7: posts big blind $25
*** HOLE CARDS ***
Dealt to Lucifer999 [Kd 8d]
Lucifer999: folds
spidy02: folds
JaspritBumrah786: folds
fishfry123: folds
allthebest: folds
Uncalled bet ($15) returned to devi7
devi7: doesn't show hand
devi7 collected $20 from pot
*** SUMMARY ***
Total pot $20.00 | Rake $0
Board []
Seat 1: JaspritBumrah786 folded before Flop (didn't bet)
Seat 2: fishfry123 (button) folded before Flop (didn't bet)
Seat 3: allthebest (small blind) folded before Flop
Seat 4: devi7 (big blind) collected ($20)
Seat 5: Lucifer999 folded before Flop (didn't bet)
Seat 6: spidy02 folded before Flop (didn't bet)



PokerStars Game #00327533138: Hold'em No Limit ($25/$50 USD) - 2022/04/30 10:08:39 ET
Table 'Hold'em (Min 1K Max 5K)   216' 6-max Seat #6 is the button
Seat 1: Lucifer999 ($14165.53 in chips) 
Seat 2: rahulh1 ($4219.76 in chips) 
Seat 3: bettercall7208 ($6781.73 in chips) 
Seat 4: No username ($3177.81 in chips) 
Seat 5: Avaroni ($7757.61 in chips) 
Seat 6: Pablit0 ($861.25 in chips) 
Lucifer999: posts small blind $25
rahulh1: posts big blind $50
*** HOLE CARDS ***
Dealt to Lucifer999 [4d Kc]
bettercall7208: raises $100.00 to $150
No username: folds
Avaroni: raises $450.00 to $600
Pablit0: folds
Lucifer999: folds
rahulh1: folds
bettercall7208: calls $450
*** FLOP *** [4c Jc Kh]
bettercall7208: checks
Avaroni: bets $750
bettercall7208: calls $750
*** TURN *** [4c Jc Kh] [7s]
bettercall7208: checks
Avaroni: checks
*** RIVER *** [4c Jc Kh 7s] [Jd]
bettercall7208: bets $2636.25
Avaroni: folds
Uncalled bet ($2636.25) returned to bettercall7208
bettercall7208: doesn't show hand
bettercall7208 collected $2636.25 from pot
*** SUMMARY ***
Total pot $2775.00 | Rake $138.75
Board [4c Jc Kh 7s Jd]
Seat 1: Lucifer999 (small blind) folded before Flop
Seat 2: rahulh1 (big blind) folded before Flop
Seat 3: bettercall7208 collected ($2636.25)
Seat 4: No username folded before Flop (didn't bet)
Seat 5: Avaroni folded on the River
Seat 6: Pablit0 (button) folded before Flop (didn't bet)



PokerStars Game #00327533291: Hold'em No Limit ($10/$25 USD) - 2022/04/30 10:09:29 ET
Table 'Hold'em (Min 500Max 2500) 1001' 6-max Seat #3 is the button
Seat 1: JaspritBumrah786 ($2025 in chips) 
Seat 2: fishfry123 ($1180.48 in chips) 
Seat 3: allthebest ($2528.3 in chips) 
Seat 4: devi7 ($2296.25 in chips) 
Seat 5: Lucifer999 ($4988.66 in chips) 
Seat 6: spidy02 ($4490.19 in chips) 
devi7: posts small blind $10
Lucifer999: posts big blind $25
*** HOLE CARDS ***
Dealt to Lucifer999 [2h 7d]
spidy02: folds
JaspritBumrah786: folds
fishfry123: folds
allthebest: folds
devi7: folds
Uncalled bet ($15) returned to Lucifer999
Lucifer999: doesn't show hand
Lucifer999 collected $20 from pot
*** SUMMARY ***
Total pot $20.00 | Rake $0
Board []
Seat 1: JaspritBumrah786 folded before Flop (didn't bet)
Seat 2: fishfry123 folded before Flop (didn't bet)
Seat 3: allthebest (button) folded before Flop (didn't bet)
Seat 4: devi7 (small blind) folded before Flop
Seat 5: Lucifer999 (big blind) collected ($20)
Seat 6: spidy02 folded before Flop (didn't bet)



PokerStars Game #00327533255: Hold'em No Limit ($10/$25 USD) - 2022/04/30 10:09:20 ET
Table 'Hold'em (Min 500Max 2500)  1282' 6-max Seat #4 is the button
Seat 1: frostbyte28 ($2906.4 in chips) 
Seat 2: jayakumar2020 ($360 in chips) 
Seat 3: PANCHYOU ($1012.74 in chips) 
Seat 4: papadickkies ($1067.55 in chips) 
Seat 5: Lucifer999 ($4940.02 in chips) 
Seat 6: devi7 ($2996.18 in chips) 
Lucifer999: posts small blind $10
devi7: posts big blind $25
*** HOLE CARDS ***
Dealt to Lucifer999 [8d 3s]
frostbyte28: raises $60.00 to $85
papadickkies: folds
Lucifer999: folds
devi7: folds
Uncalled bet ($60) returned to frostbyte28
frostbyte28: doesn't show hand
frostbyte28 collected $60 from pot
*** SUMMARY ***
Total pot $60.00 | Rake $0
Board []
Seat 1: frostbyte28 collected ($60)
Seat 4: papadickkies (button) folded before Flop (didn't bet)
Seat 5: Lucifer999 (small blind) folded before Flop
Seat 6: devi7 (big blind) folded before Flop



PokerStars Game #00327533251: Hold'em No Limit ($50/$100 USD) - 2022/04/30 10:09:20 ET
Table 'Hold'em (Min 25KMax 10K)    69' 6-max Seat #1 is the button
Seat 1: Lucifer999 ($14972.05 in chips) 
Seat 5: tabby20 ($22690.38 in chips) 
Seat 6: DM0507 ($1557.22 in chips) 
tabby20: posts small blind $50
DM0507: posts big blind $100
*** HOLE CARDS ***
Dealt to Lucifer999 [Kd Jd]
Lucifer999: raises $200.00 to $300
tabby20: folds
DM0507: calls $200
*** FLOP *** [4d 4c Tc]
DM0507: checks
Lucifer999: checks
*** TURN *** [4d 4c Tc] [2c]
DM0507: bets $1257.22
Lucifer999: folds
Uncalled bet ($1257.22) returned to DM0507
DM0507: doesn't show hand
DM0507 collected $621.4 from pot
*** SUMMARY ***
Total pot $650.00 | Rake $28.6
Board [4d 4c Tc 2c]
Seat 1: Lucifer999 (button) folded on the Turn
Seat 5: tabby20 (small blind) folded before Flop
Seat 6: DM0507 (big blind) collected ($621.4)



PokerStars Game #00327533388: Hold'em No Limit ($50/$100 USD) - 2022/04/30 10:09:57 ET
Table 'Hold'em (Min 25KMax 10K)    69' 6-max Seat #5 is the button
Seat 1: Lucifer999 ($14672.05 in chips) 
Seat 5: tabby20 ($22640.38 in chips) 
Seat 6: DM0507 ($1878.62 in chips) 
DM0507: posts small blind $50
Lucifer999: posts big blind $100
*** HOLE CARDS ***
Dealt to Lucifer999 [Ac Qs]
tabby20: raises $200.00 to $300
DM0507: folds
Lucifer999: raises $1000.00 to $1300
tabby20: folds
Uncalled bet ($1000) returned to Lucifer999
Lucifer999: doesn't show hand
Lucifer999 collected $650 from pot
*** SUMMARY ***
Total pot $650.00 | Rake $0
Board []
Seat 1: Lucifer999 (big blind) collected ($650)
Seat 5: tabby20 (button) folded before Flop
Seat 6: DM0507 (small blind) folded before Flop



PokerStars Game #00327533356: Hold'em No Limit ($10/$25 USD) - 2022/04/30 10:09:50 ET
Table 'Hold'em (Min 500Max 2500)  1282' 6-max Seat #5 is the button
Seat 1: frostbyte28 ($2941.4 in chips) 
Seat 2: jayakumar2020 ($360 in chips) 
Seat 3: PANCHYOU ($1012.74 in chips) 
Seat 4: papadickkies ($1067.55 in chips) 
Seat 5: Lucifer999 ($4930.02 in chips) 
Seat 6: devi7 ($2971.18 in chips) 
devi7: posts small blind $10
frostbyte28: posts big blind $25
*** HOLE CARDS ***
Dealt to Lucifer999 [Jh 8s]
papadickkies: calls $25
Lucifer999: folds
devi7: folds
frostbyte28: checks
*** FLOP *** [5s 6c 6h]
frostbyte28: checks
papadickkies: checks
*** TURN *** [5s 6c 6h] [Kh]
frostbyte28: checks
papadickkies: bets $55
frostbyte28: folds
Uncalled bet ($55) returned to papadickkies
papadickkies: doesn't show hand
papadickkies collected $56.85 from pot
*** SUMMARY ***
Total pot $60.00 | Rake $3.15
Board [5s 6c 6h Kh]
Seat 1: frostbyte28 (big blind) folded on the Turn
Seat 4: papadickkies collected ($56.85)
Seat 5: Lucifer999 (button) folded before Flop (didn't bet)
Seat 6: devi7 (small blind) folded before Flop



PokerStars Game #00327533351: Hold'em No Limit ($10/$25 USD) - 2022/04/30 10:09:49 ET
Table 'Hold'em (Min 500Max 2500) 1001' 6-max Seat #4 is the button
Seat 1: JaspritBumrah786 ($2025 in chips) 
Seat 2: fishfry123 ($1180.48 in chips) 
Seat 3: allthebest ($2528.3 in chips) 
Seat 4: devi7 ($2286.25 in chips) 
Seat 5: Lucifer999 ($4998.66 in chips) 
Seat 6: spidy02 ($4490.19 in chips) 
Lucifer999: posts small blind $10
spidy02: posts big blind $25
*** HOLE CARDS ***
Dealt to Lucifer999 [2s Qd]
JaspritBumrah786: folds
fishfry123: calls $25
allthebest: folds
devi7: folds
Lucifer999: folds
spidy02: raises $60.00 to $85
fishfry123: calls $60
*** FLOP *** [9c 8s 3d]
spidy02: bets $84.78
fishfry123: raises $127.17 to $211.95
spidy02: raises $233.14 to $445.09
fishfry123: calls $233.14
*** TURN *** [9c 8s 3d] [4h]
spidy02: bets $504.51
fishfry123: folds
Uncalled bet ($504.51) returned to spidy02
spidy02: doesn't show hand
spidy02 collected $1009.01 from pot
*** SUMMARY ***
Total pot $1070.18 | Rake $61.17
Board [9c 8s 3d 4h]
Seat 1: JaspritBumrah786 folded before Flop (didn't bet)
Seat 2: fishfry123 folded on the Turn
Seat 3: allthebest folded before Flop (didn't bet)
Seat 4: devi7 (button) folded before Flop (didn't bet)
Seat 5: Lucifer999 (small blind) folded before Flop
Seat 6: spidy02 (big blind) collected ($1009.01)



PokerStars Game #00327533477: Hold'em No Limit ($10/$25 USD) - 2022/04/30 10:10:26 ET
Table 'Hold'em (Min 500Max 2500)  1282' 6-max Seat #6 is the button
Seat 1: frostbyte28 ($2916.4 in chips) 
Seat 2: jayakumar2020 ($360 in chips) 
Seat 3: PANCHYOU ($1012.74 in chips) 
Seat 4: papadickkies ($1099.4 in chips) 
Seat 5: Lucifer999 ($4930.02 in chips) 
Seat 6: devi7 ($2961.18 in chips) 
frostbyte28: posts small blind $10
papadickkies: posts big blind $25
*** HOLE CARDS ***
Dealt to Lucifer999 [Th 8d]
Lucifer999: folds
devi7: folds
frostbyte28: folds
Uncalled bet ($15) returned to papadickkies
papadickkies: doesn't show hand
papadickkies collected $20 from pot
*** SUMMARY ***
Total pot $20.00 | Rake $0
Board []
Seat 1: frostbyte28 (small blind) folded before Flop
Seat 4: papadickkies (big blind) collected ($20)
Seat 5: Lucifer999 folded before Flop (didn't bet)
Seat 6: devi7 (button) folded before Flop (didn't bet)



PokerStars Game #00327533456: Hold'em No Limit ($50/$100 USD) - 2022/04/30 10:10:19 ET
Table 'Hold'em (Min 25KMax 10K)    69' 6-max Seat #6 is the button
Seat 1: Lucifer999 ($15022.05 in chips) 
Seat 5: tabby20 ($22340.38 in chips) 
Seat 6: DM0507 ($1828.62 in chips) 
Lucifer999: posts small blind $50
tabby20: posts big blind $100
*** HOLE CARDS ***
Dealt to Lucifer999 [4h 6h]
DM0507: folds
Lucifer999: raises $200.00 to $300
tabby20: calls $200
*** FLOP *** [9s 3d Td]
Lucifer999: checks
tabby20: bets $450
Lucifer999: folds
Uncalled bet ($450) returned to tabby20
tabby20: doesn't show hand
tabby20 collected $573.6 from pot
*** SUMMARY ***
Total pot $600.00 | Rake $26.4
Board [9s 3d Td]
Seat 1: Lucifer999 (small blind) folded on the Flop
Seat 5: tabby20 (big blind) collected ($573.6)
Seat 6: DM0507 (button) folded before Flop (didn't bet)



PokerStars Game #00327533322: Hold'em No Limit ($25/$50 USD) - 2022/04/30 10:09:39 ET
Table 'Hold'em (Min 1K Max 5K)   216' 6-max Seat #1 is the button
Seat 1: Lucifer999 ($14140.53 in chips) 
Seat 2: rahulh1 ($4169.76 in chips) 
Seat 3: bettercall7208 ($8067.98 in chips) 
Seat 4: No username ($3177.81 in chips) 
Seat 5: Avaroni ($6407.61 in chips) 
Seat 6: Pablit0 ($861.25 in chips) 
rahulh1: posts small blind $25
bettercall7208: posts big blind $50
*** HOLE CARDS ***
Dealt to Lucifer999 [4c Jc]
No username: raises $66.67 to $116.67
Avaroni: folds
Pablit0: calls $116.67
Lucifer999: folds
rahulh1: calls $91.67
bettercall7208: calls $66.67
*** FLOP *** [6d 5h 7s]
rahulh1: checks
bettercall7208: checks
No username: checks
Pablit0: checks
*** TURN *** [6d 5h 7s] [3h]
rahulh1: checks
bettercall7208: bets $221.69
No username: folds
Pablit0: folds
rahulh1: folds
Uncalled bet ($221.69) returned to bettercall7208
bettercall7208: doesn't show hand
bettercall7208 collected $443.38 from pot
*** SUMMARY ***
Total pot $466.68 | Rake $23.3
Board [6d 5h 7s 3h]
Seat 1: Lucifer999 (button) folded before Flop (didn't bet)
Seat 2: rahulh1 (small blind) folded on the Turn
Seat 3: bettercall7208 (big blind) collected ($443.38)
Seat 4: No username folded on the Turn
Seat 5: Avaroni folded before Flop (didn't bet)
Seat 6: Pablit0 folded on the Turn



PokerStars Game #00327533550: Hold'em No Limit ($50/$100 USD) - 2022/04/30 10:10:49 ET
Table 'Hold'em (Min 25KMax 10K)    69' 6-max Seat #1 is the button
Seat 1: Lucifer999 ($14722.05 in chips) 
Seat 5: tabby20 ($22613.98 in chips) 
Seat 6: DM0507 ($1828.62 in chips) 
tabby20: posts small blind $50
DM0507: posts big blind $100
*** HOLE CARDS ***
Dealt to Lucifer999 [Tc Kd]
Lucifer999: folds
tabby20: folds
Uncalled bet ($50) returned to DM0507
DM0507: doesn't show hand
DM0507 collected $100 from pot
*** SUMMARY ***
Total pot $100.00 | Rake $0
Board []
Seat 1: Lucifer999 (button) folded before Flop (didn't bet)
Seat 5: tabby20 (small blind) folded before Flop
Seat 6: DM0507 (big blind) collected ($100)



PokerStars Game #00327533523: Hold'em No Limit ($10/$25 USD) - 2022/04/30 10:10:42 ET
Table 'Hold'em (Min 500Max 2500) 1001' 6-max Seat #5 is the button
Seat 1: JaspritBumrah786 ($2025 in chips) 
Seat 2: fishfry123 ($650.39 in chips) 
Seat 3: allthebest ($2528.3 in chips) 
Seat 4: devi7 ($2286.25 in chips) 
Seat 5: Lucifer999 ($4988.66 in chips) 
Seat 6: spidy02 ($4969.11 in chips) 
spidy02: posts small blind $10
JaspritBumrah786: posts big blind $25
*** HOLE CARDS ***
Dealt to Lucifer999 [Kh 4s]
fishfry123: raises $60.00 to $85
allthebest: folds
devi7: folds
Lucifer999: folds
spidy02: folds
JaspritBumrah786: folds
Uncalled bet ($60) returned to fishfry123
fishfry123: doesn't show hand
fishfry123 collected $60 from pot
*** SUMMARY ***
Total pot $60.00 | Rake $0
Board []
Seat 1: JaspritBumrah786 (big blind) folded before Flop
Seat 2: fishfry123 collected ($60)
Seat 3: allthebest folded before Flop (didn't bet)
Seat 4: devi7 folded before Flop (didn't bet)
Seat 5: Lucifer999 (button) folded before Flop (didn't bet)
Seat 6: spidy02 (small blind) folded before Flop



PokerStars Game #00327533545: Hold'em No Limit ($10/$25 USD) - 2022/04/30 10:10:47 ET
Table 'Hold'em (Min 500Max 2500)  1282' 6-max Seat #1 is the button
Seat 1: frostbyte28 ($2906.4 in chips) 
Seat 2: jayakumar2020 ($360 in chips) 
Seat 3: PANCHYOU ($1012.74 in chips) 
Seat 4: papadickkies ($1109.4 in chips) 
Seat 5: Lucifer999 ($4930.02 in chips) 
Seat 6: devi7 ($2961.18 in chips) 
papadickkies: posts small blind $10
Lucifer999: posts big blind $25
*** HOLE CARDS ***
Dealt to Lucifer999 [Qc Jc]
devi7: raises $50.00 to $75
frostbyte28: calls $75
papadickkies: folds
Lucifer999: raises $305.00 to $380
devi7: folds
frostbyte28: folds
Uncalled bet ($305) returned to Lucifer999
Lucifer999: doesn't show hand
Lucifer999 collected $235 from pot
*** SUMMARY ***
Total pot $235.00 | Rake $0
Board []
Seat 1: frostbyte28 (button) folded before Flop
Seat 4: papadickkies (small blind) folded before Flop
Seat 5: Lucifer999 (big blind) collected ($235)
Seat 6: devi7 folded before Flop



PokerStars Game #00327533576: Hold'em No Limit ($25/$50 USD) - 2022/04/30 10:10:57 ET
Table 'Hold'em (Min 1K Max 5K)   216' 6-max Seat #2 is the button
Seat 1: Lucifer999 ($14140.53 in chips) 
Seat 2: rahulh1 ($4053.09 in chips) 
Seat 3: bettercall7208 ($8394.69 in chips) 
Seat 4: No username ($3061.14 in chips) 
Seat 5: Avaroni ($6407.61 in chips) 
Seat 6: Pablit0 ($744.58 in chips) 
bettercall7208: posts small blind $25
No username: posts big blind $50
*** HOLE CARDS ***
Dealt to Lucifer999 [Qs 2c]
Avaroni: folds
Pablit0: folds
Lucifer999: folds
rahulh1: folds
bettercall7208: raises $58.33 to $108.33
No username: calls $58.33
*** FLOP *** [4c 2d 8d]
bettercall7208: bets $102.93
No username: raises $154.40 to $257.33
bettercall7208: calls $154.4
*** TURN *** [4c 2d 8d] [Qd]
bettercall7208: checks
No username: bets $496.08
bettercall7208: folds
Uncalled bet ($496.08) returned to No username
No username: doesn't show hand
No username collected $694.77 from pot
*** SUMMARY ***
Total pot $731.32 | Rake $36.55
Board [4c 2d 8d Qd]
Seat 1: Lucifer999 folded before Flop (didn't bet)
Seat 2: rahulh1 (button) folded before Flop (didn't bet)
Seat 3: bettercall7208 (small blind) folded on the Turn
Seat 4: No username (big blind) collected ($694.77)
Seat 5: Avaroni folded before Flop (didn't bet)
Seat 6: Pablit0 folded before Flop (didn't bet)



PokerStars Game #00327533614: Hold'em No Limit ($50/$100 USD) - 2022/04/30 10:11:09 ET
Table 'Hold'em (Min 25KMax 10K)    69' 6-max Seat #5 is the button
Seat 1: Lucifer999 ($14722.05 in chips) 
Seat 5: tabby20 ($22563.98 in chips) 
Seat 6: DM0507 ($1878.62 in chips) 
DM0507: posts small blind $50
Lucifer999: posts big blind $100
*** HOLE CARDS ***
Dealt to Lucifer999 [Kd 7h]
tabby20: folds
DM0507: calls $50
Lucifer999: raises $300.00 to $400
DM0507: calls $300
*** FLOP *** [As 4s 6h]
DM0507: checks
Lucifer999: checks
*** TURN *** [As 4s 6h] [Js]
DM0507: checks
Lucifer999: checks
*** RIVER *** [As 4s 6h Js] [Qh]
DM0507: checks
Lucifer999: checks
*** SHOW DOWN ***
Lucifer999: shows [Kd 7h] (High card, A)
DM0507: shows [8h Jc] (Pair, JJ)
DM0507 collected $764.8 from pot
*** SUMMARY ***
Total pot $800.00 | Rake $35.2
Board [As 4s 6h Js Qh]
Seat 1: Lucifer999 (big blind) showed [Kd 7h] and lost with High card, A
Seat 5: tabby20 (button) folded before Flop (didn't bet)
Seat 6: DM0507  (small blind) showed [8h Jc] and won ($764.8) with Pair, JJ



PokerStars Game #00327533672: Hold'em No Limit ($10/$25 USD) - 2022/04/30 10:11:27 ET
Table 'Hold'em (Min 500Max 2500)  1282' 6-max Seat #4 is the button
Seat 1: frostbyte28 ($2831.4 in chips) 
Seat 2: jayakumar2020 ($360 in chips) 
Seat 3: PANCHYOU ($1012.74 in chips) 
Seat 4: papadickkies ($1099.4 in chips) 
Seat 5: Lucifer999 ($5090.02 in chips) 
Seat 6: devi7 ($2886.18 in chips) 
Lucifer999: posts small blind $10
devi7: posts big blind $25
*** HOLE CARDS ***
Dealt to Lucifer999 [Qh Jc]
frostbyte28: raises $60.00 to $85
papadickkies: folds
Lucifer999: folds
devi7: folds
Uncalled bet ($60) returned to frostbyte28
frostbyte28: doesn't show hand
frostbyte28 collected $60 from pot
*** SUMMARY ***
Total pot $60.00 | Rake $0
Board []
Seat 1: frostbyte28 collected ($60)
Seat 4: papadickkies (button) folded before Flop (didn't bet)
Seat 5: Lucifer999 (small blind) folded before Flop
Seat 6: devi7 (big blind) folded before Flop



PokerStars Game #00327533620: Hold'em No Limit ($10/$25 USD) - 2022/04/30 10:11:11 ET
Table 'Hold'em (Min 500Max 2500) 1001' 6-max Seat #6 is the button
Seat 1: JaspritBumrah786 ($2000 in chips) 
Seat 2: fishfry123 ($685.39 in chips) 
Seat 3: allthebest ($2528.3 in chips) 
Seat 4: devi7 ($2286.25 in chips) 
Seat 5: Lucifer999 ($4988.66 in chips) 
Seat 6: spidy02 ($4959.11 in chips) 
JaspritBumrah786: posts small blind $10
fishfry123: posts big blind $25
*** HOLE CARDS ***
Dealt to Lucifer999 [Ac 8c]
allthebest: raises $50.00 to $75
devi7: folds
Lucifer999: calls $75
spidy02: folds
JaspritBumrah786: folds
fishfry123: calls $50
*** FLOP *** [Ah 9d 9s]
fishfry123: checks
allthebest: bets $150
Lucifer999: calls $150
fishfry123: folds
*** TURN *** [Ah 9d 9s] [4d]
allthebest: checks
Lucifer999: checks
*** RIVER *** [Ah 9d 9s 4d] [Ks]
allthebest: checks
Lucifer999: bets $200
allthebest: folds
Uncalled bet ($200) returned to Lucifer999
Lucifer999: doesn't show hand
Lucifer999 collected $501.92 from pot
*** SUMMARY ***
Total pot $535.00 | Rake $33.08
Board [Ah 9d 9s 4d Ks]
Seat 1: JaspritBumrah786 (small blind) folded before Flop
Seat 2: fishfry123 (big blind) folded on the Flop
Seat 3: allthebest folded on the River
Seat 4: devi7 folded before Flop (didn't bet)
Seat 5: Lucifer999 collected ($501.92)
Seat 6: spidy02 (button) folded before Flop (didn't bet)



PokerStars Game #00327533771: Hold'em No Limit ($10/$25 USD) - 2022/04/30 10:11:56 ET
Table 'Hold'em (Min 500Max 2500)  1282' 6-max Seat #5 is the button
Seat 1: frostbyte28 ($2866.4 in chips) 
Seat 2: jayakumar2020 ($360 in chips) 
Seat 3: PANCHYOU ($1012.74 in chips) 
Seat 4: papadickkies ($1099.4 in chips) 
Seat 5: Lucifer999 ($5080.02 in chips) 
Seat 6: devi7 ($2861.18 in chips) 
devi7: posts small blind $10
frostbyte28: posts big blind $25
*** HOLE CARDS ***
Dealt to Lucifer999 [4d Jh]
papadickkies: folds
Lucifer999: folds
devi7: folds
Uncalled bet ($15) returned to frostbyte28
frostbyte28: doesn't show hand
frostbyte28 collected $20 from pot
*** SUMMARY ***
Total pot $20.00 | Rake $0
Board []
Seat 1: frostbyte28 (big blind) collected ($20)
Seat 4: papadickkies folded before Flop (didn't bet)
Seat 5: Lucifer999 (button) folded before Flop (didn't bet)
Seat 6: devi7 (small blind) folded before Flop



PokerStars Game #00327533765: Hold'em No Limit ($50/$100 USD) - 2022/04/30 10:11:53 ET
Table 'Hold'em (Min 25KMax 10K)    69' 6-max Seat #6 is the button
Seat 1: Lucifer999 ($14322.05 in chips) 
Seat 5: tabby20 ($22563.98 in chips) 
Seat 6: DM0507 ($2243.42 in chips) 
Lucifer999: posts small blind $50
tabby20: posts big blind $100
*** HOLE CARDS ***
Dealt to Lucifer999 [Qc Th]
DM0507: calls $100
Lucifer999: calls $50
tabby20: checks
*** FLOP *** [As Kc 3s]
Lucifer999: bets $300
tabby20: folds
DM0507: calls $300
*** TURN *** [As Kc 3s] [6h]
Lucifer999: bets $300
DM0507: calls $300
*** RIVER *** [As Kc 3s 6h] [8c]
Lucifer999: bets $450
DM0507: raises $1093.42 to $1543.42
Lucifer999: folds
Uncalled bet ($1093.42) returned to DM0507
DM0507: doesn't show hand
DM0507 collected $2294.4 from pot
*** SUMMARY ***
Total pot $2400.00 | Rake $105.6
Board [As Kc 3s 6h 8c]
Seat 1: Lucifer999 (small blind) folded on the River
Seat 5: tabby20 (big blind) folded on the Flop
Seat 6: DM0507 (button) collected ($2294.4)



PokerStars Game #00327533923: Hold'em No Limit ($50/$100 USD) - 2022/04/30 10:12:42 ET
Table 'Hold'em (Min 25KMax 10K)    69' 6-max Seat #1 is the button
Seat 1: Lucifer999 ($13172.05 in chips) 
Seat 5: tabby20 ($22463.98 in chips) 
Seat 6: DM0507 ($3387.82 in chips) 
tabby20: posts small blind $50
DM0507: posts big blind $100
*** HOLE CARDS ***
Dealt to Lucifer999 [5c 7d]
Lucifer999: folds
tabby20: folds
Uncalled bet ($50) returned to DM0507
DM0507: doesn't show hand
DM0507 collected $100 from pot
*** SUMMARY ***
Total pot $100.00 | Rake $0
Board []
Seat 1: Lucifer999 (button) folded before Flop (didn't bet)
Seat 5: tabby20 (small blind) folded before Flop
Seat 6: DM0507 (big blind) collected ($100)



PokerStars Game #00327533767: Hold'em No Limit ($25/$50 USD) - 2022/04/30 10:11:53 ET
Table 'Hold'em (Min 1K Max 5K)   216' 6-max Seat #3 is the button
Seat 1: Lucifer999 ($14140.53 in chips) 
Seat 2: rahulh1 ($4053.09 in chips) 
Seat 3: bettercall7208 ($8029.03 in chips) 
Seat 4: No username ($3390.25 in chips) 
Seat 5: Avaroni ($6407.61 in chips) 
Seat 6: Pablit0 ($744.58 in chips) 
No username: posts small blind $25
Avaroni: posts big blind $50
*** HOLE CARDS ***
Dealt to Lucifer999 [2c 8d]
Pablit0: folds
Lucifer999: folds
rahulh1: folds
bettercall7208: raises $100.00 to $150
No username: folds
Avaroni: folds
Uncalled bet ($100) returned to bettercall7208
bettercall7208: doesn't show hand
bettercall7208 collected $125 from pot
*** SUMMARY ***
Total pot $125.00 | Rake $0
Board []
Seat 1: Lucifer999 folded before Flop (didn't bet)
Seat 2: rahulh1 folded before Flop (didn't bet)
Seat 3: bettercall7208 (button) collected ($125)
Seat 4: No username (small blind) folded before Flop
Seat 5: Avaroni (big blind) folded before Flop
Seat 6: Pablit0 folded before Flop (didn't bet)



PokerStars Game #00327533978: Hold'em No Limit ($50/$100 USD) - 2022/04/30 10:13:00 ET
Table 'Hold'em (Min 25KMax 10K)    69' 6-max Seat #5 is the button
Seat 1: Lucifer999 ($13172.05 in chips) 
Seat 5: tabby20 ($22413.98 in chips) 
Seat 6: DM0507 ($3437.82 in chips) 
DM0507: posts small blind $50
Lucifer999: posts big blind $100
*** HOLE CARDS ***
Dealt to Lucifer999 [9c 5h]
tabby20: folds
DM0507: folds
Uncalled bet ($50) returned to Lucifer999
Lucifer999: doesn't show hand
Lucifer999 collected $100 from pot
*** SUMMARY ***
Total pot $100.00 | Rake $0
Board []
Seat 1: Lucifer999 (big blind) collected ($100)
Seat 5: tabby20 (button) folded before Flop (didn't bet)
Seat 6: DM0507 (small blind) folded before Flop



PokerStars Game #00327533886: Hold'em No Limit ($10/$25 USD) - 2022/04/30 10:12:32 ET
Table 'Hold'em (Min 500Max 2500)  1282' 6-max Seat #6 is the button
Seat 1: frostbyte28 ($2876.4 in chips) 
Seat 2: jayakumar2020 ($360 in chips) 
Seat 3: PANCHYOU ($1012.74 in chips) 
Seat 4: papadickkies ($1099.4 in chips) 
Seat 5: Lucifer999 ($5080.02 in chips) 
Seat 6: devi7 ($2851.18 in chips) 
frostbyte28: posts small blind $10
papadickkies: posts big blind $25
*** HOLE CARDS ***
Dealt to Lucifer999 [4d Td]
Lucifer999: folds
devi7: folds
frostbyte28: raises $50.00 to $75
papadickkies: calls $50
*** FLOP *** [Kh 9h 6s]
frostbyte28: checks
papadickkies: checks
*** TURN *** [Kh 9h 6s] [Tc]
frostbyte28: bets $70.57
papadickkies: raises $105.85 to $176.42
frostbyte28: calls $105.85
*** RIVER *** [Kh 9h 6s Tc] [Th]
frostbyte28: checks
papadickkies: bets $353.62
frostbyte28: calls $353.62
*** SHOW DOWN ***
papadickkies: shows [Jd Qd] (Straight, K-9)
frostbyte28: doesn't show hand
papadickkies collected $1141.56 from pot
*** SUMMARY ***
Total pot $1210.08 | Rake $68.52
Board [Kh 9h 6s Tc Th]
Seat 1: frostbyte28 (small blind) mucked
Seat 4: papadickkies  (big blind) showed [Jd Qd] and won ($1141.56) with Straight, K-9
Seat 5: Lucifer999 folded before Flop (didn't bet)
Seat 6: devi7 (button) folded before Flop (didn't bet)



PokerStars Game #00327534003: Hold'em No Limit ($50/$100 USD) - 2022/04/30 10:13:09 ET
Table 'Hold'em (Min 25KMax 10K)    69' 6-max Seat #6 is the button
Seat 1: Lucifer999 ($13222.05 in chips) 
Seat 5: tabby20 ($22413.98 in chips) 
Seat 6: DM0507 ($3387.82 in chips) 
Lucifer999: posts small blind $50
tabby20: posts big blind $100
*** HOLE CARDS ***
Dealt to Lucifer999 [9c 4d]
DM0507: calls $100
Lucifer999: folds
tabby20: checks
*** FLOP *** [Th Jc Kd]
tabby20: checks
DM0507: checks
*** TURN *** [Th Jc Kd] [9h]
tabby20: bets $200
DM0507: raises $3087.82 to $3287.82
tabby20: folds
Uncalled bet ($3087.82) returned to DM0507
DM0507: doesn't show hand
DM0507 collected $621.4 from pot
*** SUMMARY ***
Total pot $650.00 | Rake $28.6
Board [Th Jc Kd 9h]
Seat 1: Lucifer999 (small blind) folded before Flop
Seat 5: tabby20 (big blind) folded on the Turn
Seat 6: DM0507 (button) collected ($621.4)



PokerStars Game #00327533982: Hold'em No Limit ($25/$50 USD) - 2022/04/30 10:13:02 ET
Table 'Hold'em (Min 1K Max 5K)   216' 6-max Seat #4 is the button
Seat 1: Lucifer999 ($14140.53 in chips) 
Seat 2: rahulh1 ($4053.09 in chips) 
Seat 3: bettercall7208 ($8104.03 in chips) 
Seat 4: No username ($3365.25 in chips) 
Seat 6: Pablit0 ($744.58 in chips) 
Pablit0: posts small blind $25
Lucifer999: posts big blind $50
*** HOLE CARDS ***
Dealt to Lucifer999 [Kh 2s]
rahulh1: calls $50
bettercall7208: folds
No username: folds
Pablit0: calls $25
Lucifer999: checks
*** FLOP *** [Qs 2d 3c]
Pablit0: checks
Lucifer999: checks
rahulh1: checks
*** TURN *** [Qs 2d 3c] [Jc]
Pablit0: checks
Lucifer999: bets $150
rahulh1: folds
Pablit0: folds
Uncalled bet ($150) returned to Lucifer999
Lucifer999: doesn't show hand
Lucifer999 collected $142.5 from pot
*** SUMMARY ***
Total pot $150.00 | Rake $7.5
Board [Qs 2d 3c Jc]
Seat 1: Lucifer999 (big blind) collected ($142.5)
Seat 2: rahulh1 folded on the Turn
Seat 3: bettercall7208 folded before Flop (didn't bet)
Seat 4: No username (button) folded before Flop (didn't bet)
Seat 6: Pablit0 (small blind) folded on the Turn



PokerStars Game #00327534117: Hold'em No Limit ($50/$100 USD) - 2022/04/30 10:13:47 ET
Table 'Hold'em (Min 25KMax 10K)    69' 6-max Seat #1 is the button
Seat 1: Lucifer999 ($13172.05 in chips) 
Seat 5: tabby20 ($22113.98 in chips) 
Seat 6: DM0507 ($3709.22 in chips) 
tabby20: posts small blind $50
DM0507: posts big blind $100
*** HOLE CARDS ***
Dealt to Lucifer999 [5s Qc]
Lucifer999: folds
tabby20: folds
Uncalled bet ($50) returned to DM0507
DM0507: doesn't show hand
DM0507 collected $100 from pot
*** SUMMARY ***
Total pot $100.00 | Rake $0
Board []
Seat 1: Lucifer999 (button) folded before Flop (didn't bet)
Seat 5: tabby20 (small blind) folded before Flop
Seat 6: DM0507 (big blind) collected ($100)



PokerStars Game #00327533827: Hold'em No Limit ($10/$25 USD) - 2022/04/30 10:12:13 ET
Table 'Hold'em (Min 500Max 2500) 1001' 6-max Seat #1 is the button
Seat 1: JaspritBumrah786 ($2025 in chips) 
Seat 2: fishfry123 ($610.39 in chips) 
Seat 3: allthebest ($2303.3 in chips) 
Seat 4: devi7 ($2286.25 in chips) 
Seat 5: Lucifer999 ($5265.58 in chips) 
Seat 6: spidy02 ($4959.11 in chips) 
fishfry123: posts small blind $10
allthebest: posts big blind $25
*** HOLE CARDS ***
Dealt to Lucifer999 [Ac 9c]
devi7: raises $50.00 to $75
Lucifer999: calls $75
spidy02: folds
JaspritBumrah786: folds
fishfry123: folds
allthebest: folds
*** FLOP *** [8c 2h 3s]
devi7: bets $87.15
Lucifer999: raises $122.85 to $210
devi7: calls $122.85
*** TURN *** [8c 2h 3s] [Ts]
devi7: checks
Lucifer999: checks
*** RIVER *** [8c 2h 3s Ts] [5d]
devi7: checks
Lucifer999: bets $220
devi7: calls $220
*** SHOW DOWN ***
Lucifer999: shows [Ac 9c] (High card, A)
devi7: shows [4h 4c] (Pair, 44)
devi7 collected $985.14 from pot
*** SUMMARY ***
Total pot $1045.00 | Rake $59.86
Board [8c 2h 3s Ts 5d]
Seat 1: JaspritBumrah786 (button) folded before Flop (didn't bet)
Seat 2: fishfry123 (small blind) folded before Flop
Seat 3: allthebest (big blind) folded before Flop
Seat 4: devi7  showed [4h 4c] and won ($985.14) with Pair, 44
Seat 5: Lucifer999 showed [Ac 9c] and lost with High card, A
Seat 6: spidy02 folded before Flop (didn't bet)



PokerStars Game #00327534082: Hold'em No Limit ($10/$25 USD) - 2022/04/30 10:13:36 ET
Table 'Hold'em (Min 500Max 2500)  1282' 6-max Seat #1 is the button
Seat 1: frostbyte28 ($2271.36 in chips) 
Seat 2: jayakumar2020 ($360 in chips) 
Seat 3: PANCHYOU ($1012.74 in chips) 
Seat 4: papadickkies ($1635.92 in chips) 
Seat 5: Lucifer999 ($5080.02 in chips) 
Seat 6: devi7 ($2851.18 in chips) 
papadickkies: posts small blind $10
Lucifer999: posts big blind $25
*** HOLE CARDS ***
Dealt to Lucifer999 [Jc 8s]
devi7: folds
frostbyte28: calls $25
papadickkies: folds
Lucifer999: raises $75.00 to $100
frostbyte28: calls $75
*** FLOP *** [Ad 5h 9c]
Lucifer999: bets $80
frostbyte28: folds
Uncalled bet ($80) returned to Lucifer999
Lucifer999: doesn't show hand
Lucifer999 collected $196.98 from pot
*** SUMMARY ***
Total pot $210.00 | Rake $13.02
Board [Ad 5h 9c]
Seat 1: frostbyte28 (button) folded on the Flop
Seat 4: papadickkies (small blind) folded before Flop
Seat 5: Lucifer999 (big blind) collected ($196.98)
Seat 6: devi7 folded before Flop (didn't bet)



PokerStars Game #00327534194: Hold'em No Limit ($10/$25 USD) - 2022/04/30 10:14:15 ET
Table 'Hold'em (Min 500Max 2500)  1282' 6-max Seat #4 is the button
Seat 1: frostbyte28 ($2171.36 in chips) 
Seat 2: jayakumar2020 ($360 in chips) 
Seat 3: PANCHYOU ($1012.74 in chips) 
Seat 4: papadickkies ($1625.92 in chips) 
Seat 5: Lucifer999 ($5177 in chips) 
Seat 6: devi7 ($2851.18 in chips) 
Lucifer999: posts small blind $10
devi7: posts big blind $25
*** HOLE CARDS ***
Dealt to Lucifer999 [7c 9c]
frostbyte28: calls $25
papadickkies: folds
Lucifer999: raises $85.00 to $110
devi7: folds
frostbyte28: folds
Uncalled bet ($85) returned to Lucifer999
Lucifer999: doesn't show hand
Lucifer999 collected $75 from pot
*** SUMMARY ***
Total pot $75.00 | Rake $0
Board []
Seat 1: frostbyte28 folded before Flop
Seat 4: papadickkies (button) folded before Flop (didn't bet)
Seat 5: Lucifer999 (small blind) collected ($75)
Seat 6: devi7 (big blind) folded before Flop



PokerStars Game #00327534186: Hold'em No Limit ($10/$25 USD) - 2022/04/30 10:14:13 ET
Table 'Hold'em (Min 500Max 2500) 1001' 6-max Seat #2 is the button
Seat 1: JaspritBumrah786 ($2025 in chips) 
Seat 2: fishfry123 ($600.39 in chips) 
Seat 3: allthebest ($2278.3 in chips) 
Seat 4: devi7 ($2766.39 in chips) 
Seat 5: Lucifer999 ($4760.58 in chips) 
Seat 6: spidy02 ($4959.11 in chips) 
allthebest: posts small blind $10
devi7: posts big blind $25
*** HOLE CARDS ***
Dealt to Lucifer999 [Js 8c]
Lucifer999: folds
spidy02: folds
JaspritBumrah786: raises $50.00 to $75
fishfry123: raises $525.39 to $600.39
allthebest: folds
devi7: folds
JaspritBumrah786: folds
Uncalled bet ($525.39) returned to fishfry123
fishfry123: doesn't show hand
fishfry123 collected $185 from pot
*** SUMMARY ***
Total pot $185.00 | Rake $0
Board []
Seat 1: JaspritBumrah786 folded before Flop
Seat 2: fishfry123 (button) collected ($185)
Seat 3: allthebest (small blind) folded before Flop
Seat 4: devi7 (big blind) folded before Flop
Seat 5: Lucifer999 folded before Flop (didn't bet)
Seat 6: spidy02 folded before Flop (didn't bet)



PokerStars Game #00327534172: Hold'em No Limit ($50/$100 USD) - 2022/04/30 10:14:05 ET
Table 'Hold'em (Min 25KMax 10K)    69' 6-max Seat #5 is the button
Seat 1: Lucifer999 ($13172.05 in chips) 
Seat 5: tabby20 ($22063.98 in chips) 
Seat 6: DM0507 ($3759.22 in chips) 
DM0507: posts small blind $50
Lucifer999: posts big blind $100
*** HOLE CARDS ***
Dealt to Lucifer999 [Qd 7s]
tabby20: folds
DM0507: calls $50
Lucifer999: raises $250.00 to $350
DM0507: calls $250
*** FLOP *** [3c 5h 3d]
DM0507: checks
Lucifer999: checks
*** TURN *** [3c 5h 3d] [6d]
DM0507: bets $334.6
Lucifer999: calls $334.6
*** RIVER *** [3c 5h 3d 6d] [Kd]
DM0507: checks
Lucifer999: checks
*** SHOW DOWN ***
DM0507: shows [4d 4c] (Two pairs, 4433)
Lucifer999: doesn't show hand
DM0507 collected $1308.97 from pot
*** SUMMARY ***
Total pot $1369.20 | Rake $60.23
Board [3c 5h 3d 6d Kd]
Seat 1: Lucifer999 (big blind) mucked
Seat 5: tabby20 (button) folded before Flop (didn't bet)
Seat 6: DM0507  (small blind) showed [4d 4c] and won ($1308.97) with Two pairs, 4433



PokerStars Game #00327534163: Hold'em No Limit ($25/$50 USD) - 2022/04/30 10:14:01 ET
Table 'Hold'em (Min 1K Max 5K)   216' 6-max Seat #6 is the button
Seat 1: Lucifer999 ($14233.03 in chips) 
Seat 2: rahulh1 ($4003.09 in chips) 
Seat 3: bettercall7208 ($8104.03 in chips) 
Seat 4: No username ($3365.25 in chips) 
Seat 6: Pablit0 ($694.58 in chips) 
Lucifer999: posts small blind $25
rahulh1: posts big blind $50
*** HOLE CARDS ***
Dealt to Lucifer999 [7d 3h]
bettercall7208: folds
No username: raises $81.25 to $131.25
Pablit0: calls $131.25
Lucifer999: folds
rahulh1: calls $81.25
*** FLOP *** [2c Td 8c]
rahulh1: checks
No username: checks
Pablit0: bets $198.93
rahulh1: calls $198.93
No username: folds
*** TURN *** [2c Td 8c] [2s]
rahulh1: bets $479.82
Pablit0: calls $364.4
Uncalled bet ($115.42) returned to rahulh1
*** RIVER *** [2c Td 8c 2s] [5c]
*** RIVER *** [2c Td 8c 2s] [3c]
*** SHOW DOWN ***
rahulh1: shows [6h 8h] (Two pairs, 8822)
Pablit0: shows [Th 8d] (Two pairs, TT88)
Pablit0 collected $734.08 from pot
Pablit0 collected $734.08 from pot
*** SUMMARY ***
Total pot $1545.41 | Rake $77.25
Board [2c Td 8c 2s 5c]
Seat 1: Lucifer999 (small blind) folded before Flop
Seat 2: rahulh1 (big blind) showed [6h 8h] and lost with Two pairs, 8822
Seat 3: bettercall7208 folded before Flop (didn't bet)
Seat 4: No username folded on the Flop
Seat 6: Pablit0  (button) showed [Th 8d] and won ($734.08) with Two pairs, TT88



PokerStars Game #00327534260: Hold'em No Limit ($10/$25 USD) - 2022/04/30 10:14:35 ET
Table 'Hold'em (Min 500Max 2500)  1282' 6-max Seat #5 is the button
Seat 1: frostbyte28 ($2146.36 in chips) 
Seat 2: jayakumar2020 ($360 in chips) 
Seat 3: PANCHYOU ($1012.74 in chips) 
Seat 4: papadickkies ($1625.92 in chips) 
Seat 5: Lucifer999 ($5227 in chips) 
Seat 6: devi7 ($2826.18 in chips) 
devi7: posts small blind $10
frostbyte28: posts big blind $25
*** HOLE CARDS ***
Dealt to Lucifer999 [5h 3d]
papadickkies: folds
Lucifer999: folds
devi7: raises $55.00 to $80
frostbyte28: calls $55
*** FLOP *** [6d Th 2c]
devi7: bets $50
frostbyte28: calls $50
*** TURN *** [6d Th 2c] [Ks]
devi7: bets $185
frostbyte28: folds
Uncalled bet ($185) returned to devi7
devi7: doesn't show hand
devi7 collected $244.35 from pot
*** SUMMARY ***
Total pot $260.00 | Rake $15.65
Board [6d Th 2c Ks]
Seat 1: frostbyte28 (big blind) folded on the Turn
Seat 4: papadickkies folded before Flop (didn't bet)
Seat 5: Lucifer999 (button) folded before Flop (didn't bet)
Seat 6: devi7 (small blind) collected ($244.35)



PokerStars Game #00327534317: Hold'em No Limit ($10/$25 USD) - 2022/04/30 10:14:53 ET
Table 'Hold'em (Min 500Max 2500) 1001' 6-max Seat #3 is the button
Seat 1: JaspritBumrah786 ($2025 in chips) 
Seat 2: fishfry123 ($710.39 in chips) 
Seat 3: allthebest ($2268.3 in chips) 
Seat 4: devi7 ($2741.39 in chips) 
Seat 5: Lucifer999 ($4760.58 in chips) 
Seat 6: spidy02 ($4959.11 in chips) 
devi7: posts small blind $10
Lucifer999: posts big blind $25
*** HOLE CARDS ***
Dealt to Lucifer999 [4h 4d]
spidy02: folds
JaspritBumrah786: folds
fishfry123: raises $60.00 to $85
allthebest: folds
devi7: folds
Lucifer999: calls $60
*** FLOP *** [8d Kc 3h]
Lucifer999: checks
fishfry123: bets $625.39
Lucifer999: folds
Uncalled bet ($625.39) returned to fishfry123
fishfry123: doesn't show hand
fishfry123 collected $169.55 from pot
*** SUMMARY ***
Total pot $180.00 | Rake $10.45
Board [8d Kc 3h]
Seat 1: JaspritBumrah786 folded before Flop (didn't bet)
Seat 2: fishfry123 collected ($169.55)
Seat 3: allthebest (button) folded before Flop (didn't bet)
Seat 4: devi7 (small blind) folded before Flop
Seat 5: Lucifer999 (big blind) folded on the Flop
Seat 6: spidy02 folded before Flop (didn't bet)



PokerStars Game #00327534336: Hold'em No Limit ($50/$100 USD) - 2022/04/30 10:15:00 ET
Table 'Hold'em (Min 25KMax 10K)    69' 6-max Seat #6 is the button
Seat 1: Lucifer999 ($12487.45 in chips) 
Seat 5: tabby20 ($22063.98 in chips) 
Seat 6: DM0507 ($4383.59 in chips) 
Lucifer999: posts small blind $50
tabby20: posts big blind $100
*** HOLE CARDS ***
Dealt to Lucifer999 [7h 9s]
DM0507: calls $100
Lucifer999: calls $50
tabby20: checks
*** FLOP *** [Qd 8d 7d]
Lucifer999: checks
tabby20: bets $286.8
DM0507: calls $286.8
Lucifer999: folds
*** TURN *** [Qd 8d 7d] [8c]
tabby20: checks
DM0507: checks
*** RIVER *** [Qd 8d 7d 8c] [9c]
tabby20: checks
DM0507: checks
*** SHOW DOWN ***
tabby20: shows [5s 3d] (Pair, 88)
DM0507: shows [Ad 6c] (Pair, 88)
DM0507 collected $835.19 from pot
*** SUMMARY ***
Total pot $873.60 | Rake $38.41
Board [Qd 8d 7d 8c 9c]
Seat 1: Lucifer999 (small blind) folded on the Flop
Seat 5: tabby20 (big blind) showed [5s 3d] and lost with Pair, 88
Seat 6: DM0507  (button) showed [Ad 6c] and won ($835.19) with Pair, 88



PokerStars Game #00327534413: Hold'em No Limit ($10/$25 USD) - 2022/04/30 10:15:27 ET
Table 'Hold'em (Min 500Max 2500)  1282' 6-max Seat #6 is the button
Seat 1: frostbyte28 ($2016.36 in chips) 
Seat 2: jayakumar2020 ($360 in chips) 
Seat 3: PANCHYOU ($1012.74 in chips) 
Seat 4: papadickkies ($1625.92 in chips) 
Seat 5: Lucifer999 ($5227 in chips) 
Seat 6: devi7 ($2940.53 in chips) 
frostbyte28: posts small blind $10
papadickkies: posts big blind $25
*** HOLE CARDS ***
Dealt to Lucifer999 [4c 3d]
Lucifer999: folds
devi7: folds
frostbyte28: folds
Uncalled bet ($15) returned to papadickkies
papadickkies: doesn't show hand
papadickkies collected $20 from pot
*** SUMMARY ***
Total pot $20.00 | Rake $0
Board []
Seat 1: frostbyte28 (small blind) folded before Flop
Seat 4: papadickkies (big blind) collected ($20)
Seat 5: Lucifer999 folded before Flop (didn't bet)
Seat 6: devi7 (button) folded before Flop (didn't bet)



PokerStars Game #00327534339: Hold'em No Limit ($25/$50 USD) - 2022/04/30 10:15:00 ET
Table 'Hold'em (Min 1K Max 5K)   216' 6-max Seat #1 is the button
Seat 1: Lucifer999 ($14208.03 in chips) 
Seat 2: rahulh1 ($3308.51 in chips) 
Seat 3: bettercall7208 ($8104.03 in chips) 
Seat 4: No username ($3234 in chips) 
Seat 5: Abtugaya ($1141.15 in chips) 
Seat 6: Pablit0 ($1468.16 in chips) 
rahulh1: posts small blind $25
bettercall7208: posts big blind $50
Abtugaya: posts big blind $50
*** HOLE CARDS ***
Dealt to Lucifer999 [7s 7d]
No username: raises $175.00 to $225
Abtugaya: folds
Pablit0: calls $225
Lucifer999: folds
rahulh1: calls $200
bettercall7208: folds
*** FLOP *** [3h Td 6s]
rahulh1: checks
No username: bets $368.13
Pablit0: raises $875.03 to $1243.16
rahulh1: folds
No username: folds
Uncalled bet ($875.03) returned to Pablit0
Pablit0: doesn't show hand
Pablit0 collected $1435.71 from pot
*** SUMMARY ***
Total pot $1511.26 | Rake $75.55
Board [3h Td 6s]
Seat 1: Lucifer999 (button) folded before Flop (didn't bet)
Seat 2: rahulh1 (small blind) folded on the Flop
Seat 3: bettercall7208 (big blind) folded before Flop
Seat 4: No username folded on the Flop
Seat 5: Abtugaya folded before Flop
Seat 6: Pablit0 collected ($1435.71)



PokerStars Game #00327534455: Hold'em No Limit ($50/$100 USD) - 2022/04/30 10:15:42 ET
Table 'Hold'em (Min 25KMax 10K)    69' 6-max Seat #1 is the button
Seat 1: Lucifer999 ($12387.45 in chips) 
Seat 5: tabby20 ($21677.18 in chips) 
Seat 6: DM0507 ($4831.98 in chips) 
tabby20: posts small blind $50
DM0507: posts big blind $100
*** HOLE CARDS ***
Dealt to Lucifer999 [Qs 3s]
Lucifer999: folds
tabby20: folds
Uncalled bet ($50) returned to DM0507
DM0507: doesn't show hand
DM0507 collected $100 from pot
*** SUMMARY ***
Total pot $100.00 | Rake $0
Board []
Seat 1: Lucifer999 (button) folded before Flop (didn't bet)
Seat 5: tabby20 (small blind) folded before Flop
Seat 6: DM0507 (big blind) collected ($100)



PokerStars Game #00327534527: Hold'em No Limit ($50/$100 USD) - 2022/04/30 10:16:06 ET
Table 'Hold'em (Min 25KMax 10K)    69' 6-max Seat #5 is the button
Seat 1: Lucifer999 ($12387.45 in chips) 
Seat 5: tabby20 ($21627.18 in chips) 
Seat 6: DM0507 ($4881.98 in chips) 
DM0507: posts small blind $50
Lucifer999: posts big blind $100
*** HOLE CARDS ***
Dealt to Lucifer999 [Jh 3s]
tabby20: raises $250.00 to $350
DM0507: folds
Lucifer999: folds
Uncalled bet ($250) returned to tabby20
tabby20: doesn't show hand
tabby20 collected $250 from pot
*** SUMMARY ***
Total pot $250.00 | Rake $0
Board []
Seat 1: Lucifer999 (big blind) folded before Flop
Seat 5: tabby20 (button) collected ($250)
Seat 6: DM0507 (small blind) folded before Flop



PokerStars Game #00327534448: Hold'em No Limit ($10/$25 USD) - 2022/04/30 10:15:38 ET
Table 'Hold'em (Min 500Max 2500) 1001' 6-max Seat #4 is the button
Seat 1: JaspritBumrah786 ($2025 in chips) 
Seat 2: fishfry123 ($794.94 in chips) 
Seat 3: allthebest ($2268.3 in chips) 
Seat 4: devi7 ($2731.39 in chips) 
Seat 5: Lucifer999 ($4675.58 in chips) 
Seat 6: spidy02 ($4959.11 in chips) 
Lucifer999: posts small blind $10
spidy02: posts big blind $25
*** HOLE CARDS ***
Dealt to Lucifer999 [9s 2d]
JaspritBumrah786: folds
fishfry123: raises $60.00 to $85
allthebest: folds
devi7: folds
Lucifer999: folds
spidy02: calls $60
*** FLOP *** [2c Ts 2s]
spidy02: checks
fishfry123: bets $169.55
spidy02: raises $508.65 to $678.2
fishfry123: raises $31.74 to $709.94
spidy02: calls $31.74
*** TURN *** [2c Ts 2s] [Ad]
*** RIVER *** [2c Ts 2s Ad] [Tc]
*** SHOW DOWN ***
fishfry123: shows [Kd Ks] (Two pairs, KKTT)
spidy02: shows [6s 6c] (Two pairs, TT66)
fishfry123 collected $1510.94 from pot
*** SUMMARY ***
Total pot $1599.88 | Rake $88.94
Board [2c Ts 2s Ad Tc]
Seat 1: JaspritBumrah786 folded before Flop (didn't bet)
Seat 2: fishfry123  showed [Kd Ks] and won ($1510.94) with Two pairs, KKTT
Seat 3: allthebest folded before Flop (didn't bet)
Seat 4: devi7 (button) folded before Flop (didn't bet)
Seat 5: Lucifer999 (small blind) folded before Flop
Seat 6: spidy02 (big blind) showed [6s 6c] and lost with Two pairs, TT66



PokerStars Game #00327534479: Hold'em No Limit ($10/$25 USD) - 2022/04/30 10:15:48 ET
Table 'Hold'em (Min 500Max 2500)  1282' 6-max Seat #4 is the button
Seat 2: jayakumar2020 ($360 in chips) 
Seat 3: PANCHYOU ($1012.74 in chips) 
Seat 4: papadickkies ($1635.92 in chips) 
Seat 5: Lucifer999 ($5227 in chips) 
Seat 6: devi7 ($2940.53 in chips) 
Lucifer999: posts small blind $10
devi7: posts big blind $25
*** HOLE CARDS ***
Dealt to Lucifer999 [7h 5h]
papadickkies: folds
Lucifer999: raises $55.00 to $80
devi7: calls $55
*** FLOP *** [4s 6c 3s]
Lucifer999: bets $110
devi7: calls $110
*** TURN *** [4s 6c 3s] [3h]
Lucifer999: bets $320
devi7: calls $320
*** RIVER *** [4s 6c 3s 3h] [As]
Lucifer999: bets $600
devi7: folds
Uncalled bet ($600) returned to Lucifer999
Lucifer999: doesn't show hand
Lucifer999 collected $966.45 from pot
*** SUMMARY ***
Total pot $1020.00 | Rake $53.55
Board [4s 6c 3s 3h As]
Seat 4: papadickkies (button) folded before Flop (didn't bet)
Seat 5: Lucifer999 (small blind) collected ($966.45)
Seat 6: devi7 (big blind) folded on the River



PokerStars Game #00327534566: Hold'em No Limit ($50/$100 USD) - 2022/04/30 10:16:18 ET
Table 'Hold'em (Min 25KMax 10K)    69' 6-max Seat #6 is the button
Seat 1: Lucifer999 ($12287.45 in chips) 
Seat 5: tabby20 ($21777.18 in chips) 
Seat 6: DM0507 ($4831.98 in chips) 
Lucifer999: posts small blind $50
tabby20: posts big blind $100
*** HOLE CARDS ***
Dealt to Lucifer999 [4c 4d]
DM0507: calls $100
Lucifer999: calls $50
tabby20: raises $350.00 to $450
DM0507: calls $350
Lucifer999: raises $1750.00 to $2200
tabby20: raises $19577.18 to $21777.18
DM0507: folds
Lucifer999: folds
Uncalled bet ($19577.18) returned to tabby20
tabby20: doesn't show hand
tabby20 collected $4850 from pot
*** SUMMARY ***
Total pot $4850.00 | Rake $0
Board []
Seat 1: Lucifer999 (small blind) folded before Flop
Seat 5: tabby20 (big blind) collected ($4850)
Seat 6: DM0507 (button) folded before Flop



PokerStars Game #00327534494: Hold'em No Limit ($25/$50 USD) - 2022/04/30 10:15:55 ET
Table 'Hold'em (Min 1K Max 5K)   216' 6-max Seat #2 is the button
Seat 1: Lucifer999 ($14208.03 in chips) 
Seat 2: rahulh1 ($3083.51 in chips) 
Seat 3: bettercall7208 ($8054.03 in chips) 
Seat 4: No username ($2640.87 in chips) 
Seat 5: Abtugaya ($1091.15 in chips) 
Seat 6: Pablit0 ($2310.74 in chips) 
bettercall7208: posts small blind $25
No username: posts big blind $50
*** HOLE CARDS ***
Dealt to Lucifer999 [9s 4d]
Abtugaya: folds
Pablit0: folds
Lucifer999: folds
rahulh1: calls $50
bettercall7208: calls $25
No username: raises $150.00 to $200
rahulh1: calls $150
bettercall7208: calls $150
*** FLOP *** [6s 6c 3s]
bettercall7208: checks
No username: bets $285
rahulh1: folds
bettercall7208: calls $285
*** TURN *** [6s 6c 3s] [8s]
bettercall7208: checks
No username: checks
*** RIVER *** [6s 6c 3s 8s] [7c]
bettercall7208: bets $1111.5
No username: folds
Uncalled bet ($1111.5) returned to bettercall7208
bettercall7208: doesn't show hand
bettercall7208 collected $1111.5 from pot
*** SUMMARY ***
Total pot $1170.00 | Rake $58.5
Board [6s 6c 3s 8s 7c]
Seat 1: Lucifer999 folded before Flop (didn't bet)
Seat 2: rahulh1 (button) folded on the Flop
Seat 3: bettercall7208 (small blind) collected ($1111.5)
Seat 4: No username (big blind) folded on the River
Seat 5: Abtugaya folded before Flop (didn't bet)
Seat 6: Pablit0 folded before Flop (didn't bet)



PokerStars Game #00327534606: Hold'em No Limit ($10/$25 USD) - 2022/04/30 10:16:30 ET
Table 'Hold'em (Min 500Max 2500) 1001' 6-max Seat #5 is the button
Seat 1: JaspritBumrah786 ($2025 in chips) 
Seat 2: fishfry123 ($1510.94 in chips) 
Seat 3: allthebest ($2268.3 in chips) 
Seat 4: devi7 ($2731.39 in chips) 
Seat 5: Lucifer999 ($4665.58 in chips) 
Seat 6: spidy02 ($4164.17 in chips) 
spidy02: posts small blind $10
JaspritBumrah786: posts big blind $25
*** HOLE CARDS ***
Dealt to Lucifer999 [Ad 7c]
fishfry123: folds
allthebest: folds
devi7: folds
Lucifer999: raises $55.00 to $80
spidy02: folds
JaspritBumrah786: folds
Uncalled bet ($55) returned to Lucifer999
Lucifer999: doesn't show hand
Lucifer999 collected $60 from pot
*** SUMMARY ***
Total pot $60.00 | Rake $0
Board []
Seat 1: JaspritBumrah786 (big blind) folded before Flop
Seat 2: fishfry123 folded before Flop (didn't bet)
Seat 3: allthebest folded before Flop (didn't bet)
Seat 4: devi7 folded before Flop (didn't bet)
Seat 5: Lucifer999 (button) collected ($60)
Seat 6: spidy02 (small blind) folded before Flop



PokerStars Game #00327534631: Hold'em No Limit ($10/$25 USD) - 2022/04/30 10:16:39 ET
Table 'Hold'em (Min 500Max 2500)  1282' 6-max Seat #5 is the button
Seat 2: jayakumar2020 ($360 in chips) 
Seat 3: PANCHYOU ($1012.74 in chips) 
Seat 4: papadickkies ($1635.92 in chips) 
Seat 5: Lucifer999 ($5683.45 in chips) 
Seat 6: devi7 ($2430.53 in chips) 
devi7: posts small blind $10
papadickkies: posts big blind $25
*** HOLE CARDS ***
Dealt to Lucifer999 [3h 4d]
Lucifer999: folds
devi7: raises $55.00 to $80
papadickkies: folds
Uncalled bet ($55) returned to devi7
devi7: doesn't show hand
devi7 collected $50 from pot
*** SUMMARY ***
Total pot $50.00 | Rake $0
Board []
Seat 4: papadickkies (big blind) folded before Flop
Seat 5: Lucifer999 (button) folded before Flop (didn't bet)
Seat 6: devi7 (small blind) collected ($50)



PokerStars Game #00327534667: Hold'em No Limit ($50/$100 USD) - 2022/04/30 10:16:51 ET
Table 'Hold'em (Min 25KMax 10K)    69' 6-max Seat #1 is the button
Seat 1: Lucifer999 ($10087.45 in chips) 
Seat 5: tabby20 ($24427.18 in chips) 
Seat 6: DM0507 ($4381.98 in chips) 
tabby20: posts small blind $50
DM0507: posts big blind $100
*** HOLE CARDS ***
Dealt to Lucifer999 [7h 2d]
Lucifer999: folds
tabby20: raises $250.00 to $350
DM0507: folds
Uncalled bet ($250) returned to tabby20
tabby20: doesn't show hand
tabby20 collected $200 from pot
*** SUMMARY ***
Total pot $200.00 | Rake $0
Board []
Seat 1: Lucifer999 (button) folded before Flop (didn't bet)
Seat 5: tabby20 (small blind) collected ($200)
Seat 6: DM0507 (big blind) folded before Flop



PokerStars Game #00327534729: Hold'em No Limit ($10/$25 USD) - 2022/04/30 10:17:12 ET
Table 'Hold'em (Min 500Max 2500)  1282' 6-max Seat #6 is the button
Seat 2: jayakumar2020 ($360 in chips) 
Seat 3: PANCHYOU ($1012.74 in chips) 
Seat 4: papadickkies ($1610.92 in chips) 
Seat 5: Lucifer999 ($5683.45 in chips) 
Seat 6: devi7 ($2455.53 in chips) 
papadickkies: posts small blind $10
Lucifer999: posts big blind $25
*** HOLE CARDS ***
Dealt to Lucifer999 [Kd 4h]
devi7: raises $50.00 to $75
papadickkies: folds
Lucifer999: folds
Uncalled bet ($50) returned to devi7
devi7: doesn't show hand
devi7 collected $60 from pot
*** SUMMARY ***
Total pot $60.00 | Rake $0
Board []
Seat 4: papadickkies (small blind) folded before Flop
Seat 5: Lucifer999 (big blind) folded before Flop
Seat 6: devi7 (button) collected ($60)



PokerStars Game #00327534692: Hold'em No Limit ($25/$50 USD) - 2022/04/30 10:16:58 ET
Table 'Hold'em (Min 1K Max 5K)   216' 6-max Seat #3 is the button
Seat 1: Lucifer999 ($14208.03 in chips) 
Seat 2: rahulh1 ($2883.51 in chips) 
Seat 3: bettercall7208 ($8680.53 in chips) 
Seat 4: No username ($2155.87 in chips) 
Seat 5: Abtugaya ($1091.15 in chips) 
Seat 6: Pablit0 ($2310.74 in chips) 
No username: posts small blind $25
Abtugaya: posts big blind $50
*** HOLE CARDS ***
Dealt to Lucifer999 [3d 4h]
Pablit0: folds
Lucifer999: folds
rahulh1: folds
bettercall7208: raises $100.00 to $150
No username: folds
Abtugaya: calls $100
*** FLOP *** [Th 6s Jh]
Abtugaya: checks
bettercall7208: bets $205.83
Abtugaya: raises $735.32 to $941.15
bettercall7208: calls $735.32
*** TURN *** [Th 6s Jh] [Ts]
*** TURN *** [Th 6s Jh] [2s]
*** RIVER *** [Th 6s Jh Ts] [6c]
*** RIVER *** [Th 6s Jh Ts] [As]
*** SHOW DOWN ***
bettercall7208: shows [Ks Js] (Flush, A high)
Abtugaya: shows [Td Ac] (Two pairs, AATT)
Abtugaya collected $1048.48 from pot
bettercall7208 collected $1048.47 from pot
*** SUMMARY ***
Total pot $2207.30 | Rake $110.35
Board [Th 6s Jh Ts 6c]
Seat 1: Lucifer999 folded before Flop (didn't bet)
Seat 2: rahulh1 folded before Flop (didn't bet)
Seat 3: bettercall7208  (button) showed [Ks Js] and won ($1048.47) with Flush, A high
Seat 4: No username (small blind) folded before Flop
Seat 5: Abtugaya  (big blind) showed [Td Ac] and won ($1048.48) with Two pairs, AATT
Seat 6: Pablit0 folded before Flop (didn't bet)



PokerStars Game #00327534699: Hold'em No Limit ($10/$25 USD) - 2022/04/30 10:17:01 ET
Table 'Hold'em (Min 500Max 2500) 1001' 6-max Seat #6 is the button
Seat 1: JaspritBumrah786 ($2000 in chips) 
Seat 2: fishfry123 ($1510.94 in chips) 
Seat 3: allthebest ($2268.3 in chips) 
Seat 4: devi7 ($2731.39 in chips) 
Seat 5: Lucifer999 ($4700.58 in chips) 
Seat 6: spidy02 ($4154.17 in chips) 
JaspritBumrah786: posts small blind $10
fishfry123: posts big blind $25
*** HOLE CARDS ***
Dealt to Lucifer999 [2h 3d]
allthebest: raises $50.00 to $75
devi7: folds
Lucifer999: folds
spidy02: folds
JaspritBumrah786: folds
fishfry123: folds
Uncalled bet ($50) returned to allthebest
allthebest: doesn't show hand
allthebest collected $60 from pot
*** SUMMARY ***
Total pot $60.00 | Rake $0
Board []
Seat 1: JaspritBumrah786 (small blind) folded before Flop
Seat 2: fishfry123 (big blind) folded before Flop
Seat 3: allthebest collected ($60)
Seat 4: devi7 folded before Flop (didn't bet)
Seat 5: Lucifer999 folded before Flop (didn't bet)
Seat 6: spidy02 (button) folded before Flop (didn't bet)



PokerStars Game #00327534807: Hold'em No Limit ($10/$25 USD) - 2022/04/30 10:17:33 ET
Table 'Hold'em (Min 500Max 2500)  1282' 6-max Seat #4 is the button
Seat 2: jayakumar2020 ($360 in chips) 
Seat 3: PANCHYOU ($1012.74 in chips) 
Seat 4: papadickkies ($1600.92 in chips) 
Seat 5: Lucifer999 ($5658.45 in chips) 
Seat 6: devi7 ($2490.53 in chips) 
Lucifer999: posts small blind $10
devi7: posts big blind $25
*** HOLE CARDS ***
Dealt to Lucifer999 [Qh 5s]
papadickkies: folds
Lucifer999: folds
Uncalled bet ($15) returned to devi7
devi7: doesn't show hand
devi7 collected $20 from pot
*** SUMMARY ***
Total pot $20.00 | Rake $0
Board []
Seat 4: papadickkies (button) folded before Flop (didn't bet)
Seat 5: Lucifer999 (small blind) folded before Flop
Seat 6: devi7 (big blind) collected ($20)



PokerStars Game #00327534757: Hold'em No Limit ($50/$100 USD) - 2022/04/30 10:17:18 ET
Table 'Hold'em (Min 25KMax 10K)    69' 6-max Seat #5 is the button
Seat 1: Lucifer999 ($10087.45 in chips) 
Seat 5: tabby20 ($24527.18 in chips) 
Seat 6: DM0507 ($4281.98 in chips) 
DM0507: posts small blind $50
Lucifer999: posts big blind $100
*** HOLE CARDS ***
Dealt to Lucifer999 [6d Jc]
tabby20: folds
DM0507: calls $50
Lucifer999: checks
*** FLOP *** [4h Qc 4d]
DM0507: checks
Lucifer999: bets $100
DM0507: calls $100
*** TURN *** [4h Qc 4d] [9s]
DM0507: checks
Lucifer999: checks
*** RIVER *** [4h Qc 4d 9s] [9h]
DM0507: bets $100
Lucifer999: folds
Uncalled bet ($100) returned to DM0507
DM0507: doesn't show hand
DM0507 collected $382.4 from pot
*** SUMMARY ***
Total pot $400.00 | Rake $17.6
Board [4h Qc 4d 9s 9h]
Seat 1: Lucifer999 (big blind) folded on the River
Seat 5: tabby20 (button) folded before Flop (didn't bet)
Seat 6: DM0507 (small blind) collected ($382.4)



PokerStars Game #00327534832: Hold'em No Limit ($25/$50 USD) - 2022/04/30 10:17:41 ET
Table 'Hold'em (Min 1K Max 5K)   216' 6-max Seat #4 is the button
Seat 1: Lucifer999 ($14208.03 in chips) 
Seat 2: rahulh1 ($2883.51 in chips) 
Seat 3: bettercall7208 ($8637.85 in chips) 
Seat 4: No username ($2130.87 in chips) 
Seat 5: Abtugaya ($1048.48 in chips) 
Seat 6: Pablit0 ($2310.74 in chips) 
Abtugaya: posts small blind $25
Pablit0: posts big blind $50
*** HOLE CARDS ***
Dealt to Lucifer999 [Ah 5s]
Lucifer999: folds
rahulh1: folds
bettercall7208: folds
No username: raises $81.25 to $131.25
Abtugaya: calls $106.25
Pablit0: folds
*** FLOP *** [Kd 9c 8c]
Abtugaya: checks
No username: bets $148.45
Abtugaya: raises $768.78 to $917.23
No username: raises $768.78 to $1686.01
Uncalled bet ($768.78) returned to No username
*** TURN *** [Kd 9c 8c] [4s]
*** TURN *** [Kd 9c 8c] [7h]
*** RIVER *** [Kd 9c 8c 4s] [5h]
*** RIVER *** [Kd 9c 8c 4s] [3d]
*** SHOW DOWN ***
No username: shows [9h 8h] (Two pairs, 9988)
Abtugaya: shows [Js Th] (Straight, J-7)
No username collected $1019.83 from pot
Abtugaya collected $1019.83 from pot
*** SUMMARY ***
Total pot $2146.96 | Rake $107.3
Board [Kd 9c 8c 4s 5h]
Seat 1: Lucifer999 folded before Flop (didn't bet)
Seat 2: rahulh1 folded before Flop (didn't bet)
Seat 3: bettercall7208 folded before Flop (didn't bet)
Seat 4: No username  (button) showed [9h 8h] and won ($1019.83) with Two pairs, 9988
Seat 5: Abtugaya  (small blind) showed [Js Th] and won ($1019.83) with Straight, J-7
Seat 6: Pablit0 (big blind) folded before Flop



PokerStars Game #00327534845: Hold'em No Limit ($10/$25 USD) - 2022/04/30 10:17:46 ET
Table 'Hold'em (Min 500Max 2500) 1001' 6-max Seat #1 is the button
Seat 1: JaspritBumrah786 ($2025 in chips) 
Seat 2: fishfry123 ($1485.94 in chips) 
Seat 3: allthebest ($2303.3 in chips) 
Seat 4: devi7 ($2731.39 in chips) 
Seat 5: Lucifer999 ($4700.58 in chips) 
Seat 6: spidy02 ($4154.17 in chips) 
allthebest: posts small blind $10
devi7: posts big blind $25
*** HOLE CARDS ***
Dealt to Lucifer999 [Ad 6d]
Lucifer999: raises $55.00 to $80
spidy02: folds
JaspritBumrah786: folds
allthebest: folds
devi7: folds
Uncalled bet ($55) returned to Lucifer999
Lucifer999: doesn't show hand
Lucifer999 collected $60 from pot
*** SUMMARY ***
Total pot $60.00 | Rake $0
Board []
Seat 1: JaspritBumrah786 (button) folded before Flop (didn't bet)
Seat 3: allthebest (small blind) folded before Flop
Seat 4: devi7 (big blind) folded before Flop
Seat 5: Lucifer999 collected ($60)
Seat 6: spidy02 folded before Flop (didn't bet)



PokerStars Game #00327534936: Hold'em No Limit ($50/$100 USD) - 2022/04/30 10:18:11 ET
Table 'Hold'em (Min 25KMax 10K)    69' 6-max Seat #6 is the button
Seat 1: Lucifer999 ($10000 in chips) 
Seat 5: tabby20 ($24527.18 in chips) 
Seat 6: DM0507 ($4464.38 in chips) 
Lucifer999: posts small blind $50
tabby20: posts big blind $100
*** HOLE CARDS ***
Dealt to Lucifer999 [Kd Tc]
DM0507: calls $100
Lucifer999: calls $50
tabby20: raises $350.00 to $450
DM0507: calls $350
Lucifer999: raises $1750.00 to $2200
tabby20: raises $22327.18 to $24527.18
DM0507: folds
Lucifer999: folds
Uncalled bet ($22327.18) returned to tabby20
tabby20: doesn't show hand
tabby20 collected $4850 from pot
*** SUMMARY ***
Total pot $4850.00 | Rake $0
Board []
Seat 1: Lucifer999 (small blind) folded before Flop
Seat 5: tabby20 (big blind) collected ($4850)
Seat 6: DM0507 (button) folded before Flop



PokerStars Game #00327534974: Hold'em No Limit ($10/$25 USD) - 2022/04/30 10:18:25 ET
Table 'Hold'em (Min 500Max 2500) 1001' 6-max Seat #3 is the button
Seat 1: JaspritBumrah786 ($2025 in chips) 
Seat 2: fishfry123 ($1485.94 in chips) 
Seat 3: allthebest ($2293.3 in chips) 
Seat 4: devi7 ($2706.39 in chips) 
Seat 5: Lucifer999 ($4735.58 in chips) 
Seat 6: spidy02 ($4154.17 in chips) 
devi7: posts small blind $10
Lucifer999: posts big blind $25
*** HOLE CARDS ***
Dealt to Lucifer999 [7s Qd]
spidy02: folds
JaspritBumrah786: folds
allthebest: folds
devi7: raises $55.00 to $80
Lucifer999: folds
Uncalled bet ($55) returned to devi7
devi7: doesn't show hand
devi7 collected $50 from pot
*** SUMMARY ***
Total pot $50.00 | Rake $0
Board []
Seat 1: JaspritBumrah786 folded before Flop (didn't bet)
Seat 3: allthebest (button) folded before Flop (didn't bet)
Seat 4: devi7 (small blind) collected ($50)
Seat 5: Lucifer999 (big blind) folded before Flop
Seat 6: spidy02 folded before Flop (didn't bet)



PokerStars Game #00327534967: Hold'em No Limit ($25/$50 USD) - 2022/04/30 10:18:22 ET
Table 'Hold'em (Min 1K Max 5K)   216' 6-max Seat #5 is the button
Seat 1: Lucifer999 ($14208.03 in chips) 
Seat 2: rahulh1 ($2883.51 in chips) 
Seat 3: bettercall7208 ($8637.85 in chips) 
Seat 4: No username ($2102.22 in chips) 
Seat 5: Abtugaya ($1019.83 in chips) 
Seat 6: Pablit0 ($2260.74 in chips) 
Pablit0: posts small blind $25
Lucifer999: posts big blind $50
*** HOLE CARDS ***
Dealt to Lucifer999 [2h Kd]
rahulh1: folds
bettercall7208: folds
No username: raises $66.67 to $116.67
Abtugaya: raises $903.16 to $1019.83
Pablit0: folds
Lucifer999: folds
No username: folds
Uncalled bet ($903.16) returned to Abtugaya
Abtugaya: doesn't show hand
Abtugaya collected $308.34 from pot
*** SUMMARY ***
Total pot $308.34 | Rake $0
Board []
Seat 1: Lucifer999 (big blind) folded before Flop
Seat 2: rahulh1 folded before Flop (didn't bet)
Seat 3: bettercall7208 folded before Flop (didn't bet)
Seat 4: No username folded before Flop
Seat 5: Abtugaya (button) collected ($308.34)
Seat 6: Pablit0 (small blind) folded before Flop



PokerStars Game #00327534866: Hold'em No Limit ($10/$25 USD) - 2022/04/30 10:17:50 ET
Table 'Hold'em (Min 500Max 2500)  1282' 6-max Seat #5 is the button
Seat 2: jayakumar2020 ($360 in chips) 
Seat 3: PANCHYOU ($1012.74 in chips) 
Seat 4: papadickkies ($1600.92 in chips) 
Seat 5: Lucifer999 ($5648.45 in chips) 
Seat 6: devi7 ($2500.53 in chips) 
devi7: posts small blind $10
papadickkies: posts big blind $25
*** HOLE CARDS ***
Dealt to Lucifer999 [Tc Ts]
Lucifer999: raises $55.00 to $80
devi7: folds
papadickkies: calls $55
*** FLOP *** [3h 4c 9c]
papadickkies: checks
Lucifer999: bets $100
papadickkies: calls $100
*** TURN *** [3h 4c 9c] [8c]
papadickkies: bets $175.29
Lucifer999: calls $175.29
*** RIVER *** [3h 4c 9c 8c] [Qc]
papadickkies: bets $234.3
Lucifer999: calls $234.3
*** SHOW DOWN ***
papadickkies: shows [7s 9s] (Pair, 99)
Lucifer999: shows [Tc Ts] (Flush, Q high)
Lucifer999 collected $1126.76 from pot
*** SUMMARY ***
Total pot $1189.18 | Rake $62.42
Board [3h 4c 9c 8c Qc]
Seat 4: papadickkies (big blind) showed [7s 9s] and lost with Pair, 99
Seat 5: Lucifer999  (button) showed [Tc Ts] and won ($1126.76) with Flush, Q high
Seat 6: devi7 (small blind) folded before Flop



PokerStars Game #00327535037: Hold'em No Limit ($50/$100 USD) - 2022/04/30 10:18:45 ET
Table 'Hold'em (Min 25KMax 10K)    69' 6-max Seat #1 is the button
Seat 1: Lucifer999 ($10000 in chips) 
Seat 5: tabby20 ($27177.18 in chips) 
Seat 6: DM0507 ($4014.38 in chips) 
tabby20: posts small blind $50
DM0507: posts big blind $100
*** HOLE CARDS ***
Dealt to Lucifer999 [2c Qc]
Lucifer999: folds
tabby20: raises $250.00 to $350
DM0507: calls $250
*** FLOP *** [2s Ts Qh]
tabby20: checks
DM0507: checks
*** TURN *** [2s Ts Qh] [6d]
tabby20: bets $550
DM0507: folds
Uncalled bet ($550) returned to tabby20
tabby20: doesn't show hand
tabby20 collected $669.2 from pot
*** SUMMARY ***
Total pot $700.00 | Rake $30.8
Board [2s Ts Qh 6d]
Seat 1: Lucifer999 (button) folded before Flop (didn't bet)
Seat 5: tabby20 (small blind) collected ($669.2)
Seat 6: DM0507 (big blind) folded on the Turn



PokerStars Game #00327535044: Hold'em No Limit ($10/$25 USD) - 2022/04/30 10:18:48 ET
Table 'Hold'em (Min 500Max 2500) 1001' 6-max Seat #4 is the button
Seat 1: JaspritBumrah786 ($2025 in chips) 
Seat 2: fishfry123 ($1485.94 in chips) 
Seat 3: allthebest ($2293.3 in chips) 
Seat 4: devi7 ($2731.39 in chips) 
Seat 5: Lucifer999 ($4710.58 in chips) 
Seat 6: spidy02 ($4154.17 in chips) 
Lucifer999: posts small blind $10
spidy02: posts big blind $25
*** HOLE CARDS ***
Dealt to Lucifer999 [4c Ac]
JaspritBumrah786: folds
allthebest: raises $50.00 to $75
devi7: folds
Lucifer999: folds
spidy02: raises $55.00 to $130
allthebest: calls $55
*** FLOP *** [3c 9d 4d]
spidy02: checks
allthebest: bets $200
spidy02: calls $200
*** TURN *** [3c 9d 4d] [As]
spidy02: bets $314.92
allthebest: folds
Uncalled bet ($314.92) returned to spidy02
spidy02: doesn't show hand
spidy02 collected $629.83 from pot
*** SUMMARY ***
Total pot $670.00 | Rake $40.17
Board [3c 9d 4d As]
Seat 1: JaspritBumrah786 folded before Flop (didn't bet)
Seat 3: allthebest folded on the Turn
Seat 4: devi7 (button) folded before Flop (didn't bet)
Seat 5: Lucifer999 (small blind) folded before Flop
Seat 6: spidy02 (big blind) collected ($629.83)



PokerStars Game #00327535065: Hold'em No Limit ($25/$50 USD) - 2022/04/30 10:18:53 ET
Table 'Hold'em (Min 1K Max 5K)   216' 6-max Seat #6 is the button
Seat 1: Lucifer999 ($14158.03 in chips) 
Seat 2: rahulh1 ($2883.51 in chips) 
Seat 3: bettercall7208 ($8637.85 in chips) 
Seat 4: No username ($1985.55 in chips) 
Seat 5: Abtugaya ($1211.5 in chips) 
Seat 6: Pablit0 ($2235.74 in chips) 
Lucifer999: posts small blind $25
rahulh1: posts big blind $50
*** HOLE CARDS ***
Dealt to Lucifer999 [9s 3s]
bettercall7208: folds
No username: folds
Abtugaya: folds
Pablit0: calls $50
Lucifer999: folds
rahulh1: checks
*** FLOP *** [Jc 5d Ts]
rahulh1: checks
Pablit0: checks
*** TURN *** [Jc 5d Ts] [4s]
rahulh1: checks
Pablit0: bets $50
rahulh1: folds
Uncalled bet ($50) returned to Pablit0
Pablit0: doesn't show hand
Pablit0 collected $118.75 from pot
*** SUMMARY ***
Total pot $125.00 | Rake $6.25
Board [Jc 5d Ts 4s]
Seat 1: Lucifer999 (small blind) folded before Flop
Seat 2: rahulh1 (big blind) folded on the Turn
Seat 3: bettercall7208 folded before Flop (didn't bet)
Seat 4: No username folded before Flop (didn't bet)
Seat 5: Abtugaya folded before Flop (didn't bet)
Seat 6: Pablit0 (button) collected ($118.75)



PokerStars Game #00327535152: Hold'em No Limit ($50/$100 USD) - 2022/04/30 10:19:21 ET
Table 'Hold'em (Min 25KMax 10K)    69' 6-max Seat #5 is the button
Seat 1: Lucifer999 ($10000 in chips) 
Seat 5: tabby20 ($27496.38 in chips) 
Seat 6: DM0507 ($3664.38 in chips) 
DM0507: posts small blind $50
Lucifer999: posts big blind $100
*** HOLE CARDS ***
Dealt to Lucifer999 [Tc 5d]
tabby20: folds
DM0507: calls $50
Lucifer999: checks
*** FLOP *** [7d 9c 9s]
DM0507: checks
Lucifer999: checks
*** TURN *** [7d 9c 9s] [4h]
DM0507: checks
Lucifer999: checks
*** RIVER *** [7d 9c 9s 4h] [Jh]
DM0507: checks
Lucifer999: bets $100
DM0507: folds
Uncalled bet ($100) returned to Lucifer999
Lucifer999: doesn't show hand
Lucifer999 collected $191.2 from pot
*** SUMMARY ***
Total pot $200.00 | Rake $8.8
Board [7d 9c 9s 4h Jh]
Seat 1: Lucifer999 (big blind) collected ($191.2)
Seat 5: tabby20 (button) folded before Flop (didn't bet)
Seat 6: DM0507 (small blind) folded on the River



PokerStars Game #00327535127: Hold'em No Limit ($10/$25 USD) - 2022/04/30 10:19:15 ET
Table 'Hold'em (Min 500Max 2500)  1282' 6-max Seat #6 is the button
Seat 2: jayakumar2020 ($360 in chips) 
Seat 4: papadickkies ($1011.33 in chips) 
Seat 5: Lucifer999 ($6185.62 in chips) 
Seat 6: devi7 ($2490.53 in chips) 
papadickkies: posts small blind $10
Lucifer999: posts big blind $25
*** HOLE CARDS ***
Dealt to Lucifer999 [6c Qd]
devi7: folds
papadickkies: raises $30.00 to $55
Lucifer999: calls $30
*** FLOP *** [7h Ad 8c]
papadickkies: checks
Lucifer999: checks
*** TURN *** [7h Ad 8c] [8h]
papadickkies: checks
Lucifer999: bets $80
papadickkies: calls $80
*** RIVER *** [7h Ad 8c 8h] [Ks]
papadickkies: checks
Lucifer999: checks
*** SHOW DOWN ***
Lucifer999: shows [6c Qd] (Pair, 88)
papadickkies: doesn't show hand
Lucifer999 collected $255.83 from pot
*** SUMMARY ***
Total pot $270.00 | Rake $14.17
Board [7h Ad 8c 8h Ks]
Seat 4: papadickkies (small blind) mucked
Seat 5: Lucifer999  (big blind) showed [6c Qd] and won ($255.83) with Pair, 88
Seat 6: devi7 (button) folded before Flop (didn't bet)



PokerStars Game #00327535350: Hold'em No Limit ($10/$25 USD) - 2022/04/30 10:20:25 ET
Table 'Hold'em (Min 500Max 2500)  1282' 6-max Seat #4 is the button
Seat 4: papadickkies ($876.33 in chips) 
Seat 5: Lucifer999 ($6306.45 in chips) 
Seat 6: devi7 ($2490.53 in chips) 
Lucifer999: posts small blind $10
devi7: posts big blind $25
*** HOLE CARDS ***
Dealt to Lucifer999 [2h Jc]
papadickkies: folds
Lucifer999: folds
Uncalled bet ($15) returned to devi7
devi7: doesn't show hand
devi7 collected $20 from pot
*** SUMMARY ***
Total pot $20.00 | Rake $0
Board []
Seat 4: papadickkies (button) folded before Flop (didn't bet)
Seat 5: Lucifer999 (small blind) folded before Flop
Seat 6: devi7 (big blind) collected ($20)



PokerStars Game #00327535238: Hold'em No Limit ($10/$25 USD) - 2022/04/30 10:19:51 ET
Table 'Hold'em (Min 500Max 2500) 1001' 6-max Seat #5 is the button
Seat 1: JaspritBumrah786 ($2025 in chips) 
Seat 2: fishfry123 ($1485.94 in chips) 
Seat 3: allthebest ($2025 in chips) 
Seat 4: devi7 ($2731.39 in chips) 
Seat 5: Lucifer999 ($4700.58 in chips) 
Seat 6: spidy02 ($4454 in chips) 
spidy02: posts small blind $10
JaspritBumrah786: posts big blind $25
*** HOLE CARDS ***
Dealt to Lucifer999 [Qc 4h]
allthebest: raises $50.00 to $75
devi7: folds
Lucifer999: folds
spidy02: folds
JaspritBumrah786: raises $150.00 to $225
allthebest: calls $150
*** FLOP *** [2s Jh 9s]
JaspritBumrah786: checks
allthebest: bets $300
JaspritBumrah786: folds
Uncalled bet ($300) returned to allthebest
allthebest: doesn't show hand
allthebest collected $431.85 from pot
*** SUMMARY ***
Total pot $460.00 | Rake $28.15
Board [2s Jh 9s]
Seat 1: JaspritBumrah786 (big blind) folded on the Flop
Seat 3: allthebest collected ($431.85)
Seat 4: devi7 folded before Flop (didn't bet)
Seat 5: Lucifer999 (button) folded before Flop (didn't bet)
Seat 6: spidy02 (small blind) folded before Flop



PokerStars Game #00327535241: Hold'em No Limit ($25/$50 USD) - 2022/04/30 10:19:52 ET
Table 'Hold'em (Min 1K Max 5K)   216' 6-max Seat #1 is the button
Seat 1: Lucifer999 ($14133.03 in chips) 
Seat 2: rahulh1 ($2833.51 in chips) 
Seat 3: bettercall7208 ($8637.85 in chips) 
Seat 4: No username ($1985.55 in chips) 
Seat 5: Abtugaya ($1211.5 in chips) 
Seat 6: Pablit0 ($2304.49 in chips) 
rahulh1: posts small blind $25
bettercall7208: posts big blind $50
*** HOLE CARDS ***
Dealt to Lucifer999 [Tc Ts]
No username: raises $66.67 to $116.67
Abtugaya: folds
Pablit0: raises $291.67 to $408.34
Lucifer999: raises $441.66 to $850
rahulh1: folds
bettercall7208: folds
No username: folds
Pablit0: raises $1454.49 to $2304.49
Lucifer999: calls $1454.49
*** FLOP *** [Jc 6d 2c]
*** FLOP *** [5s 8d Jh]
*** TURN *** [Jc 6d 2c] [7c]
*** TURN *** [Jc 6d 2c] [3s]
*** RIVER *** [Jc 6d 2c 7c] [Qh]
*** RIVER *** [Jc 6d 2c 7c] [6h]
*** SHOW DOWN ***
Lucifer999: shows [Tc Ts] (Pair, TT)
Pablit0: shows [Ad As] (Pair, AA)
Pablit0 collected $2280.33 from pot
Pablit0 collected $2280.32 from pot
*** SUMMARY ***
Total pot $4800.65 | Rake $240
Board [Jc 6d 2c 7c Qh]
Seat 1: Lucifer999 (button) showed [Tc Ts] and lost with Pair, TT
Seat 2: rahulh1 (small blind) folded before Flop
Seat 3: bettercall7208 (big blind) folded before Flop
Seat 4: No username folded before Flop
Seat 5: Abtugaya folded before Flop (didn't bet)
Seat 6: Pablit0  showed [Ad As] and won ($2280.32) with Pair, AA



PokerStars Game #00327535318: Hold'em No Limit ($50/$100 USD) - 2022/04/30 10:20:15 ET
Table 'Hold'em (Min 25KMax 10K)    69' 6-max Seat #6 is the button
Seat 1: Lucifer999 ($10091.2 in chips) 
Seat 5: tabby20 ($27496.38 in chips) 
Seat 6: DM0507 ($3564.38 in chips) 
Lucifer999: posts small blind $50
tabby20: posts big blind $100
*** HOLE CARDS ***
Dealt to Lucifer999 [5d 9h]
DM0507: calls $100
Lucifer999: folds
tabby20: checks
*** FLOP *** [Qc Td Ts]
tabby20: checks
DM0507: bets $119.5
tabby20: folds
Uncalled bet ($119.5) returned to DM0507
DM0507: doesn't show hand
DM0507 collected $239 from pot
*** SUMMARY ***
Total pot $250.00 | Rake $11
Board [Qc Td Ts]
Seat 1: Lucifer999 (small blind) folded before Flop
Seat 5: tabby20 (big blind) folded on the Flop
Seat 6: DM0507 (button) collected ($239)



PokerStars Game #00327535387: Hold'em No Limit ($10/$25 USD) - 2022/04/30 10:20:36 ET
Table 'Hold'em (Min 500Max 2500) 1001' 6-max Seat #6 is the button
Seat 1: JaspritBumrah786 ($2025 in chips) 
Seat 2: fishfry123 ($1485.94 in chips) 
Seat 3: allthebest ($2306.85 in chips) 
Seat 4: devi7 ($2731.39 in chips) 
Seat 5: Lucifer999 ($4700.58 in chips) 
Seat 6: spidy02 ($4444 in chips) 
JaspritBumrah786: posts small blind $10
allthebest: posts big blind $25
*** HOLE CARDS ***
Dealt to Lucifer999 [8c Ac]
devi7: folds
Lucifer999: folds
spidy02: folds
JaspritBumrah786: folds
Uncalled bet ($15) returned to allthebest
allthebest: doesn't show hand
allthebest collected $20 from pot
*** SUMMARY ***
Total pot $20.00 | Rake $0
Board []
Seat 1: JaspritBumrah786 (small blind) folded before Flop
Seat 3: allthebest (big blind) collected ($20)
Seat 4: devi7 folded before Flop (didn't bet)
Seat 5: Lucifer999 folded before Flop (didn't bet)
Seat 6: spidy02 (button) folded before Flop (didn't bet)



PokerStars Game #00327535406: Hold'em No Limit ($50/$100 USD) - 2022/04/30 10:20:41 ET
Table 'Hold'em (Min 25KMax 10K)    69' 6-max Seat #1 is the button
Seat 1: Lucifer999 ($10041.2 in chips) 
Seat 5: tabby20 ($27396.38 in chips) 
Seat 6: DM0507 ($3703.38 in chips) 
tabby20: posts small blind $50
DM0507: posts big blind $100
*** HOLE CARDS ***
Dealt to Lucifer999 [Ks Js]
Lucifer999: folds
tabby20: folds
Uncalled bet ($50) returned to DM0507
DM0507: doesn't show hand
DM0507 collected $100 from pot
*** SUMMARY ***
Total pot $100.00 | Rake $0
Board []
Seat 1: Lucifer999 (button) folded before Flop (didn't bet)
Seat 5: tabby20 (small blind) folded before Flop
Seat 6: DM0507 (big blind) collected ($100)



PokerStars Game #00327535389: Hold'em No Limit ($10/$25 USD) - 2022/04/30 10:20:37 ET
Table 'Hold'em (Min 500Max 2500)  1282' 6-max Seat #5 is the button
Seat 4: papadickkies ($876.33 in chips) 
Seat 5: Lucifer999 ($6296.45 in chips) 
Seat 6: devi7 ($2500.53 in chips) 
devi7: posts small blind $10
papadickkies: posts big blind $25
*** HOLE CARDS ***
Dealt to Lucifer999 [9c Ah]
Lucifer999: raises $55.00 to $80
devi7: folds
papadickkies: folds
Uncalled bet ($55) returned to Lucifer999
Lucifer999: doesn't show hand
Lucifer999 collected $60 from pot
*** SUMMARY ***
Total pot $60.00 | Rake $0
Board []
Seat 4: papadickkies (big blind) folded before Flop
Seat 5: Lucifer999 (button) collected ($60)
Seat 6: devi7 (small blind) folded before Flop



PokerStars Game #00327535476: Hold'em No Limit ($10/$25 USD) - 2022/04/30 10:21:03 ET
Table 'Hold'em (Min 500Max 2500)  1282' 6-max Seat #6 is the button
Seat 4: papadickkies ($851.33 in chips) 
Seat 5: Lucifer999 ($6331.45 in chips) 
Seat 6: devi7 ($2490.53 in chips) 
papadickkies: posts small blind $10
Lucifer999: posts big blind $25
*** HOLE CARDS ***
Dealt to Lucifer999 [8h Jd]
devi7: folds
papadickkies: folds
Uncalled bet ($15) returned to Lucifer999
Lucifer999: doesn't show hand
Lucifer999 collected $20 from pot
*** SUMMARY ***
Total pot $20.00 | Rake $0
Board []
Seat 4: papadickkies (small blind) folded before Flop
Seat 5: Lucifer999 (big blind) collected ($20)
Seat 6: devi7 (button) folded before Flop (didn't bet)



PokerStars Game #00327535405: Hold'em No Limit ($25/$50 USD) - 2022/04/30 10:20:40 ET
Table 'Hold'em (Min 1K Max 5K)   216' 6-max Seat #2 is the button
Seat 1: Lucifer999 ($11828.54 in chips) 
Seat 2: rahulh1 ($2808.51 in chips) 
Seat 3: bettercall7208 ($8587.85 in chips) 
Seat 4: No username ($1868.88 in chips) 
Seat 5: Abtugaya ($1211.5 in chips) 
Seat 6: Pablit0 ($4560.65 in chips) 
bettercall7208: posts small blind $25
No username: posts big blind $50
*** HOLE CARDS ***
Dealt to Lucifer999 [Tc 5d]
Abtugaya: calls $50
Pablit0: folds
Lucifer999: folds
rahulh1: folds
bettercall7208: folds
No username: checks
*** FLOP *** [8d 6d 9h]
No username: checks
Abtugaya: checks
*** TURN *** [8d 6d 9h] [5h]
No username: checks
Abtugaya: bets $103.76
No username: folds
Uncalled bet ($103.76) returned to Abtugaya
Abtugaya: doesn't show hand
Abtugaya collected $118.75 from pot
*** SUMMARY ***
Total pot $125.00 | Rake $6.25
Board [8d 6d 9h 5h]
Seat 1: Lucifer999 folded before Flop (didn't bet)
Seat 2: rahulh1 (button) folded before Flop (didn't bet)
Seat 3: bettercall7208 (small blind) folded before Flop
Seat 4: No username (big blind) folded on the Turn
Seat 5: Abtugaya collected ($118.75)
Seat 6: Pablit0 folded before Flop (didn't bet)



PokerStars Game #00327535474: Hold'em No Limit ($10/$25 USD) - 2022/04/30 10:21:03 ET
Table 'Hold'em (Min 500Max 2500) 1001' 6-max Seat #1 is the button
Seat 1: JaspritBumrah786 ($2015 in chips) 
Seat 2: fishfry123 ($1485.94 in chips) 
Seat 3: allthebest ($2316.85 in chips) 
Seat 4: devi7 ($2731.39 in chips) 
Seat 5: Lucifer999 ($4700.58 in chips) 
Seat 6: spidy02 ($4444 in chips) 
allthebest: posts small blind $10
devi7: posts big blind $25
*** HOLE CARDS ***
Dealt to Lucifer999 [7d Qh]
Lucifer999: folds
spidy02: folds
JaspritBumrah786: folds
allthebest: folds
Uncalled bet ($15) returned to devi7
devi7: doesn't show hand
devi7 collected $20 from pot
*** SUMMARY ***
Total pot $20.00 | Rake $0
Board []
Seat 1: JaspritBumrah786 (button) folded before Flop (didn't bet)
Seat 3: allthebest (small blind) folded before Flop
Seat 4: devi7 (big blind) collected ($20)
Seat 5: Lucifer999 folded before Flop (didn't bet)
Seat 6: spidy02 folded before Flop (didn't bet)



PokerStars Game #00327535469: Hold'em No Limit ($50/$100 USD) - 2022/04/30 10:21:02 ET
Table 'Hold'em (Min 25KMax 10K)    69' 6-max Seat #5 is the button
Seat 1: Lucifer999 ($10041.2 in chips) 
Seat 5: tabby20 ($27346.38 in chips) 
Seat 6: DM0507 ($3753.38 in chips) 
DM0507: posts small blind $50
Lucifer999: posts big blind $100
*** HOLE CARDS ***
Dealt to Lucifer999 [Jh 5d]
tabby20: folds
DM0507: calls $50
Lucifer999: checks
*** FLOP *** [4d 2s Td]
DM0507: checks
Lucifer999: bets $100
DM0507: folds
Uncalled bet ($100) returned to Lucifer999
Lucifer999: doesn't show hand
Lucifer999 collected $191.2 from pot
*** SUMMARY ***
Total pot $200.00 | Rake $8.8
Board [4d 2s Td]
Seat 1: Lucifer999 (big blind) collected ($191.2)
Seat 5: tabby20 (button) folded before Flop (didn't bet)
Seat 6: DM0507 (small blind) folded on the Flop



PokerStars Game #00327535515: Hold'em No Limit ($10/$25 USD) - 2022/04/30 10:21:16 ET
Table 'Hold'em (Min 500Max 2500)  1282' 6-max Seat #4 is the button
Seat 4: papadickkies ($841.33 in chips) 
Seat 5: Lucifer999 ($6341.45 in chips) 
Seat 6: devi7 ($2490.53 in chips) 
Lucifer999: posts small blind $10
devi7: posts big blind $25
*** HOLE CARDS ***
Dealt to Lucifer999 [Ad 8c]
papadickkies: folds
Lucifer999: raises $55.00 to $80
devi7: calls $55
*** FLOP *** [4c 5c 4h]
Lucifer999: bets $125
devi7: folds
Uncalled bet ($125) returned to Lucifer999
Lucifer999: doesn't show hand
Lucifer999 collected $151.6 from pot
*** SUMMARY ***
Total pot $160.00 | Rake $8.4
Board [4c 5c 4h]
Seat 4: papadickkies (button) folded before Flop (didn't bet)
Seat 5: Lucifer999 (small blind) collected ($151.6)
Seat 6: devi7 (big blind) folded on the Flop



PokerStars Game #00327535570: Hold'em No Limit ($10/$25 USD) - 2022/04/30 10:21:33 ET
Table 'Hold'em (Min 500Max 2500) 1001' 6-max Seat #3 is the button
Seat 1: JaspritBumrah786 ($2015 in chips) 
Seat 2: fishfry123 ($1485.94 in chips) 
Seat 3: allthebest ($2306.85 in chips) 
Seat 4: devi7 ($2741.39 in chips) 
Seat 5: Lucifer999 ($4700.58 in chips) 
Seat 6: spidy02 ($4444 in chips) 
devi7: posts small blind $10
Lucifer999: posts big blind $25
*** HOLE CARDS ***
Dealt to Lucifer999 [7s 8d]
spidy02: folds
JaspritBumrah786: folds
allthebest: folds
devi7: raises $55.00 to $80
Lucifer999: calls $55
*** FLOP *** [7d 6c Qc]
devi7: checks
Lucifer999: bets $95
devi7: folds
Uncalled bet ($95) returned to Lucifer999
Lucifer999: doesn't show hand
Lucifer999 collected $150.6 from pot
*** SUMMARY ***
Total pot $160.00 | Rake $9.4
Board [7d 6c Qc]
Seat 1: JaspritBumrah786 folded before Flop (didn't bet)
Seat 3: allthebest (button) folded before Flop (didn't bet)
Seat 4: devi7 (small blind) folded on the Flop
Seat 5: Lucifer999 (big blind) collected ($150.6)
Seat 6: spidy02 folded before Flop (didn't bet)



PokerStars Game #00327535585: Hold'em No Limit ($50/$100 USD) - 2022/04/30 10:21:37 ET
Table 'Hold'em (Min 25KMax 10K)    69' 6-max Seat #6 is the button
Seat 1: Lucifer999 ($10132.4 in chips) 
Seat 5: tabby20 ($27346.38 in chips) 
Seat 6: DM0507 ($3653.38 in chips) 
Lucifer999: posts small blind $50
tabby20: posts big blind $100
*** HOLE CARDS ***
Dealt to Lucifer999 [5d 2s]
DM0507: calls $100
Lucifer999: folds
tabby20: checks
*** FLOP *** [2h 8s 6c]
tabby20: bets $300
DM0507: raises $839.00 to $1139
tabby20: raises $26107.38 to $27246.38
DM0507: calls $2414.38
Uncalled bet ($23693) returned to tabby20
*** TURN *** [2h 8s 6c] [Qh]
*** TURN *** [2h 8s 6c] [As]
*** RIVER *** [2h 8s 6c Qh] [3h]
*** RIVER *** [2h 8s 6c Qh] [Jd]
*** SHOW DOWN ***
tabby20: shows [7h 8h] (Pair, 88)
DM0507: shows [9d 9c] (Pair, 99)
tabby20 collected $3516.55 from pot
DM0507 collected $3516.55 from pot
*** SUMMARY ***
Total pot $7356.76 | Rake $323.66
Board [2h 8s 6c Qh 3h]
Seat 1: Lucifer999 (small blind) folded before Flop
Seat 5: tabby20  (big blind) showed [7h 8h] and won ($3516.55) with Pair, 88
Seat 6: DM0507  (button) showed [9d 9c] and won ($3516.55) with Pair, 99



PokerStars Game #00327535521: Hold'em No Limit ($25/$50 USD) - 2022/04/30 10:21:19 ET
Table 'Hold'em (Min 1K Max 5K)   216' 6-max Seat #3 is the button
Seat 1: Lucifer999 ($11828.54 in chips) 
Seat 2: rahulh1 ($2808.51 in chips) 
Seat 3: bettercall7208 ($8562.85 in chips) 
Seat 4: No username ($1818.88 in chips) 
Seat 5: Abtugaya ($1280.25 in chips) 
Seat 6: Pablit0 ($4560.65 in chips) 
No username: posts small blind $25
Abtugaya: posts big blind $50
*** HOLE CARDS ***
Dealt to Lucifer999 [4c 3c]
Pablit0: folds
Lucifer999: folds
rahulh1: calls $50
bettercall7208: calls $50
No username: calls $25
Abtugaya: checks
*** FLOP *** [3d 5s 7c]
No username: checks
Abtugaya: checks
rahulh1: checks
bettercall7208: bets $190
No username: folds
Abtugaya: folds
rahulh1: calls $190
*** TURN *** [3d 5s 7c] [9c]
rahulh1: checks
bettercall7208: bets $551
rahulh1: raises $551.00 to $1102
bettercall7208: calls $551
*** RIVER *** [3d 5s 7c 9c] [2h]
rahulh1: bets $694
bettercall7208: calls $694
*** SHOW DOWN ***
rahulh1: shows [Ad 9d] (Pair, 99)
bettercall7208: shows [7s 5c] (Two pairs, 7755)
bettercall7208 collected $3963.4 from pot
*** SUMMARY ***
Total pot $4172.00 | Rake $208.6
Board [3d 5s 7c 9c 2h]
Seat 1: Lucifer999 folded before Flop (didn't bet)
Seat 2: rahulh1 showed [Ad 9d] and lost with Pair, 99
Seat 3: bettercall7208  (button) showed [7s 5c] and won ($3963.4) with Two pairs, 7755
Seat 4: No username (small blind) folded on the Flop
Seat 5: Abtugaya (big blind) folded on the Flop
Seat 6: Pablit0 folded before Flop (didn't bet)



PokerStars Game #00327535628: Hold'em No Limit ($10/$25 USD) - 2022/04/30 10:21:54 ET
Table 'Hold'em (Min 500Max 2500)  1282' 6-max Seat #5 is the button
Seat 4: papadickkies ($841.33 in chips) 
Seat 5: Lucifer999 ($6413.05 in chips) 
Seat 6: devi7 ($2410.53 in chips) 
devi7: posts small blind $10
papadickkies: posts big blind $25
*** HOLE CARDS ***
Dealt to Lucifer999 [7h 9d]
Lucifer999: folds
devi7: raises $55.00 to $80
papadickkies: folds
Uncalled bet ($55) returned to devi7
devi7: doesn't show hand
devi7 collected $50 from pot
*** SUMMARY ***
Total pot $50.00 | Rake $0
Board []
Seat 4: papadickkies (big blind) folded before Flop
Seat 5: Lucifer999 (button) folded before Flop (didn't bet)
Seat 6: devi7 (small blind) collected ($50)



PokerStars Game #00327535714: Hold'em No Limit ($10/$25 USD) - 2022/04/30 10:22:21 ET
Table 'Hold'em (Min 500Max 2500)  1282' 6-max Seat #6 is the button
Seat 4: papadickkies ($816.33 in chips) 
Seat 5: Lucifer999 ($6413.05 in chips) 
Seat 6: devi7 ($2435.53 in chips) 
papadickkies: posts small blind $10
Lucifer999: posts big blind $25
*** HOLE CARDS ***
Dealt to Lucifer999 [Td 9s]
devi7: folds
papadickkies: folds
Uncalled bet ($15) returned to Lucifer999
Lucifer999: doesn't show hand
Lucifer999 collected $20 from pot
*** SUMMARY ***
Total pot $20.00 | Rake $0
Board []
Seat 4: papadickkies (small blind) folded before Flop
Seat 5: Lucifer999 (big blind) collected ($20)
Seat 6: devi7 (button) folded before Flop (didn't bet)



PokerStars Game #00327535699: Hold'em No Limit ($50/$100 USD) - 2022/04/30 10:22:15 ET
Table 'Hold'em (Min 25KMax 10K)    69' 6-max Seat #1 is the button
Seat 1: Lucifer999 ($10082.4 in chips) 
Seat 5: tabby20 ($27209.55 in chips) 
Seat 6: DM0507 ($3516.55 in chips) 
tabby20: posts small blind $50
DM0507: posts big blind $100
*** HOLE CARDS ***
Dealt to Lucifer999 [6s 2h]
Lucifer999: folds
tabby20: folds
Uncalled bet ($50) returned to DM0507
DM0507: doesn't show hand
DM0507 collected $100 from pot
*** SUMMARY ***
Total pot $100.00 | Rake $0
Board []
Seat 1: Lucifer999 (button) folded before Flop (didn't bet)
Seat 5: tabby20 (small blind) folded before Flop
Seat 6: DM0507 (big blind) collected ($100)



PokerStars Game #00327535750: Hold'em No Limit ($10/$25 USD) - 2022/04/30 10:22:33 ET
Table 'Hold'em (Min 500Max 2500)  1282' 6-max Seat #4 is the button
Seat 4: papadickkies ($806.33 in chips) 
Seat 5: Lucifer999 ($6423.05 in chips) 
Seat 6: devi7 ($2435.53 in chips) 
Lucifer999: posts small blind $10
devi7: posts big blind $25
*** HOLE CARDS ***
Dealt to Lucifer999 [Qh 3d]
papadickkies: folds
Lucifer999: folds
Uncalled bet ($15) returned to devi7
devi7: doesn't show hand
devi7 collected $20 from pot
*** SUMMARY ***
Total pot $20.00 | Rake $0
Board []
Seat 4: papadickkies (button) folded before Flop (didn't bet)
Seat 5: Lucifer999 (small blind) folded before Flop
Seat 6: devi7 (big blind) collected ($20)



PokerStars Game #00327535712: Hold'em No Limit ($25/$50 USD) - 2022/04/30 10:22:19 ET
Table 'Hold'em (Min 1K Max 5K)   216' 6-max Seat #4 is the button
Seat 1: Lucifer999 ($11828.54 in chips) 
Seat 2: rahulh1 ($772.51 in chips) 
Seat 3: bettercall7208 ($10490.25 in chips) 
Seat 4: No username ($1768.88 in chips) 
Seat 5: Abtugaya ($1230.25 in chips) 
Seat 6: Pablit0 ($4560.65 in chips) 
Abtugaya: posts small blind $25
Pablit0: posts big blind $50
*** HOLE CARDS ***
Dealt to Lucifer999 [4d 7c]
Lucifer999: folds
rahulh1: raises $78.17 to $128.17
bettercall7208: folds
No username: folds
Abtugaya: calls $103.17
Pablit0: folds
*** FLOP *** [8d 9h 3h]
Abtugaya: checks
rahulh1: bets $106.14
Abtugaya: raises $743.54 to $849.68
rahulh1: calls $538.2
Uncalled bet ($205.34) returned to Abtugaya
*** TURN *** [8d 9h 3h] [Qd]
*** TURN *** [8d 9h 3h] [5h]
*** RIVER *** [8d 9h 3h Qd] [2s]
*** RIVER *** [8d 9h 3h Qd] [Jc]
*** SHOW DOWN ***
rahulh1: shows [Jh Th] (Flush, J high)
Abtugaya: shows [8h Ac] (Pair, 88)
rahulh1 collected $757.64 from pot
rahulh1 collected $757.63 from pot
*** SUMMARY ***
Total pot $1595.02 | Rake $79.75
Board [8d 9h 3h Qd 2s]
Seat 1: Lucifer999 folded before Flop (didn't bet)
Seat 2: rahulh1  showed [Jh Th] and won ($757.63) with Flush, J high
Seat 3: bettercall7208 folded before Flop (didn't bet)
Seat 4: No username (button) folded before Flop (didn't bet)
Seat 5: Abtugaya (small blind) showed [8h Ac] and lost with Pair, 88
Seat 6: Pablit0 (big blind) folded before Flop



PokerStars Game #00327535797: Hold'em No Limit ($10/$25 USD) - 2022/04/30 10:22:49 ET
Table 'Hold'em (Min 500Max 2500)  1282' 6-max Seat #5 is the button
Seat 4: papadickkies ($806.33 in chips) 
Seat 5: Lucifer999 ($6413.05 in chips) 
Seat 6: devi7 ($2445.53 in chips) 
devi7: posts small blind $10
papadickkies: posts big blind $25
*** HOLE CARDS ***
Dealt to Lucifer999 [2c 5d]
Lucifer999: folds
devi7: raises $55.00 to $80
papadickkies: folds
Uncalled bet ($55) returned to devi7
devi7: doesn't show hand
devi7 collected $50 from pot
*** SUMMARY ***
Total pot $50.00 | Rake $0
Board []
Seat 4: papadickkies (big blind) folded before Flop
Seat 5: Lucifer999 (button) folded before Flop (didn't bet)
Seat 6: devi7 (small blind) collected ($50)



PokerStars Game #00327535694: Hold'em No Limit ($10/$25 USD) - 2022/04/30 10:22:14 ET
Table 'Hold'em (Min 500Max 2500) 1001' 6-max Seat #4 is the button
Seat 1: JaspritBumrah786 ($2015 in chips) 
Seat 2: fishfry123 ($1485.94 in chips) 
Seat 3: allthebest ($2306.85 in chips) 
Seat 4: devi7 ($2661.39 in chips) 
Seat 5: Lucifer999 ($4771.18 in chips) 
Seat 6: spidy02 ($4444 in chips) 
Lucifer999: posts small blind $10
spidy02: posts big blind $25
*** HOLE CARDS ***
Dealt to Lucifer999 [Th 7s]
JaspritBumrah786: folds
allthebest: folds
devi7: raises $50.00 to $75
Lucifer999: folds
spidy02: raises $107.50 to $182.5
devi7: calls $107.5
*** FLOP *** [5h As Qs]
spidy02: checks
devi7: checks
*** TURN *** [5h As Qs] [7d]
spidy02: checks
devi7: bets $125
spidy02: calls $125
*** RIVER *** [5h As Qs 7d] [Ks]
spidy02: bets $293.6
devi7: folds
Uncalled bet ($293.6) returned to spidy02
spidy02: doesn't show hand
spidy02 collected $587.19 from pot
*** SUMMARY ***
Total pot $625.00 | Rake $37.81
Board [5h As Qs 7d Ks]
Seat 1: JaspritBumrah786 folded before Flop (didn't bet)
Seat 3: allthebest folded before Flop (didn't bet)
Seat 4: devi7 (button) folded on the River
Seat 5: Lucifer999 (small blind) folded before Flop
Seat 6: spidy02 (big blind) collected ($587.19)



PokerStars Game #00327535756: Hold'em No Limit ($50/$100 USD) - 2022/04/30 10:22:35 ET
Table 'Hold'em (Min 25KMax 10K)    69' 6-max Seat #5 is the button
Seat 1: Lucifer999 ($10082.4 in chips) 
Seat 5: tabby20 ($27159.55 in chips) 
Seat 6: DM0507 ($3566.55 in chips) 
DM0507: posts small blind $50
Lucifer999: posts big blind $100
*** HOLE CARDS ***
Dealt to Lucifer999 [Jd 5d]
tabby20: folds
DM0507: calls $50
Lucifer999: raises $250.00 to $350
DM0507: calls $250
*** FLOP *** [Tc 2s 5h]
DM0507: checks
Lucifer999: checks
*** TURN *** [Tc 2s 5h] [Kc]
DM0507: checks
Lucifer999: bets $300
DM0507: folds
Uncalled bet ($300) returned to Lucifer999
Lucifer999: doesn't show hand
Lucifer999 collected $669.2 from pot
*** SUMMARY ***
Total pot $700.00 | Rake $30.8
Board [Tc 2s 5h Kc]
Seat 1: Lucifer999 (big blind) collected ($669.2)
Seat 5: tabby20 (button) folded before Flop (didn't bet)
Seat 6: DM0507 (small blind) folded on the Turn



PokerStars Game #00327535895: Hold'em No Limit ($50/$100 USD) - 2022/04/30 10:23:20 ET
Table 'Hold'em (Min 25KMax 10K)    69' 6-max Seat #6 is the button
Seat 1: Lucifer999 ($10401.6 in chips) 
Seat 5: tabby20 ($27159.55 in chips) 
Seat 6: DM0507 ($3216.55 in chips) 
Lucifer999: posts small blind $50
tabby20: posts big blind $100
*** HOLE CARDS ***
Dealt to Lucifer999 [6c Qd]
DM0507: folds
Lucifer999: raises $200.00 to $300
tabby20: folds
Uncalled bet ($200) returned to Lucifer999
Lucifer999: doesn't show hand
Lucifer999 collected $200 from pot
*** SUMMARY ***
Total pot $200.00 | Rake $0
Board []
Seat 1: Lucifer999 (small blind) collected ($200)
Seat 5: tabby20 (big blind) folded before Flop
Seat 6: DM0507 (button) folded before Flop (didn't bet)



PokerStars Game #00327535888: Hold'em No Limit ($10/$25 USD) - 2022/04/30 10:23:18 ET
Table 'Hold'em (Min 500Max 2500) 1001' 6-max Seat #5 is the button
Seat 1: JaspritBumrah786 ($2015 in chips) 
Seat 2: fishfry123 ($1485.94 in chips) 
Seat 3: allthebest ($2306.85 in chips) 
Seat 4: devi7 ($2353.89 in chips) 
Seat 5: Lucifer999 ($4761.18 in chips) 
Seat 6: spidy02 ($4723.69 in chips) 
spidy02: posts small blind $10
JaspritBumrah786: posts big blind $25
*** HOLE CARDS ***
Dealt to Lucifer999 [Qd 5s]
devi7: folds
Lucifer999: folds
spidy02: folds
Uncalled bet ($15) returned to JaspritBumrah786
JaspritBumrah786: doesn't show hand
JaspritBumrah786 collected $20 from pot
*** SUMMARY ***
Total pot $20.00 | Rake $0
Board []
Seat 1: JaspritBumrah786 (big blind) collected ($20)
Seat 4: devi7 folded before Flop (didn't bet)
Seat 5: Lucifer999 (button) folded before Flop (didn't bet)
Seat 6: spidy02 (small blind) folded before Flop



PokerStars Game #00327535813: Hold'em No Limit ($25/$50 USD) - 2022/04/30 10:22:54 ET
Table 'Hold'em (Min 1K Max 5K)   216' 6-max Seat #5 is the button
Seat 1: Lucifer999 ($11828.54 in chips) 
Seat 2: rahulh1 ($1515.27 in chips) 
Seat 3: bettercall7208 ($10490.25 in chips) 
Seat 4: No username ($1768.88 in chips) 
Seat 5: Abtugaya ($457.74 in chips) 
Seat 6: Pablit0 ($4510.65 in chips) 
Pablit0: posts small blind $25
Lucifer999: posts big blind $50
*** HOLE CARDS ***
Dealt to Lucifer999 [7s 4s]
rahulh1: folds
bettercall7208: folds
No username: raises $66.67 to $116.67
Abtugaya: raises $341.07 to $457.74
Pablit0: folds
Lucifer999: folds
No username: calls $341.07
*** FLOP *** [Kc Ts Js]
*** FLOP *** [Kh Ks Qs]
*** TURN *** [Kc Ts Js] [3h]
*** TURN *** [Kc Ts Js] [Kd]
*** RIVER *** [Kc Ts Js 3h] [7h]
*** RIVER *** [Kc Ts Js 3h] [Tc]
*** SHOW DOWN ***
No username: shows [5d 5s] (Full house, KKK55)
Abtugaya: shows [4h Ad] (Three of a kind, KKK)
No username collected $470.49 from pot
No username collected $470.49 from pot
*** SUMMARY ***
Total pot $990.48 | Rake $49.5
Board [Kc Ts Js 3h 7h]
Seat 1: Lucifer999 (big blind) folded before Flop
Seat 2: rahulh1 folded before Flop (didn't bet)
Seat 3: bettercall7208 folded before Flop (didn't bet)
Seat 4: No username  showed [5d 5s] and won ($470.49) with Full house, KKK55
Seat 5: Abtugaya (button) showed [4h Ad] and lost with Three of a kind, KKK
Seat 6: Pablit0 (small blind) folded before Flop



PokerStars Game #00327535945: Hold'em No Limit ($50/$100 USD) - 2022/04/30 10:23:36 ET
Table 'Hold'em (Min 25KMax 10K)    69' 6-max Seat #1 is the button
Seat 1: Lucifer999 ($10501.6 in chips) 
Seat 5: tabby20 ($27059.55 in chips) 
Seat 6: DM0507 ($3216.55 in chips) 
tabby20: posts small blind $50
DM0507: posts big blind $100
*** HOLE CARDS ***
Dealt to Lucifer999 [6d 2h]
Lucifer999: folds
tabby20: folds
Uncalled bet ($50) returned to DM0507
DM0507: doesn't show hand
DM0507 collected $100 from pot
*** SUMMARY ***
Total pot $100.00 | Rake $0
Board []
Seat 1: Lucifer999 (button) folded before Flop (didn't bet)
Seat 5: tabby20 (small blind) folded before Flop
Seat 6: DM0507 (big blind) collected ($100)



PokerStars Game #00327535959: Hold'em No Limit ($10/$25 USD) - 2022/04/30 10:23:40 ET
Table 'Hold'em (Min 500Max 2500) 1001' 6-max Seat #6 is the button
Seat 1: JaspritBumrah786 ($2060 in chips) 
Seat 2: fishfry123 ($1485.94 in chips) 
Seat 4: devi7 ($2353.89 in chips) 
Seat 5: Lucifer999 ($4761.18 in chips) 
Seat 6: spidy02 ($4713.69 in chips) 
JaspritBumrah786: posts small blind $10
devi7: posts big blind $25
*** HOLE CARDS ***
Dealt to Lucifer999 [Js 5c]
Lucifer999: folds
spidy02: folds
JaspritBumrah786: folds
Uncalled bet ($15) returned to devi7
devi7: doesn't show hand
devi7 collected $20 from pot
*** SUMMARY ***
Total pot $20.00 | Rake $0
Board []
Seat 1: JaspritBumrah786 (small blind) folded before Flop
Seat 4: devi7 (big blind) collected ($20)
Seat 5: Lucifer999 folded before Flop (didn't bet)
Seat 6: spidy02 (button) folded before Flop (didn't bet)



PokerStars Game #00327535877: Hold'em No Limit ($10/$25 USD) - 2022/04/30 10:23:15 ET
Table 'Hold'em (Min 500Max 2500)  1282' 6-max Seat #6 is the button
Seat 4: papadickkies ($781.33 in chips) 
Seat 5: Lucifer999 ($6413.05 in chips) 
Seat 6: devi7 ($2470.53 in chips) 
papadickkies: posts small blind $10
Lucifer999: posts big blind $25
*** HOLE CARDS ***
Dealt to Lucifer999 [Ad 6h]
devi7: raises $50.00 to $75
papadickkies: calls $65
Lucifer999: folds
*** FLOP *** [9c Ks Jh]
papadickkies: checks
devi7: checks
*** TURN *** [9c Ks Jh] [3d]
papadickkies: checks
devi7: bets $125
papadickkies: calls $125
*** RIVER *** [9c Ks Jh 3d] [Qc]
papadickkies: bets $581.33
devi7: folds
Uncalled bet ($581.33) returned to papadickkies
papadickkies: doesn't show hand
papadickkies collected $402.69 from pot
*** SUMMARY ***
Total pot $425.00 | Rake $22.31
Board [9c Ks Jh 3d Qc]
Seat 4: papadickkies (small blind) collected ($402.69)
Seat 5: Lucifer999 (big blind) folded before Flop
Seat 6: devi7 (button) folded on the River



PokerStars Game #00327536030: Hold'em No Limit ($10/$25 USD) - 2022/04/30 10:24:02 ET
Table 'Hold'em (Min 500Max 2500) 1001' 6-max Seat #1 is the button
Seat 1: JaspritBumrah786 ($2050 in chips) 
Seat 2: fishfry123 ($1485.94 in chips) 
Seat 4: devi7 ($2363.89 in chips) 
Seat 5: Lucifer999 ($4761.18 in chips) 
Seat 6: spidy02 ($4713.69 in chips) 
devi7: posts small blind $10
Lucifer999: posts big blind $25
*** HOLE CARDS ***
Dealt to Lucifer999 [6s Kh]
spidy02: raises $38.75 to $63.75
JaspritBumrah786: folds
devi7: folds
Lucifer999: folds
Uncalled bet ($38.75) returned to spidy02
spidy02: doesn't show hand
spidy02 collected $60 from pot
*** SUMMARY ***
Total pot $60.00 | Rake $0
Board []
Seat 1: JaspritBumrah786 (button) folded before Flop (didn't bet)
Seat 4: devi7 (small blind) folded before Flop
Seat 5: Lucifer999 (big blind) folded before Flop
Seat 6: spidy02 collected ($60)



PokerStars Game #00327536069: Hold'em No Limit ($10/$25 USD) - 2022/04/30 10:24:14 ET
Table 'Hold'em (Min 500Max 2500)  1282' 6-max Seat #4 is the button
Seat 4: papadickkies ($984.02 in chips) 
Seat 5: Lucifer999 ($6388.05 in chips) 
Seat 6: devi7 ($2270.53 in chips) 
Lucifer999: posts small blind $10
devi7: posts big blind $25
*** HOLE CARDS ***
Dealt to Lucifer999 [3h Ah]
papadickkies: folds
Lucifer999: raises $55.00 to $80
devi7: folds
Uncalled bet ($55) returned to Lucifer999
Lucifer999: doesn't show hand
Lucifer999 collected $50 from pot
*** SUMMARY ***
Total pot $50.00 | Rake $0
Board []
Seat 4: papadickkies (button) folded before Flop (didn't bet)
Seat 5: Lucifer999 (small blind) collected ($50)
Seat 6: devi7 (big blind) folded before Flop



PokerStars Game #00327536013: Hold'em No Limit ($50/$100 USD) - 2022/04/30 10:23:56 ET
Table 'Hold'em (Min 25KMax 10K)    69' 6-max Seat #5 is the button
Seat 1: Lucifer999 ($10501.6 in chips) 
Seat 5: tabby20 ($27009.55 in chips) 
Seat 6: DM0507 ($3266.55 in chips) 
DM0507: posts small blind $50
Lucifer999: posts big blind $100
*** HOLE CARDS ***
Dealt to Lucifer999 [Th 6h]
tabby20: folds
DM0507: calls $50
Lucifer999: raises $250.00 to $350
DM0507: calls $250
*** FLOP *** [Td 6c Kh]
DM0507: checks
Lucifer999: bets $550
DM0507: calls $550
*** TURN *** [Td 6c Kh] [8d]
DM0507: checks
Lucifer999: bets $9601.6
DM0507: calls $2366.55
Uncalled bet ($7235.05) returned to Lucifer999
*** RIVER *** [Td 6c Kh 8d] [4s]
*** RIVER *** [Td 6c Kh 8d] [2c]
*** SHOW DOWN ***
Lucifer999: shows [Th 6h] (Two pairs, TT66)
DM0507: shows [Kd 2d] (Two pairs, KK22)
Lucifer999 collected $3122.83 from pot
DM0507 collected $3122.82 from pot
*** SUMMARY ***
Total pot $6533.10 | Rake $287.45
Board [Td 6c Kh 8d 4s]
Seat 1: Lucifer999  (big blind) showed [Th 6h] and won ($3122.83) with Two pairs, TT66
Seat 5: tabby20 (button) folded before Flop (didn't bet)
Seat 6: DM0507  (small blind) showed [Kd 2d] and won ($3122.82) with Two pairs, KK22



PokerStars Game #00327535969: Hold'em No Limit ($25/$50 USD) - 2022/04/30 10:23:43 ET
Table 'Hold'em (Min 1K Max 5K)   216' 6-max Seat #6 is the button
Seat 1: Lucifer999 ($11778.54 in chips) 
Seat 2: rahulh1 ($1515.27 in chips) 
Seat 3: bettercall7208 ($10490.25 in chips) 
Seat 4: No username ($2252.12 in chips) 
Seat 6: Pablit0 ($4485.65 in chips) 
Lucifer999: posts small blind $25
rahulh1: posts big blind $50
*** HOLE CARDS ***
Dealt to Lucifer999 [Qs Kh]
bettercall7208: folds
No username: folds
Pablit0: folds
Lucifer999: raises $100.00 to $150
rahulh1: calls $100
*** FLOP *** [8s 5s 7c]
Lucifer999: checks
rahulh1: checks
*** TURN *** [8s 5s 7c] [Kd]
Lucifer999: bets $150
rahulh1: calls $150
*** RIVER *** [8s 5s 7c Kd] [3d]
Lucifer999: bets $400
rahulh1: folds
Uncalled bet ($400) returned to Lucifer999
Lucifer999: doesn't show hand
Lucifer999 collected $570 from pot
*** SUMMARY ***
Total pot $600.00 | Rake $30
Board [8s 5s 7c Kd 3d]
Seat 1: Lucifer999 (small blind) collected ($570)
Seat 2: rahulh1 (big blind) folded on the River
Seat 3: bettercall7208 folded before Flop (didn't bet)
Seat 4: No username folded before Flop (didn't bet)
Seat 6: Pablit0 (button) folded before Flop (didn't bet)



PokerStars Game #00327536126: Hold'em No Limit ($10/$25 USD) - 2022/04/30 10:24:31 ET
Table 'Hold'em (Min 500Max 2500) 1001' 6-max Seat #4 is the button
Seat 1: JaspritBumrah786 ($2050 in chips) 
Seat 4: devi7 ($2353.89 in chips) 
Seat 5: Lucifer999 ($4736.18 in chips) 
Seat 6: spidy02 ($4748.69 in chips) 
Lucifer999: posts small blind $10
spidy02: posts big blind $25
*** HOLE CARDS ***
Dealt to Lucifer999 [Kc Qs]
JaspritBumrah786: folds
devi7: folds
Lucifer999: raises $55.00 to $80
spidy02: raises $136.40 to $216.4
Lucifer999: folds
Uncalled bet ($136.4) returned to spidy02
spidy02: doesn't show hand
spidy02 collected $160 from pot
*** SUMMARY ***
Total pot $160.00 | Rake $0
Board []
Seat 1: JaspritBumrah786 folded before Flop (didn't bet)
Seat 4: devi7 (button) folded before Flop (didn't bet)
Seat 5: Lucifer999 (small blind) folded before Flop
Seat 6: spidy02 (big blind) collected ($160)



PokerStars Game #00327536175: Hold'em No Limit ($50/$100 USD) - 2022/04/30 10:24:45 ET
Table 'Hold'em (Min 25KMax 10K)    69' 6-max Seat #6 is the button
Seat 1: Lucifer999 ($10357.88 in chips) 
Seat 5: tabby20 ($27009.55 in chips) 
Seat 6: DM0507 ($3122.82 in chips) 
Lucifer999: posts small blind $50
tabby20: posts big blind $100
*** HOLE CARDS ***
Dealt to Lucifer999 [3s 2d]
DM0507: calls $100
Lucifer999: folds
tabby20: checks
*** FLOP *** [8d 4d 4s]
tabby20: checks
DM0507: bets $239
tabby20: folds
Uncalled bet ($239) returned to DM0507
DM0507: doesn't show hand
DM0507 collected $239 from pot
*** SUMMARY ***
Total pot $250.00 | Rake $11
Board [8d 4d 4s]
Seat 1: Lucifer999 (small blind) folded before Flop
Seat 5: tabby20 (big blind) folded on the Flop
Seat 6: DM0507 (button) collected ($239)



PokerStars Game #00327536154: Hold'em No Limit ($10/$25 USD) - 2022/04/30 10:24:41 ET
Table 'Hold'em (Min 500Max 2500)  1282' 6-max Seat #5 is the button
Seat 1: foldmybets ($2500 in chips) 
Seat 4: papadickkies ($984.02 in chips) 
Seat 5: Lucifer999 ($6413.05 in chips) 
Seat 6: devi7 ($2245.53 in chips) 
devi7: posts small blind $10
papadickkies: posts big blind $25
*** HOLE CARDS ***
Dealt to Lucifer999 [4s 2s]
Lucifer999: folds
devi7: raises $55.00 to $80
papadickkies: folds
Uncalled bet ($55) returned to devi7
devi7: doesn't show hand
devi7 collected $50 from pot
*** SUMMARY ***
Total pot $50.00 | Rake $0
Board []
Seat 4: papadickkies (big blind) folded before Flop
Seat 5: Lucifer999 (button) folded before Flop (didn't bet)
Seat 6: devi7 (small blind) collected ($50)



PokerStars Game #00327536267: Hold'em No Limit ($10/$25 USD) - 2022/04/30 10:25:13 ET
Table 'Hold'em (Min 500Max 2500)  1282' 6-max Seat #6 is the button
Seat 1: foldmybets ($2500 in chips) 
Seat 4: papadickkies ($959.02 in chips) 
Seat 5: Lucifer999 ($6413.05 in chips) 
Seat 6: devi7 ($2270.53 in chips) 
papadickkies: posts small blind $10
Lucifer999: posts big blind $25
*** HOLE CARDS ***
Dealt to Lucifer999 [6d Ts]
devi7: raises $50.00 to $75
papadickkies: folds
Lucifer999: folds
Uncalled bet ($50) returned to devi7
devi7: doesn't show hand
devi7 collected $60 from pot
*** SUMMARY ***
Total pot $60.00 | Rake $0
Board []
Seat 4: papadickkies (small blind) folded before Flop
Seat 5: Lucifer999 (big blind) folded before Flop
Seat 6: devi7 (button) collected ($60)



PokerStars Game #00327536183: Hold'em No Limit ($25/$50 USD) - 2022/04/30 10:24:49 ET
Table 'Hold'em (Min 1K Max 5K)   216' 6-max Seat #1 is the button
Seat 1: Lucifer999 ($12048.54 in chips) 
Seat 2: rahulh1 ($2065.27 in chips) 
Seat 3: bettercall7208 ($10490.25 in chips) 
Seat 4: No username ($2252.12 in chips) 
Seat 6: Pablit0 ($4485.65 in chips) 
rahulh1: posts small blind $25
bettercall7208: posts big blind $50
*** HOLE CARDS ***
Dealt to Lucifer999 [5c Jh]
No username: folds
Pablit0: calls $50
Lucifer999: folds
rahulh1: calls $25
bettercall7208: checks
*** FLOP *** [Qs 4h 6c]
rahulh1: checks
bettercall7208: bets $71.25
Pablit0: calls $71.25
rahulh1: folds
*** TURN *** [Qs 4h 6c] [5d]
bettercall7208: bets $185.27
Pablit0: folds
Uncalled bet ($185.27) returned to bettercall7208
*** SHOW DOWN ***
bettercall7208: shows [7c 8h] (Straight, 8-4)
bettercall7208 collected $277.9 from pot
*** SUMMARY ***
Total pot $292.50 | Rake $14.6
Board [Qs 4h 6c 5d]
Seat 1: Lucifer999 (button) folded before Flop (didn't bet)
Seat 2: rahulh1 (small blind) folded on the Flop
Seat 3: bettercall7208  (big blind) showed [7c 8h] and won ($277.9) with Straight, 8-4
Seat 4: No username folded before Flop (didn't bet)
Seat 6: Pablit0 folded on the Turn



PokerStars Game #00327536252: Hold'em No Limit ($50/$100 USD) - 2022/04/30 10:25:10 ET
Table 'Hold'em (Min 25KMax 10K)    69' 6-max Seat #1 is the button
Seat 1: Lucifer999 ($10307.88 in chips) 
Seat 5: tabby20 ($26909.55 in chips) 
Seat 6: DM0507 ($3261.82 in chips) 
tabby20: posts small blind $50
DM0507: posts big blind $100
*** HOLE CARDS ***
Dealt to Lucifer999 [8s 4s]
Lucifer999: raises $250.00 to $350
tabby20: raises $800.00 to $1150
DM0507: folds
Lucifer999: folds
Uncalled bet ($800) returned to tabby20
tabby20: doesn't show hand
tabby20 collected $800 from pot
*** SUMMARY ***
Total pot $800.00 | Rake $0
Board []
Seat 1: Lucifer999 (button) folded before Flop
Seat 5: tabby20 (small blind) collected ($800)
Seat 6: DM0507 (big blind) folded before Flop



PokerStars Game #00327536243: Hold'em No Limit ($10/$25 USD) - 2022/04/30 10:25:09 ET
Table 'Hold'em (Min 500Max 2500) 1001' 6-max Seat #5 is the button
Seat 1: JaspritBumrah786 ($2050 in chips) 
Seat 2: fishfry123 ($1485.94 in chips) 
Seat 4: devi7 ($2353.89 in chips) 
Seat 5: Lucifer999 ($4656.18 in chips) 
Seat 6: spidy02 ($4828.69 in chips) 
spidy02: posts small blind $10
JaspritBumrah786: posts big blind $25
*** HOLE CARDS ***
Dealt to Lucifer999 [7c Td]
fishfry123: checks
devi7: raises $65.00 to $90
Lucifer999: folds
spidy02: calls $80
JaspritBumrah786: raises $260.00 to $350
fishfry123: folds
devi7: folds
spidy02: folds
Uncalled bet ($260) returned to JaspritBumrah786
JaspritBumrah786: doesn't show hand
JaspritBumrah786 collected $295 from pot
*** SUMMARY ***
Total pot $295.00 | Rake $0
Board []
Seat 1: JaspritBumrah786 (big blind) collected ($295)
Seat 2: fishfry123 folded before Flop (didn't bet)
Seat 4: devi7 folded before Flop
Seat 5: Lucifer999 (button) folded before Flop (didn't bet)
Seat 6: spidy02 (small blind) folded before Flop



PokerStars Game #00327536355: Hold'em No Limit ($25/$50 USD) - 2022/04/30 10:25:40 ET
Table 'Hold'em (Min 1K Max 5K)   216' 6-max Seat #2 is the button
Seat 1: Lucifer999 ($12048.54 in chips) 
Seat 2: rahulh1 ($2779.15 in chips) 
Seat 3: bettercall7208 ($10646.9 in chips) 
Seat 4: No username ($2252.12 in chips) 
Seat 6: Pablit0 ($4364.4 in chips) 
bettercall7208: posts small blind $25
No username: posts big blind $50
*** HOLE CARDS ***
Dealt to Lucifer999 [7s 4s]
Pablit0: folds
Lucifer999: folds
rahulh1: folds
bettercall7208: folds
Uncalled bet ($25) returned to No username
No username: doesn't show hand
No username collected $50 from pot
*** SUMMARY ***
Total pot $50.00 | Rake $0
Board []
Seat 1: Lucifer999 folded before Flop (didn't bet)
Seat 2: rahulh1 (button) folded before Flop (didn't bet)
Seat 3: bettercall7208 (small blind) folded before Flop
Seat 4: No username (big blind) collected ($50)
Seat 6: Pablit0 folded before Flop (didn't bet)



PokerStars Game #00327536426: Hold'em No Limit ($25/$50 USD) - 2022/04/30 10:26:01 ET
Table 'Hold'em (Min 1K Max 5K)   216' 6-max Seat #3 is the button
Seat 1: Lucifer999 ($12048.54 in chips) 
Seat 2: rahulh1 ($2779.15 in chips) 
Seat 3: bettercall7208 ($10621.9 in chips) 
Seat 4: No username ($2277.12 in chips) 
Seat 6: Pablit0 ($4364.4 in chips) 
No username: posts small blind $25
Pablit0: posts big blind $50
*** HOLE CARDS ***
Dealt to Lucifer999 [7c Jh]
Lucifer999: folds
rahulh1: folds
bettercall7208: folds
No username: folds
Uncalled bet ($25) returned to Pablit0
*** SHOW DOWN ***
Pablit0: shows [5c 2c] ()
Pablit0 collected $50 from pot
*** SUMMARY ***
Total pot $50.00 | Rake $0
Board []
Seat 1: Lucifer999 folded before Flop (didn't bet)
Seat 2: rahulh1 folded before Flop (didn't bet)
Seat 3: bettercall7208 (button) folded before Flop (didn't bet)
Seat 4: No username (small blind) folded before Flop
Seat 6: Pablit0 (big blind) collected ($50)



PokerStars Game #00327536331: Hold'em No Limit ($10/$25 USD) - 2022/04/30 10:25:32 ET
Table 'Hold'em (Min 500Max 2500)  1282' 6-max Seat #4 is the button
Seat 1: foldmybets ($2500 in chips) 
Seat 4: papadickkies ($949.02 in chips) 
Seat 5: Lucifer999 ($6388.05 in chips) 
Seat 6: devi7 ($2305.53 in chips) 
Lucifer999: posts small blind $10
devi7: posts big blind $25
*** HOLE CARDS ***
Dealt to Lucifer999 [7c Kd]
papadickkies: folds
Lucifer999: raises $55.00 to $80
devi7: calls $55
*** FLOP *** [9s 2d Ks]
Lucifer999: bets $130
devi7: calls $130
*** TURN *** [9s 2d Ks] [Ah]
Lucifer999: checks
devi7: checks
*** RIVER *** [9s 2d Ks Ah] [8h]
Lucifer999: bets $380
devi7: calls $380
*** SHOW DOWN ***
Lucifer999: shows [7c Kd] (Pair, KK)
devi7: shows [4h Kh] (Pair, KK)
Lucifer999 collected $559.03 from pot
devi7 collected $559.02 from pot
*** SUMMARY ***
Total pot $1180.00 | Rake $61.95
Board [9s 2d Ks Ah 8h]
Seat 4: papadickkies (button) folded before Flop (didn't bet)
Seat 5: Lucifer999  (small blind) showed [7c Kd] and won ($559.03) with Pair, KK
Seat 6: devi7  (big blind) showed [4h Kh] and won ($559.02) with Pair, KK



PokerStars Game #00327536362: Hold'em No Limit ($50/$100 USD) - 2022/04/30 10:25:42 ET
Table 'Hold'em (Min 25KMax 10K)    69' 6-max Seat #5 is the button
Seat 1: Lucifer999 ($10000 in chips) 
Seat 5: tabby20 ($27359.55 in chips) 
Seat 6: DM0507 ($3161.82 in chips) 
DM0507: posts small blind $50
Lucifer999: posts big blind $100
*** HOLE CARDS ***
Dealt to Lucifer999 [As Th]
tabby20: raises $200.00 to $300
DM0507: folds
Lucifer999: calls $200
*** FLOP *** [3s Ac 8c]
Lucifer999: checks
tabby20: checks
*** TURN *** [3s Ac 8c] [7s]
Lucifer999: bets $550
tabby20: calls $550
*** RIVER *** [3s Ac 8c 7s] [4c]
Lucifer999: checks
tabby20: bets $1673
Lucifer999: folds
Uncalled bet ($1673) returned to tabby20
tabby20: doesn't show hand
tabby20 collected $1673 from pot
*** SUMMARY ***
Total pot $1750.00 | Rake $77
Board [3s Ac 8c 7s 4c]
Seat 1: Lucifer999 (big blind) folded on the River
Seat 5: tabby20 (button) collected ($1673)
Seat 6: DM0507 (small blind) folded before Flop



PokerStars Game #00327536377: Hold'em No Limit ($10/$25 USD) - 2022/04/30 10:25:46 ET
Table 'Hold'em (Min 500Max 2500) 1001' 6-max Seat #6 is the button
Seat 1: JaspritBumrah786 ($2500 in chips) 
Seat 2: fishfry123 ($1460.94 in chips) 
Seat 3: Riskycall ($2500 in chips) 
Seat 4: devi7 ($2263.89 in chips) 
Seat 5: Lucifer999 ($4656.18 in chips) 
Seat 6: spidy02 ($4738.69 in chips) 
JaspritBumrah786: posts small blind $10
fishfry123: posts big blind $25
*** HOLE CARDS ***
Dealt to Lucifer999 [2d Qs]
devi7: folds
Lucifer999: folds
spidy02: raises $45.00 to $70
JaspritBumrah786: folds
fishfry123: calls $45
*** FLOP *** [Ad 6c Ah]
fishfry123: checks
spidy02: checks
*** TURN *** [Ad 6c Ah] [Qc]
fishfry123: checks
spidy02: bets $70.57
fishfry123: calls $70.57
*** RIVER *** [Ad 6c Ah Qc] [Jc]
fishfry123: checks
spidy02: bets $205.4
fishfry123: calls $205.4
*** SHOW DOWN ***
spidy02: shows [Th Kc] (Straight, A-T)
fishfry123: shows [5c 2c] (Flush, Q high)
fishfry123 collected $660.14 from pot
*** SUMMARY ***
Total pot $701.94 | Rake $41.8
Board [Ad 6c Ah Qc Jc]
Seat 1: JaspritBumrah786 (small blind) folded before Flop
Seat 2: fishfry123  (big blind) showed [5c 2c] and won ($660.14) with Flush, Q high
Seat 4: devi7 folded before Flop (didn't bet)
Seat 5: Lucifer999 folded before Flop (didn't bet)
Seat 6: spidy02 (button) showed [Th Kc] and lost with Straight, A-T



PokerStars Game #00327536502: Hold'em No Limit ($10/$25 USD) - 2022/04/30 10:26:27 ET
Table 'Hold'em (Min 500Max 2500)  1282' 6-max Seat #5 is the button
Seat 1: foldmybets ($2500 in chips) 
Seat 4: papadickkies ($949.02 in chips) 
Seat 5: Lucifer999 ($6357.08 in chips) 
Seat 6: devi7 ($2274.55 in chips) 
devi7: posts small blind $10
foldmybets: posts big blind $25
*** HOLE CARDS ***
Dealt to Lucifer999 [4d Js]
papadickkies: folds
Lucifer999: folds
devi7: raises $55.00 to $80
foldmybets: folds
Uncalled bet ($55) returned to devi7
devi7: doesn't show hand
devi7 collected $50 from pot
*** SUMMARY ***
Total pot $50.00 | Rake $0
Board []
Seat 1: foldmybets (big blind) folded before Flop
Seat 4: papadickkies folded before Flop (didn't bet)
Seat 5: Lucifer999 (button) folded before Flop (didn't bet)
Seat 6: devi7 (small blind) collected ($50)



PokerStars Game #00327536521: Hold'em No Limit ($50/$100 USD) - 2022/04/30 10:26:34 ET
Table 'Hold'em (Min 25KMax 10K)    69' 6-max Seat #6 is the button
Seat 1: Lucifer999 ($10000 in chips) 
Seat 2: bettercall7208 ($10000 in chips) 
Seat 5: tabby20 ($28182.55 in chips) 
Seat 6: DM0507 ($3111.82 in chips) 
Lucifer999: posts small blind $50
bettercall7208: posts big blind $100
*** HOLE CARDS ***
Dealt to Lucifer999 [Jc Ac]
tabby20: folds
DM0507: calls $100
Lucifer999: raises $350.00 to $450
bettercall7208: calls $350
DM0507: calls $350
*** FLOP *** [8c Qh Ah]
Lucifer999: bets $1800
bettercall7208: folds
DM0507: folds
Uncalled bet ($1800) returned to Lucifer999
Lucifer999: doesn't show hand
Lucifer999 collected $1290.6 from pot
*** SUMMARY ***
Total pot $1350.00 | Rake $59.4
Board [8c Qh Ah]
Seat 1: Lucifer999 (small blind) collected ($1290.6)
Seat 2: bettercall7208 (big blind) folded on the Flop
Seat 5: tabby20 folded before Flop (didn't bet)
Seat 6: DM0507 (button) folded on the Flop



PokerStars Game #00327536489: Hold'em No Limit ($25/$50 USD) - 2022/04/30 10:26:23 ET
Table 'Hold'em (Min 1K Max 5K)   216' 6-max Seat #4 is the button
Seat 1: Lucifer999 ($12048.54 in chips) 
Seat 2: rahulh1 ($2779.15 in chips) 
Seat 3: Avaroni ($6357.61 in chips) 
Seat 4: No username ($2252.12 in chips) 
Seat 6: Pablit0 ($4389.4 in chips) 
Pablit0: posts small blind $25
Lucifer999: posts big blind $50
Avaroni: posts big blind $50
*** HOLE CARDS ***
Dealt to Lucifer999 [6s 9c]
rahulh1: folds
Avaroni: raises $100.00 to $150
No username: calls $150
Pablit0: folds
Lucifer999: folds
*** FLOP *** [2h Tc Js]
Avaroni: bets $300
No username: folds
Uncalled bet ($300) returned to Avaroni
Avaroni: doesn't show hand
Avaroni collected $356.25 from pot
*** SUMMARY ***
Total pot $375.00 | Rake $18.75
Board [2h Tc Js]
Seat 1: Lucifer999 (big blind) folded before Flop
Seat 2: rahulh1 folded before Flop (didn't bet)
Seat 3: Avaroni collected ($356.25)
Seat 4: No username (button) folded on the Flop
Seat 6: Pablit0 (small blind) folded before Flop



PokerStars Game #00327536595: Hold'em No Limit ($10/$25 USD) - 2022/04/30 10:26:56 ET
Table 'Hold'em (Min 500Max 2500)  1282' 6-max Seat #6 is the button
Seat 1: foldmybets ($2475 in chips) 
Seat 4: papadickkies ($949.02 in chips) 
Seat 5: Lucifer999 ($6357.08 in chips) 
Seat 6: devi7 ($2299.55 in chips) 
foldmybets: posts small blind $10
papadickkies: posts big blind $25
*** HOLE CARDS ***
Dealt to Lucifer999 [Ah 8c]
Lucifer999: folds
devi7: raises $50.00 to $75
foldmybets: folds
papadickkies: calls $50
*** FLOP *** [8d Jc Ad]
papadickkies: bets $75.3
devi7: folds
Uncalled bet ($75.3) returned to papadickkies
papadickkies: doesn't show hand
papadickkies collected $150.6 from pot
*** SUMMARY ***
Total pot $160.00 | Rake $9.4
Board [8d Jc Ad]
Seat 1: foldmybets (small blind) folded before Flop
Seat 4: papadickkies (big blind) collected ($150.6)
Seat 5: Lucifer999 folded before Flop (didn't bet)
Seat 6: devi7 (button) folded on the Flop



PokerStars Game #00327536617: Hold'em No Limit ($50/$100 USD) - 2022/04/30 10:27:04 ET
Table 'Hold'em (Min 25KMax 10K)    69' 6-max Seat #1 is the button
Seat 1: Lucifer999 ($10840.6 in chips) 
Seat 2: bettercall7208 ($9550 in chips) 
Seat 5: tabby20 ($28182.55 in chips) 
Seat 6: DM0507 ($2661.82 in chips) 
bettercall7208: posts small blind $50
tabby20: posts big blind $100
*** HOLE CARDS ***
Dealt to Lucifer999 [2c Qd]
DM0507: folds
Lucifer999: folds
bettercall7208: calls $50
tabby20: checks
*** FLOP *** [7h 2s Jc]
bettercall7208: checks
tabby20: checks
*** TURN *** [7h 2s Jc] [5d]
bettercall7208: bets $127.47
tabby20: folds
Uncalled bet ($127.47) returned to bettercall7208
bettercall7208: doesn't show hand
bettercall7208 collected $191.2 from pot
*** SUMMARY ***
Total pot $200.00 | Rake $8.8
Board [7h 2s Jc 5d]
Seat 1: Lucifer999 (button) folded before Flop (didn't bet)
Seat 2: bettercall7208 (small blind) collected ($191.2)
Seat 5: tabby20 (big blind) folded on the Turn
Seat 6: DM0507 folded before Flop (didn't bet)



PokerStars Game #00327536621: Hold'em No Limit ($25/$50 USD) - 2022/04/30 10:27:05 ET
Table 'Hold'em (Min 1K Max 5K)   216' 6-max Seat #6 is the button
Seat 1: Lucifer999 ($11998.54 in chips) 
Seat 2: rahulh1 ($2779.15 in chips) 
Seat 3: Avaroni ($6563.86 in chips) 
Seat 4: No username ($2102.12 in chips) 
Seat 6: Pablit0 ($4364.4 in chips) 
Lucifer999: posts small blind $25
rahulh1: posts big blind $50
*** HOLE CARDS ***
Dealt to Lucifer999 [6c 3s]
Avaroni: folds
No username: folds
Pablit0: folds
Lucifer999: raises $100.00 to $150
rahulh1: calls $100
*** FLOP *** [Kd 4d 2c]
Lucifer999: bets $150
rahulh1: folds
Uncalled bet ($150) returned to Lucifer999
Lucifer999: doesn't show hand
Lucifer999 collected $285 from pot
*** SUMMARY ***
Total pot $300.00 | Rake $15
Board [Kd 4d 2c]
Seat 1: Lucifer999 (small blind) collected ($285)
Seat 2: rahulh1 (big blind) folded on the Flop
Seat 3: Avaroni folded before Flop (didn't bet)
Seat 4: No username folded before Flop (didn't bet)
Seat 6: Pablit0 (button) folded before Flop (didn't bet)



PokerStars Game #00327536545: Hold'em No Limit ($10/$25 USD) - 2022/04/30 10:26:42 ET
Table 'Hold'em (Min 500Max 2500) 1001' 6-max Seat #1 is the button
Seat 1: JaspritBumrah786 ($2490 in chips) 
Seat 2: fishfry123 ($1775.11 in chips) 
Seat 3: EASYWITHACES ($2500 in chips) 
Seat 4: devi7 ($2263.89 in chips) 
Seat 5: Lucifer999 ($4656.18 in chips) 
Seat 6: spidy02 ($4392.72 in chips) 
fishfry123: posts small blind $10
EASYWITHACES: posts big blind $25
*** HOLE CARDS ***
Dealt to Lucifer999 [Jd 9s]
devi7: raises $50.00 to $75
Lucifer999: folds
spidy02: calls $75
JaspritBumrah786: folds
fishfry123: calls $65
EASYWITHACES: calls $50
*** FLOP *** [8h 8s 9h]
fishfry123: checks
EASYWITHACES: checks
devi7: checks
spidy02: bets $140.63
fishfry123: calls $140.63
EASYWITHACES: folds
devi7: folds
*** TURN *** [8h 8s 9h] [Jh]
fishfry123: checks
spidy02: checks
*** RIVER *** [8h 8s 9h Jh] [9d]
fishfry123: checks
spidy02: checks
*** SHOW DOWN ***
spidy02: shows [4c 4h] (Two pairs, 9988)
fishfry123: shows [Js Qh] (Two pairs, JJ99)
fishfry123 collected $545.76 from pot
*** SUMMARY ***
Total pot $581.26 | Rake $35.5
Board [8h 8s 9h Jh 9d]
Seat 1: JaspritBumrah786 (button) folded before Flop (didn't bet)
Seat 2: fishfry123  (small blind) showed [Js Qh] and won ($545.76) with Two pairs, JJ99
Seat 3: EASYWITHACES (big blind) folded on the Flop
Seat 4: devi7 folded on the Flop
Seat 5: Lucifer999 folded before Flop (didn't bet)
Seat 6: spidy02 showed [4c 4h] and lost with Two pairs, 9988



PokerStars Game #00327536726: Hold'em No Limit ($50/$100 USD) - 2022/04/30 10:27:41 ET
Table 'Hold'em (Min 25KMax 10K)    69' 6-max Seat #2 is the button
Seat 1: Lucifer999 ($10840.6 in chips) 
Seat 2: bettercall7208 ($9641.2 in chips) 
Seat 5: tabby20 ($28082.55 in chips) 
Seat 6: DM0507 ($2661.82 in chips) 
tabby20: posts small blind $50
DM0507: posts big blind $100
*** HOLE CARDS ***
Dealt to Lucifer999 [7c 8d]
Lucifer999: folds
bettercall7208: raises $200.00 to $300
tabby20: folds
DM0507: folds
Uncalled bet ($200) returned to bettercall7208
bettercall7208: doesn't show hand
bettercall7208 collected $250 from pot
*** SUMMARY ***
Total pot $250.00 | Rake $0
Board []
Seat 1: Lucifer999 folded before Flop (didn't bet)
Seat 2: bettercall7208 (button) collected ($250)
Seat 5: tabby20 (small blind) folded before Flop
Seat 6: DM0507 (big blind) folded before Flop



PokerStars Game #00327536707: Hold'em No Limit ($10/$25 USD) - 2022/04/30 10:27:35 ET
Table 'Hold'em (Min 500Max 2500)  1282' 6-max Seat #1 is the button
Seat 1: foldmybets ($2465 in chips) 
Seat 4: papadickkies ($1024.62 in chips) 
Seat 5: Lucifer999 ($6357.08 in chips) 
Seat 6: devi7 ($2224.55 in chips) 
papadickkies: posts small blind $10
Lucifer999: posts big blind $25
*** HOLE CARDS ***
Dealt to Lucifer999 [2d 8h]
devi7: raises $50.00 to $75
foldmybets: calls $75
papadickkies: folds
Lucifer999: folds
*** FLOP *** [Td 6c 6s]
devi7: bets $125
foldmybets: folds
Uncalled bet ($125) returned to devi7
devi7: doesn't show hand
devi7 collected $174.29 from pot
*** SUMMARY ***
Total pot $185.00 | Rake $10.71
Board [Td 6c 6s]
Seat 1: foldmybets (button) folded on the Flop
Seat 4: papadickkies (small blind) folded before Flop
Seat 5: Lucifer999 (big blind) folded before Flop
Seat 6: devi7 collected ($174.29)



PokerStars Game #00327536733: Hold'em No Limit ($25/$50 USD) - 2022/04/30 10:27:42 ET
Table 'Hold'em (Min 1K Max 5K)   216' 6-max Seat #1 is the button
Seat 1: Lucifer999 ($12133.54 in chips) 
Seat 2: rahulh1 ($2629.15 in chips) 
Seat 3: Avaroni ($6563.86 in chips) 
Seat 4: No username ($2102.12 in chips) 
Seat 6: Pablit0 ($4364.4 in chips) 
rahulh1: posts small blind $25
Avaroni: posts big blind $50
*** HOLE CARDS ***
Dealt to Lucifer999 [Tc Jd]
No username: folds
Pablit0: folds
Lucifer999: raises $100.00 to $150
rahulh1: folds
Avaroni: folds
Uncalled bet ($100) returned to Lucifer999
Lucifer999: doesn't show hand
Lucifer999 collected $125 from pot
*** SUMMARY ***
Total pot $125.00 | Rake $0
Board []
Seat 1: Lucifer999 (button) collected ($125)
Seat 2: rahulh1 (small blind) folded before Flop
Seat 3: Avaroni (big blind) folded before Flop
Seat 4: No username folded before Flop (didn't bet)
Seat 6: Pablit0 folded before Flop (didn't bet)



PokerStars Game #00327536753: Hold'em No Limit ($10/$25 USD) - 2022/04/30 10:27:50 ET
Table 'Hold'em (Min 500Max 2500) 1001' 6-max Seat #2 is the button
Seat 1: JaspritBumrah786 ($2490 in chips) 
Seat 2: fishfry123 ($2105.24 in chips) 
Seat 3: EASYWITHACES ($2425 in chips) 
Seat 4: devi7 ($2188.89 in chips) 
Seat 5: Lucifer999 ($4656.18 in chips) 
Seat 6: spidy02 ($4177.09 in chips) 
EASYWITHACES: posts small blind $10
devi7: posts big blind $25
*** HOLE CARDS ***
Dealt to Lucifer999 [Qs 3d]
Lucifer999: folds
spidy02: folds
JaspritBumrah786: folds
fishfry123: raises $25.00 to $50
EASYWITHACES: calls $40
devi7: calls $25
*** FLOP *** [4h 9d 4c]
EASYWITHACES: checks
devi7: checks
fishfry123: checks
*** TURN *** [4h 9d 4c] [Tc]
EASYWITHACES: bets $75
devi7: folds
fishfry123: calls $75
*** RIVER *** [4h 9d 4c Tc] [6c]
EASYWITHACES: bets $95
fishfry123: calls $95
*** SHOW DOWN ***
EASYWITHACES: shows [9c 8c] (Flush, T high)
fishfry123: doesn't show hand
EASYWITHACES collected $460.28 from pot
*** SUMMARY ***
Total pot $490.00 | Rake $29.72
Board [4h 9d 4c Tc 6c]
Seat 1: JaspritBumrah786 folded before Flop (didn't bet)
Seat 2: fishfry123 (button) mucked
Seat 3: EASYWITHACES  (small blind) showed [9c 8c] and won ($460.28) with Flush, T high
Seat 4: devi7 (big blind) folded on the Turn
Seat 5: Lucifer999 folded before Flop (didn't bet)
Seat 6: spidy02 folded before Flop (didn't bet)



PokerStars Game #00327536814: Hold'em No Limit ($10/$25 USD) - 2022/04/30 10:28:13 ET
Table 'Hold'em (Min 500Max 2500)  1282' 6-max Seat #4 is the button
Seat 1: foldmybets ($2390 in chips) 
Seat 4: papadickkies ($1014.62 in chips) 
Seat 5: Lucifer999 ($6332.08 in chips) 
Seat 6: devi7 ($2323.84 in chips) 
Lucifer999: posts small blind $10
devi7: posts big blind $25
*** HOLE CARDS ***
Dealt to Lucifer999 [Jh Jc]
foldmybets: folds
papadickkies: raises $35.00 to $60
Lucifer999: raises $220.00 to $280
devi7: folds
papadickkies: folds
Uncalled bet ($220) returned to Lucifer999
Lucifer999: doesn't show hand
Lucifer999 collected $145 from pot
*** SUMMARY ***
Total pot $145.00 | Rake $0
Board []
Seat 1: foldmybets folded before Flop (didn't bet)
Seat 4: papadickkies (button) folded before Flop
Seat 5: Lucifer999 (small blind) collected ($145)
Seat 6: devi7 (big blind) folded before Flop



PokerStars Game #00327536793: Hold'em No Limit ($50/$100 USD) - 2022/04/30 10:28:06 ET
Table 'Hold'em (Min 25KMax 10K)    69' 6-max Seat #5 is the button
Seat 1: Lucifer999 ($10840.6 in chips) 
Seat 2: bettercall7208 ($9791.2 in chips) 
Seat 5: tabby20 ($28032.55 in chips) 
Seat 6: DM0507 ($2561.82 in chips) 
DM0507: posts small blind $50
Lucifer999: posts big blind $100
*** HOLE CARDS ***
Dealt to Lucifer999 [Th 8h]
bettercall7208: calls $100
tabby20: folds
DM0507: calls $50
Lucifer999: raises $350.00 to $450
bettercall7208: calls $350
DM0507: calls $350
*** FLOP *** [2s 6h 7h]
DM0507: checks
Lucifer999: checks
bettercall7208: bets $645.3
DM0507: calls $645.3
Lucifer999: calls $645.3
*** TURN *** [2s 6h 7h] [5c]
DM0507: bets $1466.52
Lucifer999: calls $1466.52
bettercall7208: folds
*** RIVER *** [2s 6h 7h 5c] [9c]
*** RIVER *** [2s 6h 7h 5c] [9s]
*** SHOW DOWN ***
Lucifer999: shows [Th 8h] (Straight, T-6)
DM0507: shows [6d Ad] (Pair, 66)
Lucifer999 collected $2972.68 from pot
Lucifer999 collected $2972.67 from pot
*** SUMMARY ***
Total pot $6218.94 | Rake $273.59
Board [2s 6h 7h 5c 9c]
Seat 1: Lucifer999  (big blind) showed [Th 8h] and won ($2972.67) with Straight, T-6
Seat 2: bettercall7208 folded on the Turn
Seat 5: tabby20 (button) folded before Flop (didn't bet)
Seat 6: DM0507 (small blind) showed [6d Ad] and lost with Pair, 66



PokerStars Game #00327536895: Hold'em No Limit ($10/$25 USD) - 2022/04/30 10:28:45 ET
Table 'Hold'em (Min 500Max 2500) 1001' 6-max Seat #3 is the button
Seat 1: JaspritBumrah786 ($2490 in chips) 
Seat 2: fishfry123 ($1885.24 in chips) 
Seat 3: EASYWITHACES ($2665.28 in chips) 
Seat 4: devi7 ($2138.89 in chips) 
Seat 5: Lucifer999 ($4656.18 in chips) 
Seat 6: spidy02 ($4177.09 in chips) 
devi7: posts small blind $10
Lucifer999: posts big blind $25
*** HOLE CARDS ***
Dealt to Lucifer999 [Qd 3s]
spidy02: folds
JaspritBumrah786: folds
fishfry123: raises $25.00 to $50
EASYWITHACES: folds
devi7: folds
Lucifer999: folds
Uncalled bet ($25) returned to fishfry123
fishfry123: doesn't show hand
fishfry123 collected $60 from pot
*** SUMMARY ***
Total pot $60.00 | Rake $0
Board []
Seat 1: JaspritBumrah786 folded before Flop (didn't bet)
Seat 2: fishfry123 collected ($60)
Seat 3: EASYWITHACES (button) folded before Flop (didn't bet)
Seat 4: devi7 (small blind) folded before Flop
Seat 5: Lucifer999 (big blind) folded before Flop
Seat 6: spidy02 folded before Flop (didn't bet)



PokerStars Game #00327536816: Hold'em No Limit ($25/$50 USD) - 2022/04/30 10:28:13 ET
Table 'Hold'em (Min 1K Max 5K)   216' 6-max Seat #2 is the button
Seat 1: Lucifer999 ($12208.54 in chips) 
Seat 2: rahulh1 ($2604.15 in chips) 
Seat 3: Avaroni ($6513.86 in chips) 
Seat 4: No username ($2102.12 in chips) 
Seat 6: Pablit0 ($4364.4 in chips) 
Avaroni: posts small blind $25
No username: posts big blind $50
*** HOLE CARDS ***
Dealt to Lucifer999 [3c 3s]
Pablit0: calls $50
Lucifer999: calls $50
rahulh1: calls $50
Avaroni: folds
No username: checks
*** FLOP *** [Ac 6c 4d]
No username: checks
Pablit0: checks
Lucifer999: checks
rahulh1: checks
*** TURN *** [Ac 6c 4d] [2d]
No username: checks
Pablit0: checks
Lucifer999: bets $175
rahulh1: folds
No username: folds
Pablit0: folds
Uncalled bet ($175) returned to Lucifer999
Lucifer999: doesn't show hand
Lucifer999 collected $213.75 from pot
*** SUMMARY ***
Total pot $225.00 | Rake $11.25
Board [Ac 6c 4d 2d]
Seat 1: Lucifer999 collected ($213.75)
Seat 2: rahulh1 (button) folded on the Turn
Seat 3: Avaroni (small blind) folded before Flop
Seat 4: No username (big blind) folded on the Turn
Seat 6: Pablit0 folded on the Turn



PokerStars Game #00327536898: Hold'em No Limit ($10/$25 USD) - 2022/04/30 10:28:46 ET
Table 'Hold'em (Min 500Max 2500)  1282' 6-max Seat #5 is the button
Seat 1: foldmybets ($2390 in chips) 
Seat 4: papadickkies ($954.62 in chips) 
Seat 5: Lucifer999 ($6417.08 in chips) 
Seat 6: devi7 ($2298.84 in chips) 
devi7: posts small blind $10
foldmybets: posts big blind $25
*** HOLE CARDS ***
Dealt to Lucifer999 [2h 3s]
papadickkies: folds
Lucifer999: raises $45.00 to $70
devi7: calls $60
foldmybets: folds
*** FLOP *** [Ks Jc 9s]
devi7: checks
Lucifer999: checks
*** TURN *** [Ks Jc 9s] [4s]
devi7: checks
Lucifer999: bets $75
devi7: folds
Uncalled bet ($75) returned to Lucifer999
Lucifer999: doesn't show hand
Lucifer999 collected $155.34 from pot
*** SUMMARY ***
Total pot $165.00 | Rake $9.66
Board [Ks Jc 9s 4s]
Seat 1: foldmybets (big blind) folded before Flop
Seat 4: papadickkies folded before Flop (didn't bet)
Seat 5: Lucifer999 (button) collected ($155.34)
Seat 6: devi7 (small blind) folded on the Turn



PokerStars Game #00327536955: Hold'em No Limit ($50/$100 USD) - 2022/04/30 10:29:03 ET
Table 'Hold'em (Min 25KMax 10K)    69' 6-max Seat #1 is the button
Seat 1: Lucifer999 ($14224.13 in chips) 
Seat 2: bettercall7208 ($8695.9 in chips) 
Seat 5: tabby20 ($28032.55 in chips) 
Seat 6: DM0507 ($2500 in chips) 
bettercall7208: posts small blind $50
tabby20: posts big blind $100
*** HOLE CARDS ***
Dealt to Lucifer999 [4s 9s]
Lucifer999: folds
bettercall7208: calls $50
tabby20: raises $250.00 to $350
bettercall7208: calls $250
*** FLOP *** [7s 8c As]
bettercall7208: checks
tabby20: bets $550
bettercall7208: calls $550
*** TURN *** [7s 8c As] [2s]
bettercall7208: checks
tabby20: checks
*** RIVER *** [7s 8c As 2s] [Kc]
bettercall7208: checks
tabby20: bets $650
bettercall7208: calls $650
*** SHOW DOWN ***
tabby20: shows [5h 4h] (High card, A)
bettercall7208: shows [Ad 4d] (Pair, AA)
bettercall7208 collected $2963.6 from pot
*** SUMMARY ***
Total pot $3100.00 | Rake $136.4
Board [7s 8c As 2s Kc]
Seat 1: Lucifer999 (button) folded before Flop (didn't bet)
Seat 2: bettercall7208  (small blind) showed [Ad 4d] and won ($2963.6) with Pair, AA
Seat 5: tabby20 (big blind) showed [5h 4h] and lost with High card, A



PokerStars Game #00327536972: Hold'em No Limit ($10/$25 USD) - 2022/04/30 10:29:11 ET
Table 'Hold'em (Min 500Max 2500) 1001' 6-max Seat #4 is the button
Seat 1: JaspritBumrah786 ($2490 in chips) 
Seat 2: fishfry123 ($1920.24 in chips) 
Seat 3: EASYWITHACES ($2665.28 in chips) 
Seat 4: devi7 ($2128.89 in chips) 
Seat 5: Lucifer999 ($4631.18 in chips) 
Seat 6: spidy02 ($4177.09 in chips) 
Lucifer999: posts small blind $10
spidy02: posts big blind $25
*** HOLE CARDS ***
Dealt to Lucifer999 [4h 5c]
JaspritBumrah786: folds
fishfry123: raises $38.75 to $63.75
EASYWITHACES: folds
devi7: folds
Lucifer999: folds
spidy02: calls $38.75
*** FLOP *** [9c 6s 9d]
spidy02: checks
fishfry123: bets $96.98
spidy02: calls $96.98
*** TURN *** [9c 6s 9d] [4d]
spidy02: checks
fishfry123: checks
*** RIVER *** [9c 6s 9d 4d] [6d]
spidy02: checks
fishfry123: checks
*** SHOW DOWN ***
fishfry123: shows [8s 8d] (Two pairs, 9988)
spidy02: shows [Ad Td] (Flush, A high)
spidy02 collected $311.09 from pot
*** SUMMARY ***
Total pot $331.46 | Rake $20.37
Board [9c 6s 9d 4d 6d]
Seat 1: JaspritBumrah786 folded before Flop (didn't bet)
Seat 2: fishfry123 showed [8s 8d] and lost with Two pairs, 9988
Seat 3: EASYWITHACES folded before Flop (didn't bet)
Seat 4: devi7 (button) folded before Flop (didn't bet)
Seat 5: Lucifer999 (small blind) folded before Flop
Seat 6: spidy02  (big blind) showed [Ad Td] and won ($311.09) with Flush, A high



PokerStars Game #00327536983: Hold'em No Limit ($25/$50 USD) - 2022/04/30 10:29:13 ET
Table 'Hold'em (Min 1K Max 5K)   216' 6-max Seat #3 is the button
Seat 1: Lucifer999 ($12372.29 in chips) 
Seat 2: rahulh1 ($2554.15 in chips) 
Seat 3: Avaroni ($6488.86 in chips) 
Seat 4: No username ($2052.12 in chips) 
Seat 6: Pablit0 ($4314.4 in chips) 
No username: posts small blind $25
Pablit0: posts big blind $50
*** HOLE CARDS ***
Dealt to Lucifer999 [2s 2h]
Lucifer999: folds
rahulh1: folds
Avaroni: raises $100.00 to $150
No username: folds
Pablit0: calls $100
*** FLOP *** [2d 7c 4s]
Pablit0: checks
Avaroni: bets $225
Pablit0: calls $225
*** TURN *** [2d 7c 4s] [Js]
Pablit0: checks
Avaroni: checks
*** RIVER *** [2d 7c 4s Js] [2c]
Pablit0: checks
Avaroni: checks
*** SHOW DOWN ***
Avaroni: shows [3h Ah] (Pair, 22)
Pablit0: shows [3d As] (Pair, 22)
Pablit0 collected $368.13 from pot
Avaroni collected $368.12 from pot
*** SUMMARY ***
Total pot $775.00 | Rake $38.75
Board [2d 7c 4s Js 2c]
Seat 1: Lucifer999 folded before Flop (didn't bet)
Seat 2: rahulh1 folded before Flop (didn't bet)
Seat 3: Avaroni  (button) showed [3h Ah] and won ($368.12) with Pair, 22
Seat 4: No username (small blind) folded before Flop
Seat 6: Pablit0  (big blind) showed [3d As] and won ($368.13) with Pair, 22



PokerStars Game #00327537125: Hold'em No Limit ($10/$25 USD) - 2022/04/30 10:30:00 ET
Table 'Hold'em (Min 500Max 2500) 1001' 6-max Seat #5 is the button
Seat 1: JaspritBumrah786 ($2490 in chips) 
Seat 2: fishfry123 ($1759.51 in chips) 
Seat 3: EASYWITHACES ($2665.28 in chips) 
Seat 4: devi7 ($2128.89 in chips) 
Seat 5: Lucifer999 ($4621.18 in chips) 
Seat 6: spidy02 ($4327.45 in chips) 
spidy02: posts small blind $10
JaspritBumrah786: posts big blind $25
*** HOLE CARDS ***
Dealt to Lucifer999 [Th 6h]
fishfry123: calls $25
EASYWITHACES: folds
devi7: folds
Lucifer999: raises $85.00 to $110
spidy02: folds
JaspritBumrah786: folds
fishfry123: folds
Uncalled bet ($85) returned to Lucifer999
Lucifer999: doesn't show hand
Lucifer999 collected $85 from pot
*** SUMMARY ***
Total pot $85.00 | Rake $0
Board []
Seat 1: JaspritBumrah786 (big blind) folded before Flop
Seat 2: fishfry123 folded before Flop
Seat 3: EASYWITHACES folded before Flop (didn't bet)
Seat 4: devi7 folded before Flop (didn't bet)
Seat 5: Lucifer999 (button) collected ($85)
Seat 6: spidy02 (small blind) folded before Flop



PokerStars Game #00327537110: Hold'em No Limit ($50/$100 USD) - 2022/04/30 10:29:56 ET
Table 'Hold'em (Min 25KMax 10K)    69' 6-max Seat #2 is the button
Seat 1: Lucifer999 ($14224.13 in chips) 
Seat 2: bettercall7208 ($10109.5 in chips) 
Seat 5: tabby20 ($26482.55 in chips) 
Seat 6: manny007 ($2500 in chips) 
tabby20: posts small blind $50
manny007: posts big blind $100
*** HOLE CARDS ***
Dealt to Lucifer999 [6s 8s]
Lucifer999: folds
bettercall7208: raises $200.00 to $300
tabby20: calls $250
manny007: calls $200
*** FLOP *** [9d As Ts]
tabby20: checks
manny007: bets $860.4
bettercall7208: folds
tabby20: folds
Uncalled bet ($860.4) returned to manny007
manny007: doesn't show hand
manny007 collected $860.4 from pot
*** SUMMARY ***
Total pot $900.00 | Rake $39.6
Board [9d As Ts]
Seat 1: Lucifer999 folded before Flop (didn't bet)
Seat 2: bettercall7208 (button) folded on the Flop
Seat 5: tabby20 (small blind) folded on the Flop
Seat 6: manny007 (big blind) collected ($860.4)



PokerStars Game #00327537089: Hold'em No Limit ($10/$25 USD) - 2022/04/30 10:29:50 ET
Table 'Hold'em (Min 500Max 2500)  1282' 6-max Seat #6 is the button
Seat 1: foldmybets ($2365 in chips) 
Seat 2: jaykam ($920.83 in chips) 
Seat 4: papadickkies ($954.62 in chips) 
Seat 5: Lucifer999 ($6502.42 in chips) 
Seat 6: devi7 ($2228.84 in chips) 
foldmybets: posts small blind $10
jaykam: posts big blind $25
*** HOLE CARDS ***
Dealt to Lucifer999 [4h Kd]
papadickkies: folds
Lucifer999: folds
devi7: folds
foldmybets: raises $50.00 to $75
jaykam: calls $50
*** FLOP *** [Ah 9h 2s]
foldmybets: checks
jaykam: checks
*** TURN *** [Ah 9h 2s] [8s]
foldmybets: checks
jaykam: bets $25
foldmybets: calls $25
*** RIVER *** [Ah 9h 2s 8s] [4d]
foldmybets: bets $125
jaykam: folds
Uncalled bet ($125) returned to foldmybets
foldmybets: doesn't show hand
foldmybets collected $187.5 from pot
*** SUMMARY ***
Total pot $200.00 | Rake $12.5
Board [Ah 9h 2s 8s 4d]
Seat 1: foldmybets (small blind) collected ($187.5)
Seat 2: jaykam (big blind) folded on the River
Seat 4: papadickkies folded before Flop (didn't bet)
Seat 5: Lucifer999 folded before Flop (didn't bet)
Seat 6: devi7 (button) folded before Flop (didn't bet)



PokerStars Game #00327537244: Hold'em No Limit ($50/$100 USD) - 2022/04/30 10:30:38 ET
Table 'Hold'em (Min 25KMax 10K)    69' 6-max Seat #5 is the button
Seat 1: Lucifer999 ($14224.13 in chips) 
Seat 2: bettercall7208 ($9809.5 in chips) 
Seat 5: tabby20 ($26182.55 in chips) 
Seat 6: manny007 ($3060.4 in chips) 
manny007: posts small blind $50
Lucifer999: posts big blind $100
*** HOLE CARDS ***
Dealt to Lucifer999 [Jd 7c]
bettercall7208: folds
tabby20: folds
manny007: raises $200.00 to $300
Lucifer999: folds
Uncalled bet ($200) returned to manny007
manny007: doesn't show hand
manny007 collected $200 from pot
*** SUMMARY ***
Total pot $200.00 | Rake $0
Board []
Seat 1: Lucifer999 (big blind) folded before Flop
Seat 2: bettercall7208 folded before Flop (didn't bet)
Seat 5: tabby20 (button) folded before Flop (didn't bet)
Seat 6: manny007 (small blind) collected ($200)



PokerStars Game #00327537207: Hold'em No Limit ($10/$25 USD) - 2022/04/30 10:30:23 ET
Table 'Hold'em (Min 500Max 2500) 1001' 6-max Seat #6 is the button
Seat 1: JaspritBumrah786 ($2465 in chips) 
Seat 2: fishfry123 ($1734.51 in chips) 
Seat 3: EASYWITHACES ($2665.28 in chips) 
Seat 4: devi7 ($2128.89 in chips) 
Seat 5: Lucifer999 ($4681.18 in chips) 
Seat 6: spidy02 ($4317.45 in chips) 
JaspritBumrah786: posts small blind $10
fishfry123: posts big blind $25
*** HOLE CARDS ***
Dealt to Lucifer999 [9h Kc]
EASYWITHACES: folds
devi7: folds
Lucifer999: folds
spidy02: raises $45.00 to $70
JaspritBumrah786: calls $60
fishfry123: folds
*** FLOP *** [5d Ah Jd]
JaspritBumrah786: checks
spidy02: checks
*** TURN *** [5d Ah Jd] [9c]
JaspritBumrah786: checks
spidy02: checks
*** RIVER *** [5d Ah Jd 9c] [Ac]
JaspritBumrah786: checks
spidy02: bets $116.51
JaspritBumrah786: folds
Uncalled bet ($116.51) returned to spidy02
spidy02: doesn't show hand
spidy02 collected $155.34 from pot
*** SUMMARY ***
Total pot $165.00 | Rake $9.66
Board [5d Ah Jd 9c Ac]
Seat 1: JaspritBumrah786 (small blind) folded on the River
Seat 2: fishfry123 (big blind) folded before Flop
Seat 3: EASYWITHACES folded before Flop (didn't bet)
Seat 4: devi7 folded before Flop (didn't bet)
Seat 5: Lucifer999 folded before Flop (didn't bet)
Seat 6: spidy02 (button) collected ($155.34)



PokerStars Game #00327537194: Hold'em No Limit ($25/$50 USD) - 2022/04/30 10:30:20 ET
Table 'Hold'em (Min 1K Max 5K)   216' 6-max Seat #4 is the button
Seat 1: Lucifer999 ($12372.29 in chips) 
Seat 2: rahulh1 ($2554.15 in chips) 
Seat 3: Avaroni ($6481.98 in chips) 
Seat 4: No username ($2027.12 in chips) 
Seat 6: Pablit0 ($4307.53 in chips) 
Pablit0: posts small blind $25
Lucifer999: posts big blind $50
*** HOLE CARDS ***
Dealt to Lucifer999 [Kh 9d]
rahulh1: folds
Avaroni: folds
No username: raises $125.00 to $175
Pablit0: calls $150
Lucifer999: folds
*** FLOP *** [3d Qc 7h]
Pablit0: checks
No username: bets $145.48
Pablit0: calls $145.48
*** TURN *** [3d Qc 7h] [Kd]
Pablit0: checks
No username: bets $467.35
Pablit0: folds
Uncalled bet ($467.35) returned to No username
No username: doesn't show hand
No username collected $656.46 from pot
*** SUMMARY ***
Total pot $690.96 | Rake $34.5
Board [3d Qc 7h Kd]
Seat 1: Lucifer999 (big blind) folded before Flop
Seat 2: rahulh1 folded before Flop (didn't bet)
Seat 3: Avaroni folded before Flop (didn't bet)
Seat 4: No username (button) collected ($656.46)
Seat 6: Pablit0 (small blind) folded on the Turn



PokerStars Game #00327537444: Hold'em No Limit ($25/$50 USD) - 2022/04/30 10:31:34 ET
Table 'Hold'em (Min 1K Max 5K)   216' 6-max Seat #6 is the button
Seat 1: Lucifer999 ($12322.29 in chips) 
Seat 2: rahulh1 ($2554.15 in chips) 
Seat 3: Avaroni ($6481.98 in chips) 
Seat 4: No username ($2363.1 in chips) 
Seat 6: Pablit0 ($3987.05 in chips) 
Lucifer999: posts small blind $25
rahulh1: posts big blind $50
*** HOLE CARDS ***
Dealt to Lucifer999 [Td Ac]
Avaroni: folds
No username: folds
Pablit0: calls $50
Lucifer999: raises $175.00 to $225
rahulh1: folds
Pablit0: folds
Uncalled bet ($175) returned to Lucifer999
Lucifer999: doesn't show hand
Lucifer999 collected $150 from pot
*** SUMMARY ***
Total pot $150.00 | Rake $0
Board []
Seat 1: Lucifer999 (small blind) collected ($150)
Seat 2: rahulh1 (big blind) folded before Flop
Seat 3: Avaroni folded before Flop (didn't bet)
Seat 4: No username folded before Flop (didn't bet)
Seat 6: Pablit0 (button) folded before Flop



PokerStars Game #00327537336: Hold'em No Limit ($50/$100 USD) - 2022/04/30 10:31:03 ET
Table 'Hold'em (Min 25KMax 10K)    69' 6-max Seat #6 is the button
Seat 1: Lucifer999 ($14124.13 in chips) 
Seat 2: bettercall7208 ($9809.5 in chips) 
Seat 5: tabby20 ($26182.55 in chips) 
Seat 6: manny007 ($3160.4 in chips) 
Lucifer999: posts small blind $50
bettercall7208: posts big blind $100
*** HOLE CARDS ***
Dealt to Lucifer999 [Ts 8c]
tabby20: folds
manny007: calls $100
Lucifer999: calls $50
bettercall7208: checks
*** FLOP *** [Js 8s 9h]
Lucifer999: checks
bettercall7208: checks
manny007: bets $286.8
Lucifer999: raises $313.20 to $600
bettercall7208: calls $600
manny007: calls $313.2
*** TURN *** [Js 8s 9h] [7h]
Lucifer999: checks
bettercall7208: checks
manny007: checks
*** RIVER *** [Js 8s 9h 7h] [7c]
Lucifer999: checks
bettercall7208: checks
manny007: checks
*** SHOW DOWN ***
Lucifer999: shows [Ts 8c] (Straight, J-7)
bettercall7208: doesn't show hand
manny007: doesn't show hand
Lucifer999 collected $2007.6 from pot
*** SUMMARY ***
Total pot $2100.00 | Rake $92.4
Board [Js 8s 9h 7h 7c]
Seat 1: Lucifer999  (small blind) showed [Ts 8c] and won ($2007.6) with Straight, J-7
Seat 2: bettercall7208 (big blind) mucked
Seat 5: tabby20 folded before Flop (didn't bet)
Seat 6: manny007 (button) mucked



PokerStars Game #00327537285: Hold'em No Limit ($10/$25 USD) - 2022/04/30 10:30:48 ET
Table 'Hold'em (Min 500Max 2500)  1282' 6-max Seat #1 is the button
Seat 1: foldmybets ($2452.5 in chips) 
Seat 2: jaykam ($820.83 in chips) 
Seat 4: papadickkies ($954.62 in chips) 
Seat 5: Lucifer999 ($6502.42 in chips) 
Seat 6: devi7 ($2228.84 in chips) 
jaykam: posts small blind $10
papadickkies: posts big blind $25
*** HOLE CARDS ***
Dealt to Lucifer999 [Ac 8h]
Lucifer999: folds
devi7: folds
foldmybets: calls $25
jaykam: calls $15
papadickkies: checks
*** FLOP *** [8c 4s 4h]
jaykam: checks
papadickkies: checks
foldmybets: checks
*** TURN *** [8c 4s 4h] [7d]
jaykam: checks
papadickkies: bets $71.07
foldmybets: calls $71.07
jaykam: folds
*** RIVER *** [8c 4s 4h 7d] [Kd]
papadickkies: bets $152.81
foldmybets: calls $152.81
*** SHOW DOWN ***
papadickkies: shows [Jd 7c] (Two pairs, 7744)
foldmybets: shows [Ad As] (Two pairs, AA44)
foldmybets collected $490.36 from pot
*** SUMMARY ***
Total pot $522.76 | Rake $32.4
Board [8c 4s 4h 7d Kd]
Seat 1: foldmybets  (button) showed [Ad As] and won ($490.36) with Two pairs, AA44
Seat 2: jaykam (small blind) folded on the Turn
Seat 4: papadickkies (big blind) showed [Jd 7c] and lost with Two pairs, 7744
Seat 5: Lucifer999 folded before Flop (didn't bet)
Seat 6: devi7 folded before Flop (didn't bet)



PokerStars Game #00327537418: Hold'em No Limit ($10/$25 USD) - 2022/04/30 10:31:27 ET
Table 'Hold'em (Min 500Max 2500) 1001' 6-max Seat #1 is the button
Seat 1: JaspritBumrah786 ($2395 in chips) 
Seat 2: fishfry123 ($1709.51 in chips) 
Seat 3: EASYWITHACES ($2665.28 in chips) 
Seat 4: devi7 ($2128.89 in chips) 
Seat 5: Lucifer999 ($4681.18 in chips) 
Seat 6: spidy02 ($4402.79 in chips) 
fishfry123: posts small blind $10
EASYWITHACES: posts big blind $25
*** HOLE CARDS ***
Dealt to Lucifer999 [4h Jc]
devi7: folds
Lucifer999: folds
spidy02: folds
JaspritBumrah786: folds
fishfry123: raises $50.00 to $75
EASYWITHACES: folds
Uncalled bet ($50) returned to fishfry123
fishfry123: doesn't show hand
fishfry123 collected $50 from pot
*** SUMMARY ***
Total pot $50.00 | Rake $0
Board []
Seat 1: JaspritBumrah786 (button) folded before Flop (didn't bet)
Seat 2: fishfry123 (small blind) collected ($50)
Seat 3: EASYWITHACES (big blind) folded before Flop
Seat 4: devi7 folded before Flop (didn't bet)
Seat 5: Lucifer999 folded before Flop (didn't bet)
Seat 6: spidy02 folded before Flop (didn't bet)



PokerStars Game #00327537527: Hold'em No Limit ($10/$25 USD) - 2022/04/30 10:31:58 ET
Table 'Hold'em (Min 500Max 2500) 1001' 6-max Seat #2 is the button
Seat 1: JaspritBumrah786 ($2395 in chips) 
Seat 2: fishfry123 ($1734.51 in chips) 
Seat 3: EASYWITHACES ($2640.28 in chips) 
Seat 4: devi7 ($2128.89 in chips) 
Seat 5: Lucifer999 ($4681.18 in chips) 
Seat 6: spidy02 ($4402.79 in chips) 
EASYWITHACES: posts small blind $10
devi7: posts big blind $25
*** HOLE CARDS ***
Dealt to Lucifer999 [4s 5s]
Lucifer999: folds
spidy02: raises $55.00 to $80
JaspritBumrah786: folds
fishfry123: folds
EASYWITHACES: folds
devi7: raises $285.00 to $365
spidy02: folds
Uncalled bet ($285) returned to devi7
devi7: doesn't show hand
devi7 collected $170 from pot
*** SUMMARY ***
Total pot $170.00 | Rake $0
Board []
Seat 1: JaspritBumrah786 folded before Flop (didn't bet)
Seat 2: fishfry123 (button) folded before Flop (didn't bet)
Seat 3: EASYWITHACES (small blind) folded before Flop
Seat 4: devi7 (big blind) collected ($170)
Seat 5: Lucifer999 folded before Flop (didn't bet)
Seat 6: spidy02 folded before Flop



PokerStars Game #00327537515: Hold'em No Limit ($25/$50 USD) - 2022/04/30 10:31:54 ET
Table 'Hold'em (Min 1K Max 5K)   216' 6-max Seat #1 is the button
Seat 1: Lucifer999 ($12422.29 in chips) 
Seat 2: rahulh1 ($2504.15 in chips) 
Seat 3: Avaroni ($6481.98 in chips) 
Seat 4: No username ($2363.1 in chips) 
Seat 6: Pablit0 ($3937.05 in chips) 
rahulh1: posts small blind $25
Avaroni: posts big blind $50
*** HOLE CARDS ***
Dealt to Lucifer999 [4c 7d]
No username: folds
Pablit0: folds
Lucifer999: folds
rahulh1: raises $85.57 to $135.57
Avaroni: calls $85.57
*** FLOP *** [7h Jc 8d]
rahulh1: checks
Avaroni: bets $128.8
rahulh1: folds
Uncalled bet ($128.8) returned to Avaroni
Avaroni: doesn't show hand
Avaroni collected $257.59 from pot
*** SUMMARY ***
Total pot $271.14 | Rake $13.55
Board [7h Jc 8d]
Seat 1: Lucifer999 (button) folded before Flop (didn't bet)
Seat 2: rahulh1 (small blind) folded on the Flop
Seat 3: Avaroni (big blind) collected ($257.59)
Seat 4: No username folded before Flop (didn't bet)
Seat 6: Pablit0 folded before Flop (didn't bet)



PokerStars Game #00327537516: Hold'em No Limit ($50/$100 USD) - 2022/04/30 10:31:54 ET
Table 'Hold'em (Min 25KMax 10K)    69' 6-max Seat #1 is the button
Seat 1: Lucifer999 ($15431.73 in chips) 
Seat 2: bettercall7208 ($9109.5 in chips) 
Seat 5: tabby20 ($26182.55 in chips) 
Seat 6: manny007 ($2460.4 in chips) 
bettercall7208: posts small blind $50
tabby20: posts big blind $100
*** HOLE CARDS ***
Dealt to Lucifer999 [8c 9d]
manny007: folds
Lucifer999: folds
bettercall7208: calls $50
tabby20: checks
*** FLOP *** [4d 6h 2c]
bettercall7208: checks
tabby20: checks
*** TURN *** [4d 6h 2c] [2h]
bettercall7208: bets $127.47
tabby20: calls $127.47
*** RIVER *** [4d 6h 2c 2h] [Js]
bettercall7208: checks
tabby20: bets $200
bettercall7208: folds
Uncalled bet ($200) returned to tabby20
tabby20: doesn't show hand
tabby20 collected $434.97 from pot
*** SUMMARY ***
Total pot $454.94 | Rake $19.97
Board [4d 6h 2c 2h Js]
Seat 1: Lucifer999 (button) folded before Flop (didn't bet)
Seat 2: bettercall7208 (small blind) folded on the River
Seat 5: tabby20 (big blind) collected ($434.97)
Seat 6: manny007 folded before Flop (didn't bet)



PokerStars Game #00327537528: Hold'em No Limit ($10/$25 USD) - 2022/04/30 10:31:59 ET
Table 'Hold'em (Min 500Max 2500)  1282' 6-max Seat #2 is the button
Seat 1: foldmybets ($2693.98 in chips) 
Seat 2: jaykam ($795.83 in chips) 
Seat 4: papadickkies ($705.74 in chips) 
Seat 5: Lucifer999 ($6502.42 in chips) 
Seat 6: devi7 ($2228.84 in chips) 
papadickkies: posts small blind $10
Lucifer999: posts big blind $25
*** HOLE CARDS ***
Dealt to Lucifer999 [Td Kd]
devi7: folds
foldmybets: raises $50.00 to $75
jaykam: calls $75
papadickkies: folds
Lucifer999: calls $50
*** FLOP *** [8c 2c As]
Lucifer999: checks
foldmybets: checks
jaykam: checks
*** TURN *** [8c 2c As] [8d]
Lucifer999: bets $140
foldmybets: calls $140
jaykam: folds
*** RIVER *** [8c 2c As 8d] [3s]
Lucifer999: checks
foldmybets: checks
*** SHOW DOWN ***
Lucifer999: shows [Td Kd] (Pair, 88)
foldmybets: shows [Ac Kc] (Two pairs, AA88)
foldmybets collected $482.97 from pot
*** SUMMARY ***
Total pot $515.00 | Rake $32.03
Board [8c 2c As 8d 3s]
Seat 1: foldmybets  showed [Ac Kc] and won ($482.97) with Two pairs, AA88
Seat 2: jaykam (button) folded on the Turn
Seat 4: papadickkies (small blind) folded before Flop
Seat 5: Lucifer999 (big blind) showed [Td Kd] and lost with Pair, 88
Seat 6: devi7 folded before Flop (didn't bet)



PokerStars Game #00327537671: Hold'em No Limit ($50/$100 USD) - 2022/04/30 10:32:44 ET
Table 'Hold'em (Min 25KMax 10K)    69' 6-max Seat #2 is the button
Seat 1: Lucifer999 ($15431.73 in chips) 
Seat 2: bettercall7208 ($8882.03 in chips) 
Seat 5: tabby20 ($26390.05 in chips) 
Seat 6: manny007 ($2460.4 in chips) 
tabby20: posts small blind $50
manny007: posts big blind $100
*** HOLE CARDS ***
Dealt to Lucifer999 [5d 3d]
Lucifer999: folds
bettercall7208: folds
tabby20: folds
Uncalled bet ($50) returned to manny007
manny007: doesn't show hand
manny007 collected $100 from pot
*** SUMMARY ***
Total pot $100.00 | Rake $0
Board []
Seat 1: Lucifer999 folded before Flop (didn't bet)
Seat 2: bettercall7208 (button) folded before Flop (didn't bet)
Seat 5: tabby20 (small blind) folded before Flop
Seat 6: manny007 (big blind) collected ($100)



PokerStars Game #00327537735: Hold'em No Limit ($10/$25 USD) - 2022/04/30 10:33:02 ET
Table 'Hold'em (Min 500Max 2500)  1282' 6-max Seat #4 is the button
Seat 1: foldmybets ($2961.95 in chips) 
Seat 2: jaykam ($720.83 in chips) 
Seat 4: papadickkies ($695.74 in chips) 
Seat 5: Lucifer999 ($6287.42 in chips) 
Seat 6: devi7 ($2228.84 in chips) 
Lucifer999: posts small blind $10
devi7: posts big blind $25
*** HOLE CARDS ***
Dealt to Lucifer999 [Qs 9c]
foldmybets: folds
jaykam: folds
papadickkies: folds
Lucifer999: raises $55.00 to $80
devi7: folds
Uncalled bet ($55) returned to Lucifer999
Lucifer999: doesn't show hand
Lucifer999 collected $50 from pot
*** SUMMARY ***
Total pot $50.00 | Rake $0
Board []
Seat 1: foldmybets folded before Flop (didn't bet)
Seat 2: jaykam folded before Flop (didn't bet)
Seat 4: papadickkies (button) folded before Flop (didn't bet)
Seat 5: Lucifer999 (small blind) collected ($50)
Seat 6: devi7 (big blind) folded before Flop



PokerStars Game #00327537657: Hold'em No Limit ($25/$50 USD) - 2022/04/30 10:32:40 ET
Table 'Hold'em (Min 1K Max 5K)   216' 6-max Seat #2 is the button
Seat 1: Lucifer999 ($12422.29 in chips) 
Seat 2: rahulh1 ($2368.58 in chips) 
Seat 3: Avaroni ($6604 in chips) 
Seat 4: No username ($2363.1 in chips) 
Seat 6: Pablit0 ($3937.05 in chips) 
Avaroni: posts small blind $25
No username: posts big blind $50
*** HOLE CARDS ***
Dealt to Lucifer999 [5h Qc]
Pablit0: folds
Lucifer999: folds
rahulh1: calls $50
Avaroni: calls $25
No username: raises $150.00 to $200
rahulh1: calls $150
Avaroni: folds
*** FLOP *** [Jc 7h Ac]
No username: bets $213.75
rahulh1: folds
Uncalled bet ($213.75) returned to No username
No username: doesn't show hand
No username collected $427.5 from pot
*** SUMMARY ***
Total pot $450.00 | Rake $22.5
Board [Jc 7h Ac]
Seat 1: Lucifer999 folded before Flop (didn't bet)
Seat 2: rahulh1 (button) folded on the Flop
Seat 3: Avaroni (small blind) folded before Flop
Seat 4: No username (big blind) collected ($427.5)
Seat 6: Pablit0 folded before Flop (didn't bet)



PokerStars Game #00327537654: Hold'em No Limit ($10/$25 USD) - 2022/04/30 10:32:40 ET
Table 'Hold'em (Min 500Max 2500) 1001' 6-max Seat #3 is the button
Seat 1: JaspritBumrah786 ($2395 in chips) 
Seat 2: fishfry123 ($1734.51 in chips) 
Seat 3: EASYWITHACES ($2630.28 in chips) 
Seat 4: devi7 ($2218.89 in chips) 
Seat 5: Lucifer999 ($4681.18 in chips) 
Seat 6: spidy02 ($4322.79 in chips) 
devi7: posts small blind $10
Lucifer999: posts big blind $25
*** HOLE CARDS ***
Dealt to Lucifer999 [3c Th]
spidy02: calls $25
JaspritBumrah786: folds
fishfry123: calls $25
EASYWITHACES: calls $25
devi7: calls $15
Lucifer999: checks
*** FLOP *** [Qs 9d Jh]
devi7: checks
Lucifer999: checks
spidy02: checks
fishfry123: checks
EASYWITHACES: bets $117.44
devi7: folds
Lucifer999: folds
spidy02: folds
fishfry123: calls $117.44
*** TURN *** [Qs 9d Jh] [7s]
fishfry123: checks
EASYWITHACES: bets $2487.84
fishfry123: folds
Uncalled bet ($2487.84) returned to EASYWITHACES
EASYWITHACES: doesn't show hand
EASYWITHACES collected $338.04 from pot
*** SUMMARY ***
Total pot $359.88 | Rake $21.84
Board [Qs 9d Jh 7s]
Seat 1: JaspritBumrah786 folded before Flop (didn't bet)
Seat 2: fishfry123 folded on the Turn
Seat 3: EASYWITHACES (button) collected ($338.04)
Seat 4: devi7 (small blind) folded on the Flop
Seat 5: Lucifer999 (big blind) folded on the Flop
Seat 6: spidy02 folded on the Flop



PokerStars Game #00327537756: Hold'em No Limit ($50/$100 USD) - 2022/04/30 10:33:06 ET
Table 'Hold'em (Min 25KMax 10K)    69' 6-max Seat #5 is the button
Seat 1: Lucifer999 ($15431.73 in chips) 
Seat 2: bettercall7208 ($8882.03 in chips) 
Seat 5: tabby20 ($26340.05 in chips) 
Seat 6: manny007 ($2510.4 in chips) 
manny007: posts small blind $50
Lucifer999: posts big blind $100
*** HOLE CARDS ***
Dealt to Lucifer999 [Qs Th]
bettercall7208: raises $200.00 to $300
tabby20: folds
manny007: folds
Lucifer999: calls $200
*** FLOP *** [9d Ah 7d]
Lucifer999: checks
bettercall7208: bets $310.7
Lucifer999: folds
Uncalled bet ($310.7) returned to bettercall7208
bettercall7208: doesn't show hand
bettercall7208 collected $621.4 from pot
*** SUMMARY ***
Total pot $650.00 | Rake $28.6
Board [9d Ah 7d]
Seat 1: Lucifer999 (big blind) folded on the Flop
Seat 2: bettercall7208 collected ($621.4)
Seat 5: tabby20 (button) folded before Flop (didn't bet)
Seat 6: manny007 (small blind) folded before Flop



PokerStars Game #00327537830: Hold'em No Limit ($25/$50 USD) - 2022/04/30 10:33:26 ET
Table 'Hold'em (Min 1K Max 5K)   216' 6-max Seat #3 is the button
Seat 1: Lucifer999 ($12422.29 in chips) 
Seat 2: rahulh1 ($2168.58 in chips) 
Seat 3: Avaroni ($6554 in chips) 
Seat 4: No username ($2590.6 in chips) 
Seat 6: Pablit0 ($3937.05 in chips) 
No username: posts small blind $25
Pablit0: posts big blind $50
*** HOLE CARDS ***
Dealt to Lucifer999 [4c Kc]
Lucifer999: folds
rahulh1: raises $104.02 to $154.02
Avaroni: folds
No username: folds
Pablit0: folds
Uncalled bet ($104.02) returned to rahulh1
rahulh1: doesn't show hand
rahulh1 collected $125 from pot
*** SUMMARY ***
Total pot $125.00 | Rake $0
Board []
Seat 1: Lucifer999 folded before Flop (didn't bet)
Seat 2: rahulh1 collected ($125)
Seat 3: Avaroni (button) folded before Flop (didn't bet)
Seat 4: No username (small blind) folded before Flop
Seat 6: Pablit0 (big blind) folded before Flop



PokerStars Game #00327537808: Hold'em No Limit ($10/$25 USD) - 2022/04/30 10:33:20 ET
Table 'Hold'em (Min 500Max 2500)  1282' 6-max Seat #5 is the button
Seat 1: foldmybets ($2961.95 in chips) 
Seat 2: jaykam ($720.83 in chips) 
Seat 4: papadickkies ($695.74 in chips) 
Seat 5: Lucifer999 ($6312.42 in chips) 
Seat 6: devi7 ($2203.84 in chips) 
devi7: posts small blind $10
foldmybets: posts big blind $25
*** HOLE CARDS ***
Dealt to Lucifer999 [7d Jh]
jaykam: folds
papadickkies: folds
Lucifer999: raises $45.00 to $70
devi7: folds
foldmybets: calls $45
*** FLOP *** [9c 2h 5d]
foldmybets: checks
Lucifer999: checks
*** TURN *** [9c 2h 5d] [Ah]
foldmybets: bets $100
Lucifer999: folds
Uncalled bet ($100) returned to foldmybets
foldmybets: doesn't show hand
foldmybets collected $141.13 from pot
*** SUMMARY ***
Total pot $150.00 | Rake $8.87
Board [9c 2h 5d Ah]
Seat 1: foldmybets (big blind) collected ($141.13)
Seat 2: jaykam folded before Flop (didn't bet)
Seat 4: papadickkies folded before Flop (didn't bet)
Seat 5: Lucifer999 (button) folded on the Turn
Seat 6: devi7 (small blind) folded before Flop



PokerStars Game #00327537898: Hold'em No Limit ($50/$100 USD) - 2022/04/30 10:33:46 ET
Table 'Hold'em (Min 25KMax 10K)    69' 6-max Seat #6 is the button
Seat 1: Lucifer999 ($15131.73 in chips) 
Seat 2: bettercall7208 ($9203.43 in chips) 
Seat 5: tabby20 ($26340.05 in chips) 
Seat 6: manny007 ($2460.4 in chips) 
Lucifer999: posts small blind $50
bettercall7208: posts big blind $100
*** HOLE CARDS ***
Dealt to Lucifer999 [3d 9c]
tabby20: folds
manny007: folds
Lucifer999: folds
Uncalled bet ($50) returned to bettercall7208
bettercall7208: doesn't show hand
bettercall7208 collected $100 from pot
*** SUMMARY ***
Total pot $100.00 | Rake $0
Board []
Seat 1: Lucifer999 (small blind) folded before Flop
Seat 2: bettercall7208 (big blind) collected ($100)
Seat 5: tabby20 folded before Flop (didn't bet)
Seat 6: manny007 (button) folded before Flop (didn't bet)



PokerStars Game #00327537872: Hold'em No Limit ($10/$25 USD) - 2022/04/30 10:33:39 ET
Table 'Hold'em (Min 500Max 2500) 1001' 6-max Seat #4 is the button
Seat 1: JaspritBumrah786 ($2395 in chips) 
Seat 2: fishfry123 ($1592.07 in chips) 
Seat 3: EASYWITHACES ($2825.88 in chips) 
Seat 4: devi7 ($2193.89 in chips) 
Seat 5: Lucifer999 ($4656.18 in chips) 
Seat 6: spidy02 ($4297.79 in chips) 
Lucifer999: posts small blind $10
spidy02: posts big blind $25
*** HOLE CARDS ***
Dealt to Lucifer999 [3s 3h]
JaspritBumrah786: folds
fishfry123: folds
EASYWITHACES: calls $25
devi7: raises $85.00 to $110
Lucifer999: calls $100
spidy02: folds
EASYWITHACES: calls $85
*** FLOP *** [Tc As 4c]
Lucifer999: checks
EASYWITHACES: checks
devi7: bets $220.02
Lucifer999: folds
EASYWITHACES: calls $220.02
*** TURN *** [Tc As 4c] [Ah]
EASYWITHACES: checks
devi7: bets $374.16
EASYWITHACES: folds
Uncalled bet ($374.16) returned to devi7
devi7: doesn't show hand
devi7 collected $748.31 from pot
*** SUMMARY ***
Total pot $795.04 | Rake $46.73
Board [Tc As 4c Ah]
Seat 1: JaspritBumrah786 folded before Flop (didn't bet)
Seat 2: fishfry123 folded before Flop (didn't bet)
Seat 3: EASYWITHACES folded on the Turn
Seat 4: devi7 (button) collected ($748.31)
Seat 5: Lucifer999 (small blind) folded on the Flop
Seat 6: spidy02 (big blind) folded before Flop



PokerStars Game #00327537989: Hold'em No Limit ($50/$100 USD) - 2022/04/30 10:34:15 ET
Table 'Hold'em (Min 25KMax 10K)    69' 6-max Seat #1 is the button
Seat 1: Lucifer999 ($15081.73 in chips) 
Seat 2: bettercall7208 ($9253.43 in chips) 
Seat 5: tabby20 ($26340.05 in chips) 
Seat 6: manny007 ($2460.4 in chips) 
bettercall7208: posts small blind $50
tabby20: posts big blind $100
*** HOLE CARDS ***
Dealt to Lucifer999 [Kc 7h]
manny007: folds
Lucifer999: folds
bettercall7208: folds
Uncalled bet ($50) returned to tabby20
tabby20: doesn't show hand
tabby20 collected $100 from pot
*** SUMMARY ***
Total pot $100.00 | Rake $0
Board []
Seat 1: Lucifer999 (button) folded before Flop (didn't bet)
Seat 2: bettercall7208 (small blind) folded before Flop
Seat 5: tabby20 (big blind) collected ($100)
Seat 6: manny007 folded before Flop (didn't bet)



PokerStars Game #00327537926: Hold'em No Limit ($25/$50 USD) - 2022/04/30 10:33:55 ET
Table 'Hold'em (Min 1K Max 5K)   216' 6-max Seat #4 is the button
Seat 1: Lucifer999 ($12422.29 in chips) 
Seat 2: rahulh1 ($2243.58 in chips) 
Seat 3: Avaroni ($6554 in chips) 
Seat 4: No username ($2565.6 in chips) 
Seat 6: Pablit0 ($3887.05 in chips) 
Pablit0: posts small blind $25
Lucifer999: posts big blind $50
*** HOLE CARDS ***
Dealt to Lucifer999 [Ah 6h]
rahulh1: folds
Avaroni: folds
No username: raises $125.00 to $175
Pablit0: folds
Lucifer999: calls $125
*** FLOP *** [2h 8h 3s]
Lucifer999: checks
No username: checks
*** TURN *** [2h 8h 3s] [Qc]
Lucifer999: bets $250
No username: calls $250
*** RIVER *** [2h 8h 3s Qc] [Ts]
Lucifer999: checks
No username: checks
*** SHOW DOWN ***
Lucifer999: shows [Ah 6h] (High card, A)
No username: shows [Ad Kh] (High card, A)
No username collected $831.25 from pot
*** SUMMARY ***
Total pot $875.00 | Rake $43.75
Board [2h 8h 3s Qc Ts]
Seat 1: Lucifer999 (big blind) showed [Ah 6h] and lost with High card, A
Seat 2: rahulh1 folded before Flop (didn't bet)
Seat 3: Avaroni folded before Flop (didn't bet)
Seat 4: No username  (button) showed [Ad Kh] and won ($831.25) with High card, A
Seat 6: Pablit0 (small blind) folded before Flop



PokerStars Game #00327538055: Hold'em No Limit ($10/$25 USD) - 2022/04/30 10:34:35 ET
Table 'Hold'em (Min 500Max 2500) 1001' 6-max Seat #5 is the button
Seat 1: JaspritBumrah786 ($2395 in chips) 
Seat 2: fishfry123 ($1592.07 in chips) 
Seat 3: EASYWITHACES ($2495.86 in chips) 
Seat 4: devi7 ($2612.18 in chips) 
Seat 5: Lucifer999 ($4546.18 in chips) 
Seat 6: spidy02 ($4272.79 in chips) 
spidy02: posts small blind $10
JaspritBumrah786: posts big blind $25
*** HOLE CARDS ***
Dealt to Lucifer999 [9s 4h]
fishfry123: calls $25
EASYWITHACES: raises $100.00 to $125
devi7: folds
Lucifer999: folds
spidy02: folds
JaspritBumrah786: folds
fishfry123: folds
Uncalled bet ($100) returned to EASYWITHACES
EASYWITHACES: doesn't show hand
EASYWITHACES collected $85 from pot
*** SUMMARY ***
Total pot $85.00 | Rake $0
Board []
Seat 1: JaspritBumrah786 (big blind) folded before Flop
Seat 2: fishfry123 folded before Flop
Seat 3: EASYWITHACES collected ($85)
Seat 4: devi7 folded before Flop (didn't bet)
Seat 5: Lucifer999 (button) folded before Flop (didn't bet)
Seat 6: spidy02 (small blind) folded before Flop



PokerStars Game #00327537988: Hold'em No Limit ($10/$25 USD) - 2022/04/30 10:34:14 ET
Table 'Hold'em (Min 500Max 2500)  1282' 6-max Seat #6 is the button
Seat 1: foldmybets ($3033.08 in chips) 
Seat 2: jaykam ($720.83 in chips) 
Seat 4: papadickkies ($695.74 in chips) 
Seat 5: Lucifer999 ($6242.42 in chips) 
Seat 6: devi7 ($2193.84 in chips) 
foldmybets: posts small blind $10
jaykam: posts big blind $25
*** HOLE CARDS ***
Dealt to Lucifer999 [2c 3s]
papadickkies: raises $50.00 to $75
Lucifer999: folds
devi7: folds
foldmybets: folds
jaykam: calls $50
*** FLOP *** [6h Jd 9d]
jaykam: checks
papadickkies: bets $45
jaykam: folds
Uncalled bet ($45) returned to papadickkies
papadickkies: doesn't show hand
papadickkies collected $150.6 from pot
*** SUMMARY ***
Total pot $160.00 | Rake $9.4
Board [6h Jd 9d]
Seat 1: foldmybets (small blind) folded before Flop
Seat 2: jaykam (big blind) folded on the Flop
Seat 4: papadickkies collected ($150.6)
Seat 5: Lucifer999 folded before Flop (didn't bet)
Seat 6: devi7 (button) folded before Flop (didn't bet)



PokerStars Game #00327538057: Hold'em No Limit ($50/$100 USD) - 2022/04/30 10:34:35 ET
Table 'Hold'em (Min 25KMax 10K)    69' 6-max Seat #2 is the button
Seat 1: Lucifer999 ($15081.73 in chips) 
Seat 2: bettercall7208 ($9203.43 in chips) 
Seat 5: tabby20 ($26390.05 in chips) 
Seat 6: manny007 ($2460.4 in chips) 
tabby20: posts small blind $50
manny007: posts big blind $100
*** HOLE CARDS ***
Dealt to Lucifer999 [4s 3h]
Lucifer999: folds
bettercall7208: raises $200.00 to $300
tabby20: folds
manny007: folds
Uncalled bet ($200) returned to bettercall7208
bettercall7208: doesn't show hand
bettercall7208 collected $250 from pot
*** SUMMARY ***
Total pot $250.00 | Rake $0
Board []
Seat 1: Lucifer999 folded before Flop (didn't bet)
Seat 2: bettercall7208 (button) collected ($250)
Seat 5: tabby20 (small blind) folded before Flop
Seat 6: manny007 (big blind) folded before Flop



PokerStars Game #00327538165: Hold'em No Limit ($10/$25 USD) - 2022/04/30 10:35:06 ET
Table 'Hold'em (Min 500Max 2500)  1282' 6-max Seat #1 is the button
Seat 1: foldmybets ($3023.08 in chips) 
Seat 2: jaykam ($645.83 in chips) 
Seat 4: papadickkies ($771.34 in chips) 
Seat 5: Lucifer999 ($6242.42 in chips) 
Seat 6: devi7 ($2193.84 in chips) 
jaykam: posts small blind $10
papadickkies: posts big blind $25
*** HOLE CARDS ***
Dealt to Lucifer999 [Td Tc]
Lucifer999: raises $55.00 to $80
devi7: folds
foldmybets: folds
jaykam: folds
papadickkies: folds
Uncalled bet ($55) returned to Lucifer999
Lucifer999: doesn't show hand
Lucifer999 collected $60 from pot
*** SUMMARY ***
Total pot $60.00 | Rake $0
Board []
Seat 1: foldmybets (button) folded before Flop (didn't bet)
Seat 2: jaykam (small blind) folded before Flop
Seat 4: papadickkies (big blind) folded before Flop
Seat 5: Lucifer999 collected ($60)
Seat 6: devi7 folded before Flop (didn't bet)



PokerStars Game #00327538113: Hold'em No Limit ($25/$50 USD) - 2022/04/30 10:34:49 ET
Table 'Hold'em (Min 1K Max 5K)   216' 6-max Seat #6 is the button
Seat 1: Lucifer999 ($11997.29 in chips) 
Seat 2: rahulh1 ($2243.58 in chips) 
Seat 3: Avaroni ($6554 in chips) 
Seat 4: No username ($2971.85 in chips) 
Seat 6: Pablit0 ($3862.05 in chips) 
Lucifer999: posts small blind $25
rahulh1: posts big blind $50
*** HOLE CARDS ***
Dealt to Lucifer999 [Jd Th]
Avaroni: folds
No username: raises $66.67 to $116.67
Pablit0: calls $116.67
Lucifer999: folds
rahulh1: calls $66.67
*** FLOP *** [Kc 6c 4h]
rahulh1: checks
No username: checks
Pablit0: bets $150
rahulh1: folds
No username: folds
Uncalled bet ($150) returned to Pablit0
Pablit0: doesn't show hand
Pablit0 collected $356.26 from pot
*** SUMMARY ***
Total pot $375.01 | Rake $18.75
Board [Kc 6c 4h]
Seat 1: Lucifer999 (small blind) folded before Flop
Seat 2: rahulh1 (big blind) folded on the Flop
Seat 3: Avaroni folded before Flop (didn't bet)
Seat 4: No username folded on the Flop
Seat 6: Pablit0 (button) collected ($356.26)



PokerStars Game #00327538173: Hold'em No Limit ($50/$100 USD) - 2022/04/30 10:35:09 ET
Table 'Hold'em (Min 25KMax 10K)    69' 6-max Seat #5 is the button
Seat 1: Lucifer999 ($15081.73 in chips) 
Seat 2: bettercall7208 ($9353.43 in chips) 
Seat 5: tabby20 ($26340.05 in chips) 
Seat 6: manny007 ($2360.4 in chips) 
manny007: posts small blind $50
Lucifer999: posts big blind $100
*** HOLE CARDS ***
Dealt to Lucifer999 [Js 6h]
bettercall7208: raises $100.00 to $200
tabby20: calls $200
manny007: folds
Lucifer999: folds
*** FLOP *** [9d Kc 9s]
bettercall7208: bets $262.9
tabby20: folds
Uncalled bet ($262.9) returned to bettercall7208
bettercall7208: doesn't show hand
bettercall7208 collected $525.8 from pot
*** SUMMARY ***
Total pot $550.00 | Rake $24.2
Board [9d Kc 9s]
Seat 1: Lucifer999 (big blind) folded before Flop
Seat 2: bettercall7208 collected ($525.8)
Seat 5: tabby20 (button) folded on the Flop
Seat 6: manny007 (small blind) folded before Flop



PokerStars Game #00327538157: Hold'em No Limit ($10/$25 USD) - 2022/04/30 10:35:03 ET
Table 'Hold'em (Min 500Max 2500) 1001' 6-max Seat #6 is the button
Seat 1: JaspritBumrah786 ($2370 in chips) 
Seat 2: fishfry123 ($1567.07 in chips) 
Seat 3: EASYWITHACES ($2555.86 in chips) 
Seat 4: devi7 ($2612.18 in chips) 
Seat 5: Lucifer999 ($4546.18 in chips) 
Seat 6: spidy02 ($4262.79 in chips) 
JaspritBumrah786: posts small blind $10
fishfry123: posts big blind $25
*** HOLE CARDS ***
Dealt to Lucifer999 [Kh 2c]
EASYWITHACES: folds
devi7: folds
Lucifer999: folds
spidy02: folds
JaspritBumrah786: folds
Uncalled bet ($15) returned to fishfry123
fishfry123: doesn't show hand
fishfry123 collected $20 from pot
*** SUMMARY ***
Total pot $20.00 | Rake $0
Board []
Seat 1: JaspritBumrah786 (small blind) folded before Flop
Seat 2: fishfry123 (big blind) collected ($20)
Seat 3: EASYWITHACES folded before Flop (didn't bet)
Seat 4: devi7 folded before Flop (didn't bet)
Seat 5: Lucifer999 folded before Flop (didn't bet)
Seat 6: spidy02 (button) folded before Flop (didn't bet)



PokerStars Game #00327538297: Hold'em No Limit ($50/$100 USD) - 2022/04/30 10:35:47 ET
Table 'Hold'em (Min 25KMax 10K)    69' 6-max Seat #6 is the button
Seat 1: Lucifer999 ($14981.73 in chips) 
Seat 2: bettercall7208 ($9679.23 in chips) 
Seat 5: tabby20 ($26140.05 in chips) 
Seat 6: manny007 ($2310.4 in chips) 
Lucifer999: posts small blind $50
bettercall7208: posts big blind $100
*** HOLE CARDS ***
Dealt to Lucifer999 [5c Th]
tabby20: folds
manny007: folds
Lucifer999: folds
Uncalled bet ($50) returned to bettercall7208
bettercall7208: doesn't show hand
bettercall7208 collected $100 from pot
*** SUMMARY ***
Total pot $100.00 | Rake $0
Board []
Seat 1: Lucifer999 (small blind) folded before Flop
Seat 2: bettercall7208 (big blind) collected ($100)
Seat 5: tabby20 folded before Flop (didn't bet)
Seat 6: manny007 (button) folded before Flop (didn't bet)



PokerStars Game #00327538274: Hold'em No Limit ($25/$50 USD) - 2022/04/30 10:35:39 ET
Table 'Hold'em (Min 1K Max 5K)   216' 6-max Seat #1 is the button
Seat 1: Lucifer999 ($11972.29 in chips) 
Seat 2: rahulh1 ($2126.91 in chips) 
Seat 3: Avaroni ($6554 in chips) 
Seat 4: No username ($2855.18 in chips) 
Seat 5: BIG DADDY__ ($1560 in chips) 
Seat 6: Pablit0 ($4101.64 in chips) 
rahulh1: posts small blind $25
Avaroni: posts big blind $50
BIG DADDY__: posts big blind $50
*** HOLE CARDS ***
Dealt to Lucifer999 [4h Td]
No username: folds
BIG DADDY__: checks
Pablit0: folds
Lucifer999: folds
rahulh1: calls $25
Avaroni: raises $150.00 to $200
BIG DADDY__: folds
rahulh1: folds
Uncalled bet ($150) returned to Avaroni
Avaroni: doesn't show hand
Avaroni collected $150 from pot
*** SUMMARY ***
Total pot $150.00 | Rake $0
Board []
Seat 1: Lucifer999 (button) folded before Flop (didn't bet)
Seat 2: rahulh1 (small blind) folded before Flop
Seat 3: Avaroni (big blind) collected ($150)
Seat 4: No username folded before Flop (didn't bet)
Seat 5: BIG DADDY__ folded before Flop
Seat 6: Pablit0 folded before Flop (didn't bet)



PokerStars Game #00327538372: Hold'em No Limit ($50/$100 USD) - 2022/04/30 10:36:10 ET
Table 'Hold'em (Min 25KMax 10K)    69' 6-max Seat #1 is the button
Seat 1: Lucifer999 ($14931.73 in chips) 
Seat 2: bettercall7208 ($9729.23 in chips) 
Seat 5: tabby20 ($26140.05 in chips) 
Seat 6: manny007 ($2310.4 in chips) 
bettercall7208: posts small blind $50
tabby20: posts big blind $100
*** HOLE CARDS ***
Dealt to Lucifer999 [Ts 4s]
manny007: calls $100
Lucifer999: folds
bettercall7208: calls $50
tabby20: raises $350.00 to $450
manny007: folds
bettercall7208: folds
Uncalled bet ($350) returned to tabby20
tabby20: doesn't show hand
tabby20 collected $300 from pot
*** SUMMARY ***
Total pot $300.00 | Rake $0
Board []
Seat 1: Lucifer999 (button) folded before Flop (didn't bet)
Seat 2: bettercall7208 (small blind) folded before Flop
Seat 5: tabby20 (big blind) collected ($300)
Seat 6: manny007 folded before Flop



PokerStars Game #00327538361: Hold'em No Limit ($10/$25 USD) - 2022/04/30 10:36:05 ET
Table 'Hold'em (Min 500Max 2500) 1001' 6-max Seat #1 is the button
Seat 1: JaspritBumrah786 ($2360 in chips) 
Seat 2: fishfry123 ($1577.07 in chips) 
Seat 3: EASYWITHACES ($2555.86 in chips) 
Seat 4: devi7 ($2612.18 in chips) 
Seat 5: Lucifer999 ($4546.18 in chips) 
Seat 6: spidy02 ($4262.79 in chips) 
fishfry123: posts small blind $10
EASYWITHACES: posts big blind $25
*** HOLE CARDS ***
Dealt to Lucifer999 [Qh 2d]
devi7: folds
Lucifer999: folds
spidy02: raises $60.00 to $85
JaspritBumrah786: folds
fishfry123: folds
EASYWITHACES: folds
Uncalled bet ($60) returned to spidy02
spidy02: doesn't show hand
spidy02 collected $60 from pot
*** SUMMARY ***
Total pot $60.00 | Rake $0
Board []
Seat 1: JaspritBumrah786 (button) folded before Flop (didn't bet)
Seat 2: fishfry123 (small blind) folded before Flop
Seat 3: EASYWITHACES (big blind) folded before Flop
Seat 4: devi7 folded before Flop (didn't bet)
Seat 5: Lucifer999 folded before Flop (didn't bet)
Seat 6: spidy02 collected ($60)



PokerStars Game #00327538264: Hold'em No Limit ($10/$25 USD) - 2022/04/30 10:35:34 ET
Table 'Hold'em (Min 500Max 2500)  1282' 6-max Seat #2 is the button
Seat 1: foldmybets ($3023.08 in chips) 
Seat 2: jaykam ($635.83 in chips) 
Seat 3: Mastkalandar ($500 in chips) 
Seat 4: papadickkies ($746.34 in chips) 
Seat 5: Lucifer999 ($6277.42 in chips) 
Seat 6: devi7 ($2193.84 in chips) 
papadickkies: posts small blind $10
Lucifer999: posts big blind $25
*** HOLE CARDS ***
Dealt to Lucifer999 [Kd 7d]
devi7: folds
foldmybets: raises $50.00 to $75
jaykam: calls $75
papadickkies: folds
Lucifer999: calls $50
*** FLOP *** [8h 2s Ks]
Lucifer999: checks
foldmybets: checks
jaykam: checks
*** TURN *** [8h 2s Ks] [4c]
Lucifer999: checks
foldmybets: checks
jaykam: bets $110.34
Lucifer999: raises $169.66 to $280
foldmybets: folds
jaykam: folds
Uncalled bet ($169.66) returned to Lucifer999
Lucifer999: doesn't show hand
Lucifer999 collected $427.8 from pot
*** SUMMARY ***
Total pot $455.68 | Rake $27.88
Board [8h 2s Ks 4c]
Seat 1: foldmybets folded on the Turn
Seat 2: jaykam (button) folded on the Turn
Seat 4: papadickkies (small blind) folded before Flop
Seat 5: Lucifer999 (big blind) collected ($427.8)
Seat 6: devi7 folded before Flop (didn't bet)



PokerStars Game #00327538451: Hold'em No Limit ($50/$100 USD) - 2022/04/30 10:36:32 ET
Table 'Hold'em (Min 25KMax 10K)    69' 6-max Seat #2 is the button
Seat 1: Lucifer999 ($14931.73 in chips) 
Seat 2: bettercall7208 ($9629.23 in chips) 
Seat 5: tabby20 ($26340.05 in chips) 
Seat 6: manny007 ($2210.4 in chips) 
tabby20: posts small blind $50
manny007: posts big blind $100
*** HOLE CARDS ***
Dealt to Lucifer999 [6d 7d]
Lucifer999: folds
bettercall7208: folds
tabby20: folds
Uncalled bet ($50) returned to manny007
manny007: doesn't show hand
manny007 collected $100 from pot
*** SUMMARY ***
Total pot $100.00 | Rake $0
Board []
Seat 1: Lucifer999 folded before Flop (didn't bet)
Seat 2: bettercall7208 (button) folded before Flop (didn't bet)
Seat 5: tabby20 (small blind) folded before Flop
Seat 6: manny007 (big blind) collected ($100)



PokerStars Game #00327538486: Hold'em No Limit ($10/$25 USD) - 2022/04/30 10:36:43 ET
Table 'Hold'em (Min 500Max 2500)  1282' 6-max Seat #4 is the button
Seat 1: foldmybets ($2948.08 in chips) 
Seat 2: jaykam ($450.49 in chips) 
Seat 3: Mastkalandar ($500 in chips) 
Seat 4: papadickkies ($736.34 in chips) 
Seat 5: Lucifer999 ($6519.88 in chips) 
Seat 6: devi7 ($2193.84 in chips) 
Lucifer999: posts small blind $10
devi7: posts big blind $25
*** HOLE CARDS ***
Dealt to Lucifer999 [4c Jh]
foldmybets: folds
jaykam: folds
papadickkies: folds
Lucifer999: folds
Uncalled bet ($15) returned to devi7
devi7: doesn't show hand
devi7 collected $20 from pot
*** SUMMARY ***
Total pot $20.00 | Rake $0
Board []
Seat 1: foldmybets folded before Flop (didn't bet)
Seat 2: jaykam folded before Flop (didn't bet)
Seat 4: papadickkies (button) folded before Flop (didn't bet)
Seat 5: Lucifer999 (small blind) folded before Flop
Seat 6: devi7 (big blind) collected ($20)



PokerStars Game #00327538409: Hold'em No Limit ($25/$50 USD) - 2022/04/30 10:36:20 ET
Table 'Hold'em (Min 1K Max 5K)   216' 6-max Seat #2 is the button
Seat 1: Lucifer999 ($11972.29 in chips) 
Seat 2: rahulh1 ($2076.91 in chips) 
Seat 3: Avaroni ($6654 in chips) 
Seat 4: No username ($2855.18 in chips) 
Seat 5: BIG DADDY__ ($1510 in chips) 
Seat 6: Pablit0 ($4101.64 in chips) 
Avaroni: posts small blind $25
No username: posts big blind $50
*** HOLE CARDS ***
Dealt to Lucifer999 [Jc 8h]
BIG DADDY__: folds
Pablit0: folds
Lucifer999: folds
rahulh1: folds
Avaroni: raises $125.00 to $175
No username: calls $125
*** FLOP *** [Ah 7c Tc]
Avaroni: bets $275
No username: folds
Uncalled bet ($275) returned to Avaroni
Avaroni: doesn't show hand
Avaroni collected $332.5 from pot
*** SUMMARY ***
Total pot $350.00 | Rake $17.5
Board [Ah 7c Tc]
Seat 1: Lucifer999 folded before Flop (didn't bet)
Seat 2: rahulh1 (button) folded before Flop (didn't bet)
Seat 3: Avaroni (small blind) collected ($332.5)
Seat 4: No username (big blind) folded on the Flop
Seat 5: BIG DADDY__ folded before Flop (didn't bet)
Seat 6: Pablit0 folded before Flop (didn't bet)



PokerStars Game #00327538512: Hold'em No Limit ($50/$100 USD) - 2022/04/30 10:36:51 ET
Table 'Hold'em (Min 25KMax 10K)    69' 6-max Seat #5 is the button
Seat 1: Lucifer999 ($14931.73 in chips) 
Seat 2: bettercall7208 ($9629.23 in chips) 
Seat 5: tabby20 ($26290.05 in chips) 
Seat 6: manny007 ($2260.4 in chips) 
manny007: posts small blind $50
Lucifer999: posts big blind $100
*** HOLE CARDS ***
Dealt to Lucifer999 [9s 4h]
bettercall7208: folds
tabby20: raises $200.00 to $300
manny007: folds
Lucifer999: folds
Uncalled bet ($200) returned to tabby20
tabby20: doesn't show hand
tabby20 collected $250 from pot
*** SUMMARY ***
Total pot $250.00 | Rake $0
Board []
Seat 1: Lucifer999 (big blind) folded before Flop
Seat 2: bettercall7208 folded before Flop (didn't bet)
Seat 5: tabby20 (button) collected ($250)
Seat 6: manny007 (small blind) folded before Flop



PokerStars Game #00327538456: Hold'em No Limit ($10/$25 USD) - 2022/04/30 10:36:34 ET
Table 'Hold'em (Min 500Max 2500) 1001' 6-max Seat #2 is the button
Seat 1: JaspritBumrah786 ($2360 in chips) 
Seat 2: fishfry123 ($1567.07 in chips) 
Seat 3: EASYWITHACES ($2530.86 in chips) 
Seat 4: devi7 ($2612.18 in chips) 
Seat 5: Lucifer999 ($4546.18 in chips) 
Seat 6: spidy02 ($4297.79 in chips) 
EASYWITHACES: posts small blind $10
devi7: posts big blind $25
*** HOLE CARDS ***
Dealt to Lucifer999 [Th Td]
Lucifer999: raises $55.00 to $80
spidy02: calls $80
JaspritBumrah786: folds
fishfry123: calls $80
EASYWITHACES: folds
devi7: folds
*** FLOP *** [7c Ah Js]
Lucifer999: checks
spidy02: bets $129.29
fishfry123: folds
Lucifer999: folds
Uncalled bet ($129.29) returned to spidy02
spidy02: doesn't show hand
spidy02 collected $258.57 from pot
*** SUMMARY ***
Total pot $275.00 | Rake $16.43
Board [7c Ah Js]
Seat 1: JaspritBumrah786 folded before Flop (didn't bet)
Seat 2: fishfry123 (button) folded on the Flop
Seat 3: EASYWITHACES (small blind) folded before Flop
Seat 4: devi7 (big blind) folded before Flop
Seat 5: Lucifer999 folded on the Flop
Seat 6: spidy02 collected ($258.57)



PokerStars Game #00327538531: Hold'em No Limit ($10/$25 USD) - 2022/04/30 10:36:56 ET
Table 'Hold'em (Min 500Max 2500)  1282' 6-max Seat #5 is the button
Seat 1: foldmybets ($2948.08 in chips) 
Seat 2: jaykam ($450.49 in chips) 
Seat 3: Mastkalandar ($500 in chips) 
Seat 4: papadickkies ($736.34 in chips) 
Seat 5: Lucifer999 ($6509.88 in chips) 
Seat 6: devi7 ($2203.84 in chips) 
devi7: posts small blind $10
foldmybets: posts big blind $25
*** HOLE CARDS ***
Dealt to Lucifer999 [3h 2c]
jaykam: folds
papadickkies: raises $40.00 to $65
Lucifer999: folds
devi7: folds
foldmybets: folds
Uncalled bet ($40) returned to papadickkies
papadickkies: doesn't show hand
papadickkies collected $60 from pot
*** SUMMARY ***
Total pot $60.00 | Rake $0
Board []
Seat 1: foldmybets (big blind) folded before Flop
Seat 2: jaykam folded before Flop (didn't bet)
Seat 4: papadickkies collected ($60)
Seat 5: Lucifer999 (button) folded before Flop (didn't bet)
Seat 6: devi7 (small blind) folded before Flop



PokerStars Game #00327538578: Hold'em No Limit ($50/$100 USD) - 2022/04/30 10:37:10 ET
Table 'Hold'em (Min 25KMax 10K)    69' 6-max Seat #6 is the button
Seat 1: Lucifer999 ($14831.73 in chips) 
Seat 2: bettercall7208 ($9629.23 in chips) 
Seat 5: tabby20 ($26440.05 in chips) 
Seat 6: manny007 ($2210.4 in chips) 
Lucifer999: posts small blind $50
bettercall7208: posts big blind $100
*** HOLE CARDS ***
Dealt to Lucifer999 [As 5d]
tabby20: folds
manny007: calls $100
Lucifer999: folds
bettercall7208: checks
*** FLOP *** [7h 7c 5c]
bettercall7208: checks
manny007: checks
*** TURN *** [7h 7c 5c] [Kc]
bettercall7208: bets $100
manny007: calls $100
*** RIVER *** [7h 7c 5c Kc] [Qs]
bettercall7208: bets $215.1
manny007: calls $215.1
*** SHOW DOWN ***
bettercall7208: shows [4h Qc] (Two pairs, QQ77)
manny007: doesn't show hand
bettercall7208 collected $841.48 from pot
*** SUMMARY ***
Total pot $880.20 | Rake $38.72
Board [7h 7c 5c Kc Qs]
Seat 1: Lucifer999 (small blind) folded before Flop
Seat 2: bettercall7208  (big blind) showed [4h Qc] and won ($841.48) with Two pairs, QQ77
Seat 5: tabby20 folded before Flop (didn't bet)
Seat 6: manny007 (button) mucked



PokerStars Game #00327538541: Hold'em No Limit ($25/$50 USD) - 2022/04/30 10:36:59 ET
Table 'Hold'em (Min 1K Max 5K)   216' 6-max Seat #3 is the button
Seat 1: Lucifer999 ($11972.29 in chips) 
Seat 2: rahulh1 ($2076.91 in chips) 
Seat 3: Avaroni ($6811.5 in chips) 
Seat 4: No username ($2680.18 in chips) 
Seat 5: BIG DADDY__ ($1510 in chips) 
Seat 6: Pablit0 ($4101.64 in chips) 
No username: posts small blind $25
BIG DADDY__: posts big blind $50
*** HOLE CARDS ***
Dealt to Lucifer999 [6s Tc]
Pablit0: folds
Lucifer999: folds
rahulh1: calls $50
Avaroni: folds
No username: calls $25
BIG DADDY__: checks
*** FLOP *** [Kc Qd Qc]
No username: bets $106.88
BIG DADDY__: folds
rahulh1: calls $106.88
*** TURN *** [Kc Qd Qc] [6h]
No username: checks
rahulh1: checks
*** RIVER *** [Kc Qd Qc 6h] [9s]
No username: bets $172.81
rahulh1: calls $172.81
*** SHOW DOWN ***
No username: shows [3s Kd] (Two pairs, KKQQ)
rahulh1: shows [Kh Th] (Two pairs, KKQQ)
rahulh1 collected $673.93 from pot
*** SUMMARY ***
Total pot $709.38 | Rake $35.45
Board [Kc Qd Qc 6h 9s]
Seat 1: Lucifer999 folded before Flop (didn't bet)
Seat 2: rahulh1  showed [Kh Th] and won ($673.93) with Two pairs, KKQQ
Seat 3: Avaroni (button) folded before Flop (didn't bet)
Seat 4: No username (small blind) showed [3s Kd] and lost with Two pairs, KKQQ
Seat 5: BIG DADDY__ (big blind) folded on the Flop
Seat 6: Pablit0 folded before Flop (didn't bet)



PokerStars Game #00327538642: Hold'em No Limit ($10/$25 USD) - 2022/04/30 10:37:31 ET
Table 'Hold'em (Min 500Max 2500)  1282' 6-max Seat #6 is the button
Seat 1: foldmybets ($2923.08 in chips) 
Seat 2: jaykam ($450.49 in chips) 
Seat 3: Mastkalandar ($500 in chips) 
Seat 4: papadickkies ($771.34 in chips) 
Seat 5: Lucifer999 ($6509.88 in chips) 
Seat 6: devi7 ($2193.84 in chips) 
foldmybets: posts small blind $10
jaykam: posts big blind $25
*** HOLE CARDS ***
Dealt to Lucifer999 [Qh 4d]
papadickkies: folds
Lucifer999: folds
devi7: folds
foldmybets: folds
Uncalled bet ($15) returned to jaykam
jaykam: doesn't show hand
jaykam collected $20 from pot
*** SUMMARY ***
Total pot $20.00 | Rake $0
Board []
Seat 1: foldmybets (small blind) folded before Flop
Seat 2: jaykam (big blind) collected ($20)
Seat 4: papadickkies folded before Flop (didn't bet)
Seat 5: Lucifer999 folded before Flop (didn't bet)
Seat 6: devi7 (button) folded before Flop (didn't bet)



PokerStars Game #00327538668: Hold'em No Limit ($50/$100 USD) - 2022/04/30 10:37:39 ET
Table 'Hold'em (Min 25KMax 10K)    69' 6-max Seat #1 is the button
Seat 1: Lucifer999 ($14781.73 in chips) 
Seat 2: bettercall7208 ($10055.61 in chips) 
Seat 5: tabby20 ($26440.05 in chips) 
Seat 6: manny007 ($1795.3 in chips) 
bettercall7208: posts small blind $50
tabby20: posts big blind $100
*** HOLE CARDS ***
Dealt to Lucifer999 [5c Td]
manny007: calls $100
Lucifer999: folds
bettercall7208: raises $300.00 to $400
tabby20: folds
manny007: calls $300
*** FLOP *** [4h Kd 5s]
bettercall7208: bets $573.6
manny007: folds
Uncalled bet ($573.6) returned to bettercall7208
bettercall7208: doesn't show hand
bettercall7208 collected $860.4 from pot
*** SUMMARY ***
Total pot $900.00 | Rake $39.6
Board [4h Kd 5s]
Seat 1: Lucifer999 (button) folded before Flop (didn't bet)
Seat 2: bettercall7208 (small blind) collected ($860.4)
Seat 5: tabby20 (big blind) folded before Flop
Seat 6: manny007 folded on the Flop



PokerStars Game #00327538691: Hold'em No Limit ($25/$50 USD) - 2022/04/30 10:37:45 ET
Table 'Hold'em (Min 1K Max 5K)   216' 6-max Seat #4 is the button
Seat 1: Lucifer999 ($11972.29 in chips) 
Seat 2: rahulh1 ($2421.15 in chips) 
Seat 3: Avaroni ($6811.5 in chips) 
Seat 4: No username ($2350.49 in chips) 
Seat 5: BIG DADDY__ ($1460 in chips) 
Seat 6: Pablit0 ($4101.64 in chips) 
BIG DADDY__: posts small blind $25
Pablit0: posts big blind $50
*** HOLE CARDS ***
Dealt to Lucifer999 [6s Qc]
Lucifer999: folds
rahulh1: calls $50
Avaroni: folds
No username: folds
BIG DADDY__: folds
Pablit0: checks
*** FLOP *** [7h Jd Qh]
Pablit0: checks
rahulh1: bets $50
Pablit0: calls $50
*** TURN *** [7h Jd Qh] [4c]
Pablit0: checks
rahulh1: checks
*** RIVER *** [7h Jd Qh 4c] [2s]
Pablit0: checks
rahulh1: checks
*** SHOW DOWN ***
rahulh1: shows [9s Ts] (High card, Q)
Pablit0: shows [2c Kd] (Pair, 22)
Pablit0 collected $213.75 from pot
*** SUMMARY ***
Total pot $225.00 | Rake $11.25
Board [7h Jd Qh 4c 2s]
Seat 1: Lucifer999 folded before Flop (didn't bet)
Seat 2: rahulh1 showed [9s Ts] and lost with High card, Q
Seat 3: Avaroni folded before Flop (didn't bet)
Seat 4: No username (button) folded before Flop (didn't bet)
Seat 5: BIG DADDY__ (small blind) folded before Flop
Seat 6: Pablit0  (big blind) showed [2c Kd] and won ($213.75) with Pair, 22



PokerStars Game #00327538720: Hold'em No Limit ($10/$25 USD) - 2022/04/30 10:37:58 ET
Table 'Hold'em (Min 500Max 2500)  1282' 6-max Seat #1 is the button
Seat 1: foldmybets ($2913.08 in chips) 
Seat 2: jaykam ($460.49 in chips) 
Seat 3: Mastkalandar ($500 in chips) 
Seat 4: papadickkies ($771.34 in chips) 
Seat 5: Lucifer999 ($6509.88 in chips) 
Seat 6: devi7 ($2193.84 in chips) 
jaykam: posts small blind $10
Mastkalandar: posts big blind $25
*** HOLE CARDS ***
Dealt to Lucifer999 [Tc Td]
papadickkies: folds
Lucifer999: folds
devi7: folds
foldmybets: folds
jaykam: raises $25.00 to $50
Mastkalandar: calls $25
*** FLOP *** [8c 6c 9h]
jaykam: bets $410.49
Mastkalandar: folds
Uncalled bet ($410.49) returned to jaykam
jaykam: doesn't show hand
jaykam collected $93.75 from pot
*** SUMMARY ***
Total pot $100.00 | Rake $6.25
Board [8c 6c 9h]
Seat 1: foldmybets (button) folded before Flop (didn't bet)
Seat 2: jaykam (small blind) collected ($93.75)
Seat 3: Mastkalandar (big blind) folded on the Flop
Seat 4: papadickkies folded before Flop (didn't bet)
Seat 5: Lucifer999 folded before Flop (didn't bet)
Seat 6: devi7 folded before Flop (didn't bet)



PokerStars Game #00327538742: Hold'em No Limit ($50/$100 USD) - 2022/04/30 10:38:06 ET
Table 'Hold'em (Min 25KMax 10K)    69' 6-max Seat #2 is the button
Seat 1: Lucifer999 ($14781.73 in chips) 
Seat 2: bettercall7208 ($10516.01 in chips) 
Seat 5: tabby20 ($26340.05 in chips) 
Seat 6: manny007 ($1395.3 in chips) 
tabby20: posts small blind $50
manny007: posts big blind $100
*** HOLE CARDS ***
Dealt to Lucifer999 [Tc 5d]
Lucifer999: folds
bettercall7208: raises $100.00 to $200
tabby20: folds
manny007: calls $100
*** FLOP *** [Qs 3c 3s]
manny007: checks
bettercall7208: bets $215.1
manny007: folds
Uncalled bet ($215.1) returned to bettercall7208
bettercall7208: doesn't show hand
bettercall7208 collected $430.2 from pot
*** SUMMARY ***
Total pot $450.00 | Rake $19.8
Board [Qs 3c 3s]
Seat 1: Lucifer999 folded before Flop (didn't bet)
Seat 2: bettercall7208 (button) collected ($430.2)
Seat 5: tabby20 (small blind) folded before Flop
Seat 6: manny007 (big blind) folded on the Flop



PokerStars Game #00327538622: Hold'em No Limit ($10/$25 USD) - 2022/04/30 10:37:26 ET
Table 'Hold'em (Min 500Max 2500) 1001' 6-max Seat #3 is the button
Seat 1: JaspritBumrah786 ($2360 in chips) 
Seat 2: fishfry123 ($1487.07 in chips) 
Seat 3: EASYWITHACES ($2520.86 in chips) 
Seat 4: devi7 ($2587.18 in chips) 
Seat 5: Lucifer999 ($4466.18 in chips) 
Seat 6: spidy02 ($4476.36 in chips) 
devi7: posts small blind $10
Lucifer999: posts big blind $25
*** HOLE CARDS ***
Dealt to Lucifer999 [7c Ks]
spidy02: folds
JaspritBumrah786: folds
fishfry123: folds
EASYWITHACES: calls $25
devi7: folds
Lucifer999: checks
*** FLOP *** [As Js 3c]
Lucifer999: checks
EASYWITHACES: checks
*** TURN *** [As Js 3c] [Jh]
Lucifer999: bets $50
EASYWITHACES: calls $50
*** RIVER *** [As Js 3c Jh] [5s]
Lucifer999: checks
EASYWITHACES: checks
*** SHOW DOWN ***
Lucifer999: shows [7c Ks] (Pair, JJ)
EASYWITHACES: shows [Kd 3d] (Two pairs, JJ33)
EASYWITHACES collected $150.6 from pot
*** SUMMARY ***
Total pot $160.00 | Rake $9.4
Board [As Js 3c Jh 5s]
Seat 1: JaspritBumrah786 folded before Flop (didn't bet)
Seat 2: fishfry123 folded before Flop (didn't bet)
Seat 3: EASYWITHACES  (button) showed [Kd 3d] and won ($150.6) with Two pairs, JJ33
Seat 4: devi7 (small blind) folded before Flop
Seat 5: Lucifer999 (big blind) showed [7c Ks] and lost with Pair, JJ
Seat 6: spidy02 folded before Flop (didn't bet)



PokerStars Game #00327538841: Hold'em No Limit ($10/$25 USD) - 2022/04/30 10:38:40 ET
Table 'Hold'em (Min 500Max 2500)  1282' 6-max Seat #2 is the button
Seat 1: foldmybets ($2913.08 in chips) 
Seat 2: jaykam ($504.24 in chips) 
Seat 3: Mastkalandar ($450 in chips) 
Seat 4: papadickkies ($771.34 in chips) 
Seat 5: Lucifer999 ($6509.88 in chips) 
Seat 6: devi7 ($2193.84 in chips) 
Mastkalandar: posts small blind $10
papadickkies: posts big blind $25
*** HOLE CARDS ***
Dealt to Lucifer999 [5h 6s]
Lucifer999: folds
devi7: raises $50.00 to $75
foldmybets: folds
jaykam: calls $75
Mastkalandar: folds
papadickkies: folds
*** FLOP *** [7d 9h 7s]
devi7: bets $87.15
jaykam: calls $87.15
*** TURN *** [7d 9h 7s] [9d]
devi7: checks
jaykam: checks
*** RIVER *** [7d 9h 7s 9d] [Ah]
devi7: checks
jaykam: checks
*** SHOW DOWN ***
devi7: shows [Td Tc] (Two pairs, TT99)
jaykam: doesn't show hand
devi7 collected $337.46 from pot
*** SUMMARY ***
Total pot $359.30 | Rake $21.84
Board [7d 9h 7s 9d Ah]
Seat 1: foldmybets folded before Flop (didn't bet)
Seat 2: jaykam (button) mucked
Seat 3: Mastkalandar (small blind) folded before Flop
Seat 4: papadickkies (big blind) folded before Flop
Seat 5: Lucifer999 folded before Flop (didn't bet)
Seat 6: devi7  showed [Td Tc] and won ($337.46) with Two pairs, TT99



PokerStars Game #00327538825: Hold'em No Limit ($25/$50 USD) - 2022/04/30 10:38:33 ET
Table 'Hold'em (Min 1K Max 5K)   216' 6-max Seat #5 is the button
Seat 1: Lucifer999 ($11972.29 in chips) 
Seat 2: rahulh1 ($2321.15 in chips) 
Seat 3: Avaroni ($6811.5 in chips) 
Seat 4: No username ($2350.49 in chips) 
Seat 5: BIG DADDY__ ($1435 in chips) 
Seat 6: Pablit0 ($4215.39 in chips) 
Pablit0: posts small blind $25
Lucifer999: posts big blind $50
*** HOLE CARDS ***
Dealt to Lucifer999 [9c Ts]
rahulh1: calls $50
Avaroni: folds
No username: raises $175.00 to $225
BIG DADDY__: folds
Pablit0: calls $200
Lucifer999: folds
rahulh1: calls $175
*** FLOP *** [Kd 3d 3h]
Pablit0: checks
rahulh1: checks
No username: checks
*** TURN *** [Kd 3d 3h] [7s]
Pablit0: bets $294.38
rahulh1: calls $294.38
No username: folds
*** RIVER *** [Kd 3d 3h 7s] [As]
Pablit0: checks
rahulh1: checks
*** SHOW DOWN ***
Pablit0: shows [Tc Jc] (Pair, 33)
rahulh1: shows [6d 6s] (Two pairs, 6633)
rahulh1 collected $1248.11 from pot
*** SUMMARY ***
Total pot $1313.76 | Rake $65.65
Board [Kd 3d 3h 7s As]
Seat 1: Lucifer999 (big blind) folded before Flop
Seat 2: rahulh1  showed [6d 6s] and won ($1248.11) with Two pairs, 6633
Seat 3: Avaroni folded before Flop (didn't bet)
Seat 4: No username folded on the Turn
Seat 5: BIG DADDY__ (button) folded before Flop (didn't bet)
Seat 6: Pablit0 (small blind) showed [Tc Jc] and lost with Pair, 33



PokerStars Game #00327538842: Hold'em No Limit ($50/$100 USD) - 2022/04/30 10:38:40 ET
Table 'Hold'em (Min 25KMax 10K)    69' 6-max Seat #5 is the button
Seat 1: Lucifer999 ($14781.73 in chips) 
Seat 2: bettercall7208 ($10746.21 in chips) 
Seat 5: tabby20 ($26290.05 in chips) 
Seat 6: manny007 ($1195.3 in chips) 
manny007: posts small blind $50
Lucifer999: posts big blind $100
*** HOLE CARDS ***
Dealt to Lucifer999 [7h 6d]
bettercall7208: raises $100.00 to $200
tabby20: raises $550.00 to $750
manny007: calls $700
Lucifer999: calls $650
bettercall7208: calls $550
*** FLOP *** [Tc Jh 2s]
manny007: checks
Lucifer999: checks
bettercall7208: checks
tabby20: checks
*** TURN *** [Tc Jh 2s] [3d]
manny007: bets $445.3
Lucifer999: folds
bettercall7208: calls $445.3
tabby20: raises $954.70 to $1400
bettercall7208: calls $954.7
*** RIVER *** [Tc Jh 2s 3d] [Kc]
bettercall7208: checks
tabby20: bets $24140.05
bettercall7208: calls $8596.21
Uncalled bet ($15543.84) returned to tabby20
tabby20 collected $18852.56 from side pot-1
*** SHOW DOWN ***
bettercall7208: shows [Th Kd] (Two pairs, KKTT)
tabby20: shows [3c 3h] (Three of a kind, 333)
manny007: shows [4c 5c] (High card, K)
tabby20 collected $4145.16 from pot
*** SUMMARY ***
Total pot $23437.72 Main pot $4335.90. Side pot $19101.82 | Rake $440
Board [Tc Jh 2s 3d Kc]
Seat 1: Lucifer999 (big blind) folded on the Turn
Seat 2: bettercall7208 showed [Th Kd] and lost with Two pairs, KKTT
Seat 5: tabby20  (button) showed [3c 3h] and won ($22997.72) with Three of a kind, 333
Seat 6: manny007 (small blind) showed [4c 5c] and lost with High card, K



PokerStars Game #00327539003: Hold'em No Limit ($10/$25 USD) - 2022/04/30 10:39:33 ET
Table 'Hold'em (Min 500Max 2500)  1282' 6-max Seat #3 is the button
Seat 1: foldmybets ($2913.08 in chips) 
Seat 2: jaykam ($342.09 in chips) 
Seat 3: Mastkalandar ($2025 in chips) 
Seat 4: papadickkies ($746.34 in chips) 
Seat 5: Lucifer999 ($6509.88 in chips) 
Seat 6: devi7 ($2369.15 in chips) 
papadickkies: posts small blind $10
Lucifer999: posts big blind $25
*** HOLE CARDS ***
Dealt to Lucifer999 [4d 3s]
devi7: folds
foldmybets: raises $50.00 to $75
jaykam: folds
Mastkalandar: folds
papadickkies: folds
Lucifer999: folds
Uncalled bet ($50) returned to foldmybets
foldmybets: doesn't show hand
foldmybets collected $60 from pot
*** SUMMARY ***
Total pot $60.00 | Rake $0
Board []
Seat 1: foldmybets collected ($60)
Seat 2: jaykam folded before Flop (didn't bet)
Seat 3: Mastkalandar (button) folded before Flop (didn't bet)
Seat 4: papadickkies (small blind) folded before Flop
Seat 5: Lucifer999 (big blind) folded before Flop
Seat 6: devi7 folded before Flop (didn't bet)



PokerStars Game #00327539051: Hold'em No Limit ($25/$50 USD) - 2022/04/30 10:39:49 ET
Table 'Hold'em (Min 1K Max 5K)   216' 6-max Seat #1 is the button
Seat 1: Lucifer999 ($11922.29 in chips) 
Seat 2: rahulh1 ($3049.88 in chips) 
Seat 3: Avaroni ($6811.5 in chips) 
Seat 4: No username ($2125.49 in chips) 
Seat 5: BIG DADDY__ ($1435 in chips) 
Seat 6: Pablit0 ($3696.01 in chips) 
rahulh1: posts small blind $25
Avaroni: posts big blind $50
*** HOLE CARDS ***
Dealt to Lucifer999 [Jc Js]
No username: folds
BIG DADDY__: raises $100.00 to $150
Lucifer999: raises $275.00 to $425
rahulh1: folds
Avaroni: folds
BIG DADDY__: calls $275
*** FLOP *** [2c 3s 3c]
BIG DADDY__: checks
Lucifer999: bets $425
BIG DADDY__: folds
Uncalled bet ($425) returned to Lucifer999
Lucifer999: doesn't show hand
Lucifer999 collected $878.75 from pot
*** SUMMARY ***
Total pot $925.00 | Rake $46.25
Board [2c 3s 3c]
Seat 1: Lucifer999 (button) collected ($878.75)
Seat 2: rahulh1 (small blind) folded before Flop
Seat 3: Avaroni (big blind) folded before Flop
Seat 4: No username folded before Flop (didn't bet)
Seat 5: BIG DADDY__ folded on the Flop



PokerStars Game #00327539101: Hold'em No Limit ($10/$25 USD) - 2022/04/30 10:40:07 ET
Table 'Hold'em (Min 500Max 2500)  1282' 6-max Seat #4 is the button
Seat 1: foldmybets ($2948.08 in chips) 
Seat 2: jaykam ($342.09 in chips) 
Seat 3: Mastkalandar ($2025 in chips) 
Seat 4: papadickkies ($736.34 in chips) 
Seat 5: Lucifer999 ($6484.88 in chips) 
Seat 6: devi7 ($2369.15 in chips) 
Lucifer999: posts small blind $10
devi7: posts big blind $25
*** HOLE CARDS ***
Dealt to Lucifer999 [Th Qd]
foldmybets: folds
jaykam: calls $25
Mastkalandar: folds
papadickkies: folds
Lucifer999: raises $85.00 to $110
devi7: folds
jaykam: folds
Uncalled bet ($85) returned to Lucifer999
Lucifer999: doesn't show hand
Lucifer999 collected $75 from pot
*** SUMMARY ***
Total pot $75.00 | Rake $0
Board []
Seat 1: foldmybets folded before Flop (didn't bet)
Seat 2: jaykam folded before Flop
Seat 3: Mastkalandar folded before Flop (didn't bet)
Seat 4: papadickkies (button) folded before Flop (didn't bet)
Seat 5: Lucifer999 (small blind) collected ($75)
Seat 6: devi7 (big blind) folded before Flop



PokerStars Game #00327538915: Hold'em No Limit ($10/$25 USD) - 2022/04/30 10:39:06 ET
Table 'Hold'em (Min 500Max 2500) 1001' 6-max Seat #4 is the button
Seat 1: JaspritBumrah786 ($2360 in chips) 
Seat 2: fishfry123 ($1487.07 in chips) 
Seat 3: EASYWITHACES ($2596.46 in chips) 
Seat 4: devi7 ($2577.18 in chips) 
Seat 5: Lucifer999 ($4391.18 in chips) 
Seat 6: spidy02 ($4476.36 in chips) 
Lucifer999: posts small blind $10
spidy02: posts big blind $25
*** HOLE CARDS ***
Dealt to Lucifer999 [9s 2c]
JaspritBumrah786: raises $50.00 to $75
fishfry123: folds
EASYWITHACES: folds
devi7: folds
Lucifer999: folds
spidy02: calls $50
*** FLOP *** [Td Ks Th]
spidy02: checks
JaspritBumrah786: bets $50
spidy02: calls $50
*** TURN *** [Td Ks Th] [Jc]
spidy02: checks
JaspritBumrah786: bets $175
spidy02: calls $175
*** RIVER *** [Td Ks Th Jc] [Ac]
spidy02: bets $429.74
JaspritBumrah786: calls $429.74
*** SHOW DOWN ***
spidy02: shows [Qh Js] (Straight, A-T)
JaspritBumrah786: shows [As Qc] (Straight, A-T)
spidy02 collected $693.68 from pot
JaspritBumrah786 collected $693.68 from pot
*** SUMMARY ***
Total pot $1469.48 | Rake $82.12
Board [Td Ks Th Jc Ac]
Seat 1: JaspritBumrah786  showed [As Qc] and won ($693.68) with Straight, A-T
Seat 2: fishfry123 folded before Flop (didn't bet)
Seat 3: EASYWITHACES folded before Flop (didn't bet)
Seat 4: devi7 (button) folded before Flop (didn't bet)
Seat 5: Lucifer999 (small blind) folded before Flop
Seat 6: spidy02  (big blind) showed [Qh Js] and won ($693.68) with Straight, A-T



PokerStars Game #00327539060: Hold'em No Limit ($50/$100 USD) - 2022/04/30 10:39:53 ET
Table 'Hold'em (Min 25KMax 10K)    69' 6-max Seat #1 is the button
Seat 1: Lucifer999 ($14031.73 in chips) 
Seat 5: tabby20 ($38541.56 in chips) 
Lucifer999: posts small blind $50
tabby20: posts big blind $100
*** HOLE CARDS ***
Dealt to Lucifer999 [Ac 4h]
Lucifer999: raises $100.00 to $200
tabby20: raises $500.00 to $700
Lucifer999: calls $500
*** FLOP *** [Qh 4d 7c]
tabby20: bets $672.7
Lucifer999: calls $672.7
*** TURN *** [Qh 4d 7c] [5s]
tabby20: bets $1319.18
Lucifer999: calls $1319.18
*** RIVER *** [Qh 4d 7c 5s] [Ah]
tabby20: bets $3800
Lucifer999: calls $3800
*** SHOW DOWN ***
tabby20: shows [Kc 5c] (Pair, 55)
Lucifer999: shows [Ac 4h] (Two pairs, AA44)
Lucifer999 collected $12643.76 from pot
*** SUMMARY ***
Total pot $12983.76 | Rake $340
Board [Qh 4d 7c 5s Ah]
Seat 1: Lucifer999  (button) (small blind) showed [Ac 4h] and won ($12643.76) with Two pairs, AA44
Seat 5: tabby20 (big blind) showed [Kc 5c] and lost with Pair, 55



PokerStars Game #00327539180: Hold'em No Limit ($25/$50 USD) - 2022/04/30 10:40:32 ET
Table 'Hold'em (Min 1K Max 5K)   216' 6-max Seat #2 is the button
Seat 1: Lucifer999 ($12376.04 in chips) 
Seat 2: rahulh1 ($3024.88 in chips) 
Seat 3: Avaroni ($6761.5 in chips) 
Seat 4: No username ($2125.49 in chips) 
Seat 5: BIG DADDY__ ($1010 in chips) 
Avaroni: posts small blind $25
No username: posts big blind $50
*** HOLE CARDS ***
Dealt to Lucifer999 [5s 8d]
BIG DADDY__: folds
Lucifer999: folds
rahulh1: folds
Avaroni: raises $125.00 to $175
No username: folds
Uncalled bet ($125) returned to Avaroni
Avaroni: doesn't show hand
Avaroni collected $100 from pot
*** SUMMARY ***
Total pot $100.00 | Rake $0
Board []
Seat 1: Lucifer999 folded before Flop (didn't bet)
Seat 2: rahulh1 (button) folded before Flop (didn't bet)
Seat 3: Avaroni (small blind) collected ($100)
Seat 4: No username (big blind) folded before Flop
Seat 5: BIG DADDY__ folded before Flop (didn't bet)



PokerStars Game #00327539242: Hold'em No Limit ($50/$100 USD) - 2022/04/30 10:40:54 ET
Table 'Hold'em (Min 25KMax 10K)    69' 6-max Seat #5 is the button
Seat 1: Lucifer999 ($20183.61 in chips) 
Seat 5: tabby20 ($32049.68 in chips) 
tabby20: posts small blind $50
Lucifer999: posts big blind $100
*** HOLE CARDS ***
Dealt to Lucifer999 [2h Qs]
tabby20: raises $100.00 to $200
Lucifer999: folds
Uncalled bet ($100) returned to tabby20
tabby20: doesn't show hand
tabby20 collected $200 from pot
*** SUMMARY ***
Total pot $200.00 | Rake $0
Board []
Seat 1: Lucifer999 (big blind) folded before Flop
Seat 5: tabby20 (button) (small blind) collected ($200)



PokerStars Game #00327539230: Hold'em No Limit ($10/$25 USD) - 2022/04/30 10:40:49 ET
Table 'Hold'em (Min 500Max 2500) 1001' 6-max Seat #5 is the button
Seat 1: JaspritBumrah786 ($2500 in chips) 
Seat 2: fishfry123 ($1487.07 in chips) 
Seat 3: EASYWITHACES ($2596.46 in chips) 
Seat 4: devi7 ($2577.18 in chips) 
Seat 5: Lucifer999 ($4381.18 in chips) 
Seat 6: spidy02 ($4440.3 in chips) 
spidy02: posts small blind $10
JaspritBumrah786: posts big blind $25
*** HOLE CARDS ***
Dealt to Lucifer999 [8d 3d]
fishfry123: calls $25
EASYWITHACES: folds
devi7: folds
Lucifer999: folds
spidy02: folds
JaspritBumrah786: checks
*** FLOP *** [Kh Qs 5s]
JaspritBumrah786: checks
fishfry123: bets $42.64
JaspritBumrah786: folds
Uncalled bet ($42.64) returned to fishfry123
fishfry123: doesn't show hand
fishfry123 collected $56.85 from pot
*** SUMMARY ***
Total pot $60.00 | Rake $3.15
Board [Kh Qs 5s]
Seat 1: JaspritBumrah786 (big blind) folded on the Flop
Seat 2: fishfry123 collected ($56.85)
Seat 3: EASYWITHACES folded before Flop (didn't bet)
Seat 4: devi7 folded before Flop (didn't bet)
Seat 5: Lucifer999 (button) folded before Flop (didn't bet)
Seat 6: spidy02 (small blind) folded before Flop



PokerStars Game #00327539260: Hold'em No Limit ($25/$50 USD) - 2022/04/30 10:40:59 ET
Table 'Hold'em (Min 1K Max 5K)   216' 6-max Seat #3 is the button
Seat 1: Lucifer999 ($12376.04 in chips) 
Seat 2: rahulh1 ($3024.88 in chips) 
Seat 3: Avaroni ($6811.5 in chips) 
Seat 4: No username ($2075.49 in chips) 
Seat 5: BIG DADDY__ ($1010 in chips) 
No username: posts small blind $25
BIG DADDY__: posts big blind $50
*** HOLE CARDS ***
Dealt to Lucifer999 [4s 8h]
Lucifer999: folds
rahulh1: folds
Avaroni: folds
No username: raises $2025.49 to $2075.49
BIG DADDY__: folds
Uncalled bet ($2025.49) returned to No username
No username: doesn't show hand
No username collected $100 from pot
*** SUMMARY ***
Total pot $100.00 | Rake $0
Board []
Seat 1: Lucifer999 folded before Flop (didn't bet)
Seat 2: rahulh1 folded before Flop (didn't bet)
Seat 3: Avaroni (button) folded before Flop (didn't bet)
Seat 4: No username (small blind) collected ($100)
Seat 5: BIG DADDY__ (big blind) folded before Flop



PokerStars Game #00327539276: Hold'em No Limit ($50/$100 USD) - 2022/04/30 10:41:05 ET
Table 'Hold'em (Min 25KMax 10K)    69' 6-max Seat #1 is the button
Seat 1: Lucifer999 ($20083.61 in chips) 
Seat 5: tabby20 ($32149.68 in chips) 
Seat 6: manny007 ($2500 in chips) 
Lucifer999: posts small blind $50
tabby20: posts big blind $100
*** HOLE CARDS ***
Dealt to Lucifer999 [3h Ac]
Lucifer999: raises $100.00 to $200
tabby20: calls $100
*** FLOP *** [Jh 2d Th]
tabby20: checks
Lucifer999: bets $200
tabby20: folds
Uncalled bet ($200) returned to Lucifer999
Lucifer999: doesn't show hand
Lucifer999 collected $384.4 from pot
*** SUMMARY ***
Total pot $400.00 | Rake $15.6
Board [Jh 2d Th]
Seat 1: Lucifer999 (button) (small blind) collected ($384.4)
Seat 5: tabby20 (big blind) folded on the Flop



PokerStars Game #00327539340: Hold'em No Limit ($25/$50 USD) - 2022/04/30 10:41:27 ET
Table 'Hold'em (Min 1K Max 5K)   216' 6-max Seat #4 is the button
Seat 1: Lucifer999 ($12376.04 in chips) 
Seat 2: rahulh1 ($3024.88 in chips) 
Seat 3: Avaroni ($6811.5 in chips) 
Seat 4: No username ($2125.49 in chips) 
Seat 5: BIG DADDY__ ($960 in chips) 
BIG DADDY__: posts small blind $25
Lucifer999: posts big blind $50
*** HOLE CARDS ***
Dealt to Lucifer999 [2h 5d]
rahulh1: folds
Avaroni: folds
No username: folds
BIG DADDY__: folds
Uncalled bet ($25) returned to Lucifer999
Lucifer999: doesn't show hand
Lucifer999 collected $50 from pot
*** SUMMARY ***
Total pot $50.00 | Rake $0
Board []
Seat 1: Lucifer999 (big blind) collected ($50)
Seat 2: rahulh1 folded before Flop (didn't bet)
Seat 3: Avaroni folded before Flop (didn't bet)
Seat 4: No username (button) folded before Flop (didn't bet)
Seat 5: BIG DADDY__ (small blind) folded before Flop



PokerStars Game #00327539378: Hold'em No Limit ($50/$100 USD) - 2022/04/30 10:41:39 ET
Table 'Hold'em (Min 25KMax 10K)    69' 6-max Seat #5 is the button
Seat 1: Lucifer999 ($20268.01 in chips) 
Seat 5: tabby20 ($31949.68 in chips) 
Seat 6: manny007 ($2500 in chips) 
tabby20: posts small blind $50
Lucifer999: posts big blind $100
*** HOLE CARDS ***
Dealt to Lucifer999 [Kd 9h]
tabby20: raises $200.00 to $300
Lucifer999: raises $700.00 to $1000
tabby20: folds
Uncalled bet ($700) returned to Lucifer999
Lucifer999: doesn't show hand
Lucifer999 collected $600 from pot
*** SUMMARY ***
Total pot $600.00 | Rake $0
Board []
Seat 1: Lucifer999 (big blind) collected ($600)
Seat 5: tabby20 (button) (small blind) folded before Flop



PokerStars Game #00327539388: Hold'em No Limit ($25/$50 USD) - 2022/04/30 10:41:42 ET
Table 'Hold'em (Min 1K Max 5K)   216' 6-max Seat #5 is the button
Seat 1: Lucifer999 ($12401.04 in chips) 
Seat 2: rahulh1 ($3024.88 in chips) 
Seat 3: Avaroni ($6811.5 in chips) 
Seat 4: No username ($2125.49 in chips) 
Seat 5: BIG DADDY__ ($935 in chips) 
Lucifer999: posts small blind $25
rahulh1: posts big blind $50
*** HOLE CARDS ***
Dealt to Lucifer999 [8d 4c]
Avaroni: folds
No username: raises $81.25 to $131.25
BIG DADDY__: folds
Lucifer999: folds
rahulh1: folds
Uncalled bet ($81.25) returned to No username
No username: doesn't show hand
No username collected $125 from pot
*** SUMMARY ***
Total pot $125.00 | Rake $0
Board []
Seat 1: Lucifer999 (small blind) folded before Flop
Seat 2: rahulh1 (big blind) folded before Flop
Seat 3: Avaroni folded before Flop (didn't bet)
Seat 4: No username collected ($125)
Seat 5: BIG DADDY__ (button) folded before Flop (didn't bet)



PokerStars Game #00327539308: Hold'em No Limit ($10/$25 USD) - 2022/04/30 10:41:17 ET
Table 'Hold'em (Min 500Max 2500) 1001' 6-max Seat #6 is the button
Seat 1: JaspritBumrah786 ($2475 in chips) 
Seat 2: fishfry123 ($1518.92 in chips) 
Seat 3: EASYWITHACES ($2596.46 in chips) 
Seat 4: devi7 ($2577.18 in chips) 
Seat 5: Lucifer999 ($4381.18 in chips) 
Seat 6: spidy02 ($4430.3 in chips) 
JaspritBumrah786: posts small blind $10
fishfry123: posts big blind $25
*** HOLE CARDS ***
Dealt to Lucifer999 [Ah 4h]
EASYWITHACES: folds
devi7: folds
Lucifer999: folds
spidy02: raises $38.75 to $63.75
JaspritBumrah786: folds
fishfry123: calls $38.75
*** FLOP *** [Kh 3h 6c]
fishfry123: checks
spidy02: bets $74.66
fishfry123: calls $74.66
*** TURN *** [Kh 3h 6c] [8h]
fishfry123: checks
spidy02: checks
*** RIVER *** [Kh 3h 6c 8h] [2h]
fishfry123: bets $202.36
spidy02: calls $202.36
*** SHOW DOWN ***
fishfry123: shows [Th Qh] (Flush, K high)
spidy02: doesn't show hand
fishfry123 collected $650.27 from pot
*** SUMMARY ***
Total pot $691.54 | Rake $41.27
Board [Kh 3h 6c 8h 2h]
Seat 1: JaspritBumrah786 (small blind) folded before Flop
Seat 2: fishfry123  (big blind) showed [Th Qh] and won ($650.27) with Flush, K high
Seat 3: EASYWITHACES folded before Flop (didn't bet)
Seat 4: devi7 folded before Flop (didn't bet)
Seat 5: Lucifer999 folded before Flop (didn't bet)
Seat 6: spidy02 (button) mucked



PokerStars Game #00327539203: Hold'em No Limit ($10/$25 USD) - 2022/04/30 10:40:40 ET
Table 'Hold'em (Min 500Max 2500)  1282' 6-max Seat #5 is the button
Seat 1: foldmybets ($2948.08 in chips) 
Seat 2: jaykam ($317.09 in chips) 
Seat 3: Mastkalandar ($2025 in chips) 
Seat 4: papadickkies ($736.34 in chips) 
Seat 5: Lucifer999 ($6534.88 in chips) 
Seat 6: devi7 ($2344.15 in chips) 
devi7: posts small blind $10
foldmybets: posts big blind $25
*** HOLE CARDS ***
Dealt to Lucifer999 [4s 3h]
jaykam: calls $25
Mastkalandar: folds
papadickkies: raises $45.00 to $70
Lucifer999: folds
devi7: calls $60
foldmybets: calls $45
jaykam: calls $45
*** FLOP *** [8c 2d 6d]
devi7: checks
foldmybets: checks
jaykam: checks
papadickkies: checks
*** TURN *** [8c 2d 6d] [2s]
devi7: bets $173.78
foldmybets: calls $173.78
jaykam: folds
papadickkies: calls $173.78
*** RIVER *** [8c 2d 6d 2s] [3c]
devi7: checks
foldmybets: bets $525
papadickkies: folds
devi7: folds
Uncalled bet ($525) returned to foldmybets
foldmybets: doesn't show hand
foldmybets collected $754.29 from pot
*** SUMMARY ***
Total pot $801.34 | Rake $47.05
Board [8c 2d 6d 2s 3c]
Seat 1: foldmybets (big blind) collected ($754.29)
Seat 2: jaykam folded on the Turn
Seat 3: Mastkalandar folded before Flop (didn't bet)
Seat 4: papadickkies folded on the River
Seat 5: Lucifer999 (button) folded before Flop (didn't bet)
Seat 6: devi7 (small blind) folded on the River



PokerStars Game #00327539478: Hold'em No Limit ($10/$25 USD) - 2022/04/30 10:42:10 ET
Table 'Hold'em (Min 500Max 2500) 1001' 6-max Seat #1 is the button
Seat 1: JaspritBumrah786 ($2465 in chips) 
Seat 2: fishfry123 ($1828.42 in chips) 
Seat 3: EASYWITHACES ($2596.46 in chips) 
Seat 4: devi7 ($2577.18 in chips) 
Seat 5: Lucifer999 ($4381.18 in chips) 
Seat 6: spidy02 ($4089.53 in chips) 
fishfry123: posts small blind $10
EASYWITHACES: posts big blind $25
*** HOLE CARDS ***
Dealt to Lucifer999 [3s Ac]
devi7: folds
Lucifer999: folds
spidy02: raises $60.00 to $85
JaspritBumrah786: folds
fishfry123: folds
EASYWITHACES: folds
Uncalled bet ($60) returned to spidy02
spidy02: doesn't show hand
spidy02 collected $60 from pot
*** SUMMARY ***
Total pot $60.00 | Rake $0
Board []
Seat 1: JaspritBumrah786 (button) folded before Flop (didn't bet)
Seat 2: fishfry123 (small blind) folded before Flop
Seat 3: EASYWITHACES (big blind) folded before Flop
Seat 4: devi7 folded before Flop (didn't bet)
Seat 5: Lucifer999 folded before Flop (didn't bet)
Seat 6: spidy02 collected ($60)



PokerStars Game #00327539444: Hold'em No Limit ($50/$100 USD) - 2022/04/30 10:41:57 ET
Table 'Hold'em (Min 25KMax 10K)    69' 6-max Seat #1 is the button
Seat 1: Lucifer999 ($20568.01 in chips) 
Seat 5: tabby20 ($31649.68 in chips) 
Seat 6: manny007 ($2500 in chips) 
tabby20: posts small blind $50
manny007: posts big blind $100
*** HOLE CARDS ***
Dealt to Lucifer999 [4s Ad]
Lucifer999: folds
tabby20: raises $200.00 to $300
manny007: calls $200
*** FLOP *** [9c 5h Qs]
tabby20: checks
manny007: checks
*** TURN *** [9c 5h Qs] [3s]
tabby20: checks
manny007: checks
*** RIVER *** [9c 5h Qs 3s] [9s]
tabby20: checks
manny007: bets $573.6
tabby20: folds
Uncalled bet ($573.6) returned to manny007
manny007: doesn't show hand
manny007 collected $573.6 from pot
*** SUMMARY ***
Total pot $600.00 | Rake $26.4
Board [9c 5h Qs 3s 9s]
Seat 1: Lucifer999 (button) folded before Flop (didn't bet)
Seat 5: tabby20 (small blind) folded on the River
Seat 6: manny007 (big blind) collected ($573.6)



PokerStars Game #00327539462: Hold'em No Limit ($25/$50 USD) - 2022/04/30 10:42:05 ET
Table 'Hold'em (Min 1K Max 5K)   216' 6-max Seat #1 is the button
Seat 1: Lucifer999 ($12376.04 in chips) 
Seat 2: rahulh1 ($2974.88 in chips) 
Seat 3: Avaroni ($6811.5 in chips) 
Seat 4: No username ($2200.49 in chips) 
Seat 5: BIG DADDY__ ($935 in chips) 
rahulh1: posts small blind $25
Avaroni: posts big blind $50
*** HOLE CARDS ***
Dealt to Lucifer999 [3h Ks]
No username: folds
BIG DADDY__: raises $100.00 to $150
Lucifer999: folds
rahulh1: raises $231.25 to $381.25
Avaroni: folds
BIG DADDY__: raises $553.75 to $935
rahulh1: calls $553.75
*** FLOP *** [4s 8h 8d]
*** FLOP *** [7s Th Qh]
*** TURN *** [4s 8h 8d] [6h]
*** TURN *** [4s 8h 8d] [7c]
*** RIVER *** [4s 8h 8d 6h] [2s]
*** RIVER *** [4s 8h 8d 6h] [8s]
*** SHOW DOWN ***
rahulh1: shows [Ah Js] (Pair, 77)
BIG DADDY__: shows [Qd Ac] (Two pairs, QQ77)
BIG DADDY__ collected $912 from pot
BIG DADDY__ collected $912 from pot
*** SUMMARY ***
Total pot $1920.00 | Rake $96
Board [4s 8h 8d 6h 2s]
Seat 1: Lucifer999 (button) folded before Flop (didn't bet)
Seat 2: rahulh1 (small blind) showed [Ah Js] and lost with Pair, 77
Seat 3: Avaroni (big blind) folded before Flop
Seat 4: No username folded before Flop (didn't bet)
Seat 5: BIG DADDY__  showed [Qd Ac] and won ($912) with Two pairs, QQ77



PokerStars Game #00327539580: Hold'em No Limit ($50/$100 USD) - 2022/04/30 10:42:40 ET
Table 'Hold'em (Min 25KMax 10K)    69' 6-max Seat #5 is the button
Seat 1: Lucifer999 ($20568.01 in chips) 
Seat 5: tabby20 ($31349.68 in chips) 
Seat 6: manny007 ($2773.6 in chips) 
manny007: posts small blind $50
Lucifer999: posts big blind $100
*** HOLE CARDS ***
Dealt to Lucifer999 [8c Jh]
tabby20: raises $200.00 to $300
manny007: folds
Lucifer999: folds
Uncalled bet ($200) returned to tabby20
tabby20: doesn't show hand
tabby20 collected $250 from pot
*** SUMMARY ***
Total pot $250.00 | Rake $0
Board []
Seat 1: Lucifer999 (big blind) folded before Flop
Seat 5: tabby20 (button) collected ($250)
Seat 6: manny007 (small blind) folded before Flop



PokerStars Game #00327539567: Hold'em No Limit ($10/$25 USD) - 2022/04/30 10:42:38 ET
Table 'Hold'em (Min 500Max 2500) 1001' 6-max Seat #2 is the button
Seat 1: JaspritBumrah786 ($2465 in chips) 
Seat 2: fishfry123 ($1818.42 in chips) 
Seat 3: EASYWITHACES ($2571.46 in chips) 
Seat 4: devi7 ($2577.18 in chips) 
Seat 5: Lucifer999 ($4381.18 in chips) 
Seat 6: spidy02 ($4124.53 in chips) 
EASYWITHACES: posts small blind $10
devi7: posts big blind $25
*** HOLE CARDS ***
Dealt to Lucifer999 [4h Kh]
Lucifer999: folds
spidy02: folds
JaspritBumrah786: folds
fishfry123: folds
EASYWITHACES: folds
Uncalled bet ($15) returned to devi7
devi7: doesn't show hand
devi7 collected $20 from pot
*** SUMMARY ***
Total pot $20.00 | Rake $0
Board []
Seat 1: JaspritBumrah786 folded before Flop (didn't bet)
Seat 2: fishfry123 (button) folded before Flop (didn't bet)
Seat 3: EASYWITHACES (small blind) folded before Flop
Seat 4: devi7 (big blind) collected ($20)
Seat 5: Lucifer999 folded before Flop (didn't bet)
Seat 6: spidy02 folded before Flop (didn't bet)



PokerStars Game #00327539619: Hold'em No Limit ($50/$100 USD) - 2022/04/30 10:42:56 ET
Table 'Hold'em (Min 25KMax 10K)    69' 6-max Seat #6 is the button
Seat 1: Lucifer999 ($20468.01 in chips) 
Seat 5: tabby20 ($31499.68 in chips) 
Seat 6: manny007 ($2723.6 in chips) 
manny007: posts small blind $50
Lucifer999: posts big blind $100
*** HOLE CARDS ***
Dealt to Lucifer999 [Ks 7h]
manny007: folds
Uncalled bet ($50) returned to Lucifer999
Lucifer999: doesn't show hand
Lucifer999 collected $100 from pot
*** SUMMARY ***
Total pot $100.00 | Rake $0
Board []
Seat 1: Lucifer999 (big blind) collected ($100)
Seat 6: manny007 (button) (small blind) folded before Flop



PokerStars Game #00327539649: Hold'em No Limit ($50/$100 USD) - 2022/04/30 10:43:05 ET
Table 'Hold'em (Min 25KMax 10K)    69' 6-max Seat #1 is the button
Seat 1: Lucifer999 ($20518.01 in chips) 
Seat 5: tabby20 ($31499.68 in chips) 
Seat 6: manny007 ($2673.6 in chips) 
Lucifer999: posts small blind $50
manny007: posts big blind $100
*** HOLE CARDS ***
Dealt to Lucifer999 [8d 3s]
Lucifer999: calls $50
manny007: raises $200.00 to $300
Lucifer999: folds
Uncalled bet ($200) returned to manny007
manny007: doesn't show hand
manny007 collected $200 from pot
*** SUMMARY ***
Total pot $200.00 | Rake $0
Board []
Seat 1: Lucifer999 (button) (small blind) folded before Flop
Seat 6: manny007 (big blind) collected ($200)



PokerStars Game #00327539646: Hold'em No Limit ($10/$25 USD) - 2022/04/30 10:43:04 ET
Table 'Hold'em (Min 500Max 2500) 1001' 6-max Seat #3 is the button
Seat 1: JaspritBumrah786 ($2465 in chips) 
Seat 2: fishfry123 ($1818.42 in chips) 
Seat 3: EASYWITHACES ($2561.46 in chips) 
Seat 4: devi7 ($2587.18 in chips) 
Seat 5: Lucifer999 ($4381.18 in chips) 
Seat 6: spidy02 ($4124.53 in chips) 
devi7: posts small blind $10
Lucifer999: posts big blind $25
*** HOLE CARDS ***
Dealt to Lucifer999 [3d As]
spidy02: folds
JaspritBumrah786: folds
fishfry123: raises $38.75 to $63.75
EASYWITHACES: folds
devi7: folds
Lucifer999: folds
Uncalled bet ($38.75) returned to fishfry123
fishfry123: doesn't show hand
fishfry123 collected $60 from pot
*** SUMMARY ***
Total pot $60.00 | Rake $0
Board []
Seat 1: JaspritBumrah786 folded before Flop (didn't bet)
Seat 2: fishfry123 collected ($60)
Seat 3: EASYWITHACES (button) folded before Flop (didn't bet)
Seat 4: devi7 (small blind) folded before Flop
Seat 5: Lucifer999 (big blind) folded before Flop
Seat 6: spidy02 folded before Flop (didn't bet)



PokerStars Game #00327539600: Hold'em No Limit ($25/$50 USD) - 2022/04/30 10:42:48 ET
Table 'Hold'em (Min 1K Max 5K)   216' 6-max Seat #2 is the button
Seat 1: Lucifer999 ($12376.04 in chips) 
Seat 2: rahulh1 ($2039.88 in chips) 
Seat 3: Avaroni ($6761.5 in chips) 
Seat 4: No username ($2200.49 in chips) 
Seat 5: BIG DADDY__ ($1824 in chips) 
Avaroni: posts small blind $25
No username: posts big blind $50
*** HOLE CARDS ***
Dealt to Lucifer999 [3h 5c]
BIG DADDY__: folds
Lucifer999: folds
rahulh1: calls $50
Avaroni: folds
No username: checks
*** FLOP *** [Jd 3c 6s]
No username: checks
rahulh1: checks
*** TURN *** [Jd 3c 6s] [7c]
No username: bets $89.06
rahulh1: calls $89.06
*** RIVER *** [Jd 3c 6s 7c] [8c]
No username: checks
rahulh1: checks
*** SHOW DOWN ***
No username: shows [Jc 2s] (Pair, JJ)
rahulh1: doesn't show hand
No username collected $287.97 from pot
*** SUMMARY ***
Total pot $303.12 | Rake $15.15
Board [Jd 3c 6s 7c 8c]
Seat 1: Lucifer999 folded before Flop (didn't bet)
Seat 2: rahulh1 (button) mucked
Seat 3: Avaroni (small blind) folded before Flop
Seat 4: No username  (big blind) showed [Jc 2s] and won ($287.97) with Pair, JJ
Seat 5: BIG DADDY__ folded before Flop (didn't bet)



PokerStars Game #00327539708: Hold'em No Limit ($50/$100 USD) - 2022/04/30 10:43:26 ET
Table 'Hold'em (Min 25KMax 10K)    69' 6-max Seat #6 is the button
Seat 1: Lucifer999 ($20418.01 in chips) 
Seat 6: manny007 ($2773.6 in chips) 
manny007: posts small blind $50
Lucifer999: posts big blind $100
*** HOLE CARDS ***
Dealt to Lucifer999 [Th 7d]
manny007: folds
Uncalled bet ($50) returned to Lucifer999
Lucifer999: doesn't show hand
Lucifer999 collected $100 from pot
*** SUMMARY ***
Total pot $100.00 | Rake $0
Board []
Seat 1: Lucifer999 (big blind) collected ($100)
Seat 6: manny007 (button) (small blind) folded before Flop



PokerStars Game #00327539508: Hold'em No Limit ($10/$25 USD) - 2022/04/30 10:42:21 ET
Table 'Hold'em (Min 500Max 2500)  1282' 6-max Seat #6 is the button
Seat 1: foldmybets ($3458.59 in chips) 
Seat 2: jaykam ($247.09 in chips) 
Seat 3: Mastkalandar ($2025 in chips) 
Seat 4: papadickkies ($492.56 in chips) 
Seat 5: Lucifer999 ($6534.88 in chips) 
Seat 6: devi7 ($2100.37 in chips) 
foldmybets: posts small blind $10
jaykam: posts big blind $25
*** HOLE CARDS ***
Dealt to Lucifer999 [Ah Qh]
Mastkalandar: folds
papadickkies: folds
Lucifer999: raises $55.00 to $80
devi7: folds
foldmybets: calls $70
jaykam: folds
*** FLOP *** [Ks Jh 8h]
foldmybets: checks
Lucifer999: bets $130
foldmybets: calls $130
*** TURN *** [Ks Jh 8h] [Jd]
foldmybets: checks
Lucifer999: bets $320
foldmybets: raises $705.00 to $1025
Lucifer999: calls $705
*** RIVER *** [Ks Jh 8h Jd] [6h]
foldmybets: bets $2223.59
Lucifer999: calls $2223.59
*** SHOW DOWN ***
foldmybets: shows [Js Ad] (Three of a kind, JJJ)
Lucifer999: shows [Ah Qh] (Flush, A high)
Lucifer999 collected $6738.18 from pot
*** SUMMARY ***
Total pot $6942.18 | Rake $204
Board [Ks Jh 8h Jd 6h]
Seat 1: foldmybets (small blind) showed [Js Ad] and lost with Three of a kind, JJJ
Seat 2: jaykam (big blind) folded before Flop
Seat 3: Mastkalandar folded before Flop (didn't bet)
Seat 4: papadickkies folded before Flop (didn't bet)
Seat 5: Lucifer999  showed [Ah Qh] and won ($6738.18) with Flush, A high
Seat 6: devi7 (button) folded before Flop (didn't bet)



PokerStars Game #00327539732: Hold'em No Limit ($50/$100 USD) - 2022/04/30 10:43:33 ET
Table 'Hold'em (Min 25KMax 10K)    69' 6-max Seat #1 is the button
Seat 1: Lucifer999 ($20468.01 in chips) 
Seat 6: manny007 ($2723.6 in chips) 
Lucifer999: posts small blind $50
manny007: posts big blind $100
*** HOLE CARDS ***
Dealt to Lucifer999 [6h 3c]
Lucifer999: calls $50
manny007: checks
*** FLOP *** [9d 8c Tc]
manny007: bets $100
Lucifer999: folds
Uncalled bet ($100) returned to manny007
manny007: doesn't show hand
manny007 collected $192.2 from pot
*** SUMMARY ***
Total pot $200.00 | Rake $7.8
Board [9d 8c Tc]
Seat 1: Lucifer999 (button) (small blind) folded on the Flop
Seat 6: manny007 (big blind) collected ($192.2)



PokerStars Game #00327539728: Hold'em No Limit ($10/$25 USD) - 2022/04/30 10:43:32 ET
Table 'Hold'em (Min 500Max 2500) 1001' 6-max Seat #4 is the button
Seat 1: JaspritBumrah786 ($2465 in chips) 
Seat 2: fishfry123 ($1853.42 in chips) 
Seat 3: EASYWITHACES ($2561.46 in chips) 
Seat 4: devi7 ($2577.18 in chips) 
Seat 5: Lucifer999 ($4356.18 in chips) 
Seat 6: spidy02 ($4124.53 in chips) 
Lucifer999: posts small blind $10
spidy02: posts big blind $25
*** HOLE CARDS ***
Dealt to Lucifer999 [6d 3c]
JaspritBumrah786: folds
fishfry123: folds
EASYWITHACES: folds
devi7: folds
Lucifer999: folds
Uncalled bet ($15) returned to spidy02
spidy02: doesn't show hand
spidy02 collected $20 from pot
*** SUMMARY ***
Total pot $20.00 | Rake $0
Board []
Seat 1: JaspritBumrah786 folded before Flop (didn't bet)
Seat 2: fishfry123 folded before Flop (didn't bet)
Seat 3: EASYWITHACES folded before Flop (didn't bet)
Seat 4: devi7 (button) folded before Flop (didn't bet)
Seat 5: Lucifer999 (small blind) folded before Flop
Seat 6: spidy02 (big blind) collected ($20)



PokerStars Game #00327539745: Hold'em No Limit ($10/$25 USD) - 2022/04/30 10:43:36 ET
Table 'Hold'em (Min 500Max 2500)  1282' 6-max Seat #1 is the button
Seat 1: foldmybets ($1500 in chips) 
Seat 2: jaykam ($222.09 in chips) 
Seat 3: Mastkalandar ($2025 in chips) 
Seat 4: papadickkies ($492.56 in chips) 
Seat 5: Lucifer999 ($9814.47 in chips) 
Seat 6: devi7 ($2100.37 in chips) 
jaykam: posts small blind $10
Mastkalandar: posts big blind $25
*** HOLE CARDS ***
Dealt to Lucifer999 [7c 7d]
papadickkies: folds
Lucifer999: folds
devi7: folds
foldmybets: raises $50.00 to $75
jaykam: folds
Mastkalandar: folds
Uncalled bet ($50) returned to foldmybets
foldmybets: doesn't show hand
foldmybets collected $60 from pot
*** SUMMARY ***
Total pot $60.00 | Rake $0
Board []
Seat 1: foldmybets (button) collected ($60)
Seat 2: jaykam (small blind) folded before Flop
Seat 3: Mastkalandar (big blind) folded before Flop
Seat 4: papadickkies folded before Flop (didn't bet)
Seat 5: Lucifer999 folded before Flop (didn't bet)
Seat 6: devi7 folded before Flop (didn't bet)



PokerStars Game #00327539799: Hold'em No Limit ($50/$100 USD) - 2022/04/30 10:43:56 ET
Table 'Hold'em (Min 25KMax 10K)    69' 6-max Seat #6 is the button
Seat 1: Lucifer999 ($20368.01 in chips) 
Seat 6: manny007 ($2815.8 in chips) 
manny007: posts small blind $50
Lucifer999: posts big blind $100
*** HOLE CARDS ***
Dealt to Lucifer999 [8s 4d]
manny007: calls $50
Lucifer999: checks
*** FLOP *** [Ts 4h 4c]
Lucifer999: checks
manny007: checks
*** TURN *** [Ts 4h 4c] [9h]
Lucifer999: bets $300
manny007: folds
Uncalled bet ($300) returned to Lucifer999
Lucifer999: doesn't show hand
Lucifer999 collected $192.2 from pot
*** SUMMARY ***
Total pot $200.00 | Rake $7.8
Board [Ts 4h 4c 9h]
Seat 1: Lucifer999 (big blind) collected ($192.2)
Seat 6: manny007 (button) (small blind) folded on the Turn



PokerStars Game #00327539854: Hold'em No Limit ($10/$25 USD) - 2022/04/30 10:44:09 ET
Table 'Hold'em (Min 500Max 2500)  1282' 6-max Seat #2 is the button
Seat 1: foldmybets ($1535 in chips) 
Seat 2: jaykam ($212.09 in chips) 
Seat 3: Mastkalandar ($2000 in chips) 
Seat 4: papadickkies ($492.56 in chips) 
Seat 5: Lucifer999 ($9814.47 in chips) 
Seat 6: devi7 ($2100.37 in chips) 
Mastkalandar: posts small blind $10
papadickkies: posts big blind $25
*** HOLE CARDS ***
Dealt to Lucifer999 [4s 6h]
Lucifer999: folds
devi7: folds
foldmybets: raises $50.00 to $75
jaykam: folds
Mastkalandar: folds
papadickkies: folds
Uncalled bet ($50) returned to foldmybets
foldmybets: doesn't show hand
foldmybets collected $60 from pot
*** SUMMARY ***
Total pot $60.00 | Rake $0
Board []
Seat 1: foldmybets collected ($60)
Seat 2: jaykam (button) folded before Flop (didn't bet)
Seat 3: Mastkalandar (small blind) folded before Flop
Seat 4: papadickkies (big blind) folded before Flop
Seat 5: Lucifer999 folded before Flop (didn't bet)
Seat 6: devi7 folded before Flop (didn't bet)



PokerStars Game #00327539810: Hold'em No Limit ($10/$25 USD) - 2022/04/30 10:44:00 ET
Table 'Hold'em (Min 500Max 2500) 1001' 6-max Seat #5 is the button
Seat 1: JaspritBumrah786 ($2465 in chips) 
Seat 2: fishfry123 ($1853.42 in chips) 
Seat 3: EASYWITHACES ($2561.46 in chips) 
Seat 4: devi7 ($2577.18 in chips) 
Seat 5: Lucifer999 ($4346.18 in chips) 
Seat 6: spidy02 ($4134.53 in chips) 
spidy02: posts small blind $10
JaspritBumrah786: posts big blind $25
*** HOLE CARDS ***
Dealt to Lucifer999 [4c 5c]
fishfry123: folds
EASYWITHACES: folds
devi7: folds
Lucifer999: raises $55.00 to $80
spidy02: raises $121.25 to $201.25
JaspritBumrah786: folds
Lucifer999: calls $121.25
*** FLOP *** [Th 6s 9h]
spidy02: bets $200.55
Lucifer999: folds
Uncalled bet ($200.55) returned to spidy02
spidy02: doesn't show hand
spidy02 collected $401.09 from pot
*** SUMMARY ***
Total pot $427.50 | Rake $26.41
Board [Th 6s 9h]
Seat 1: JaspritBumrah786 (big blind) folded before Flop
Seat 2: fishfry123 folded before Flop (didn't bet)
Seat 3: EASYWITHACES folded before Flop (didn't bet)
Seat 4: devi7 folded before Flop (didn't bet)
Seat 5: Lucifer999 (button) folded on the Flop
Seat 6: spidy02 (small blind) collected ($401.09)



PokerStars Game #00327539922: Hold'em No Limit ($50/$100 USD) - 2022/04/30 10:44:35 ET
Table 'Hold'em (Min 25KMax 10K)    69' 6-max Seat #1 is the button
Seat 1: Lucifer999 ($20460.21 in chips) 
Seat 6: manny007 ($2715.8 in chips) 
Lucifer999: posts small blind $50
manny007: posts big blind $100
*** HOLE CARDS ***
Dealt to Lucifer999 [4d 2c]
Lucifer999: calls $50
manny007: raises $200.00 to $300
Lucifer999: folds
Uncalled bet ($200) returned to manny007
manny007: doesn't show hand
manny007 collected $200 from pot
*** SUMMARY ***
Total pot $200.00 | Rake $0
Board []
Seat 1: Lucifer999 (button) (small blind) folded before Flop
Seat 6: manny007 (big blind) collected ($200)



PokerStars Game #00327539729: Hold'em No Limit ($25/$50 USD) - 2022/04/30 10:43:32 ET
Table 'Hold'em (Min 1K Max 5K)   216' 6-max Seat #3 is the button
Seat 1: Lucifer999 ($12376.04 in chips) 
Seat 2: rahulh1 ($1900.82 in chips) 
Seat 3: Avaroni ($6736.5 in chips) 
Seat 4: No username ($2349.4 in chips) 
Seat 5: BIG DADDY__ ($1824 in chips) 
No username: posts small blind $25
BIG DADDY__: posts big blind $50
*** HOLE CARDS ***
Dealt to Lucifer999 [8s 8c]
Lucifer999: folds
rahulh1: folds
Avaroni: folds
No username: calls $25
BIG DADDY__: checks
*** FLOP *** [Qh 7h 7c]
No username: checks
BIG DADDY__: bets $100
No username: folds
Uncalled bet ($100) returned to BIG DADDY__
BIG DADDY__: doesn't show hand
BIG DADDY__ collected $95 from pot
*** SUMMARY ***
Total pot $100.00 | Rake $5
Board [Qh 7h 7c]
Seat 1: Lucifer999 folded before Flop (didn't bet)
Seat 2: rahulh1 folded before Flop (didn't bet)
Seat 3: Avaroni (button) folded before Flop (didn't bet)
Seat 4: No username (small blind) folded on the Flop
Seat 5: BIG DADDY__ (big blind) collected ($95)



PokerStars Game #00327539959: Hold'em No Limit ($10/$25 USD) - 2022/04/30 10:44:49 ET
Table 'Hold'em (Min 500Max 2500) 1001' 6-max Seat #6 is the button
Seat 1: JaspritBumrah786 ($2440 in chips) 
Seat 2: fishfry123 ($1853.42 in chips) 
Seat 3: EASYWITHACES ($2561.46 in chips) 
Seat 4: devi7 ($2577.18 in chips) 
Seat 5: Lucifer999 ($4144.93 in chips) 
Seat 6: spidy02 ($4334.37 in chips) 
JaspritBumrah786: posts small blind $10
fishfry123: posts big blind $25
*** HOLE CARDS ***
Dealt to Lucifer999 [9d 8s]
EASYWITHACES: folds
devi7: folds
Lucifer999: folds
spidy02: raises $45.00 to $70
JaspritBumrah786: folds
fishfry123: calls $45
*** FLOP *** [Th Ac Jc]
fishfry123: checks
spidy02: bets $70.57
fishfry123: calls $70.57
*** TURN *** [Th Ac Jc] [3s]
fishfry123: bets $205.4
spidy02: folds
Uncalled bet ($205.4) returned to fishfry123
fishfry123: doesn't show hand
fishfry123 collected $273.87 from pot
*** SUMMARY ***
Total pot $291.14 | Rake $17.27
Board [Th Ac Jc 3s]
Seat 1: JaspritBumrah786 (small blind) folded before Flop
Seat 2: fishfry123 (big blind) collected ($273.87)
Seat 3: EASYWITHACES folded before Flop (didn't bet)
Seat 4: devi7 folded before Flop (didn't bet)
Seat 5: Lucifer999 folded before Flop (didn't bet)
Seat 6: spidy02 (button) folded on the Turn



PokerStars Game #00327539931: Hold'em No Limit ($10/$25 USD) - 2022/04/30 10:44:37 ET
Table 'Hold'em (Min 500Max 2500)  1282' 6-max Seat #3 is the button
Seat 1: foldmybets ($1570 in chips) 
Seat 2: jaykam ($212.09 in chips) 
Seat 3: Mastkalandar ($2025 in chips) 
Seat 4: papadickkies ($467.56 in chips) 
Seat 5: Lucifer999 ($9814.47 in chips) 
Seat 6: devi7 ($2100.37 in chips) 
papadickkies: posts small blind $10
Lucifer999: posts big blind $25
*** HOLE CARDS ***
Dealt to Lucifer999 [Ks Jd]
devi7: folds
foldmybets: folds
jaykam: folds
Mastkalandar: raises $50.00 to $75
papadickkies: folds
Lucifer999: calls $50
*** FLOP *** [Ad 6d 7c]
Lucifer999: checks
Mastkalandar: checks
*** TURN *** [Ad 6d 7c] [9d]
Lucifer999: bets $110
Mastkalandar: raises $240.00 to $350
Lucifer999: folds
Uncalled bet ($240) returned to Mastkalandar
Mastkalandar: doesn't show hand
Mastkalandar collected $357.05 from pot
*** SUMMARY ***
Total pot $380.00 | Rake $22.95
Board [Ad 6d 7c 9d]
Seat 1: foldmybets folded before Flop (didn't bet)
Seat 2: jaykam folded before Flop (didn't bet)
Seat 3: Mastkalandar (button) collected ($357.05)
Seat 4: papadickkies (small blind) folded before Flop
Seat 5: Lucifer999 (big blind) folded on the Turn
Seat 6: devi7 folded before Flop (didn't bet)



PokerStars Game #00327539961: Hold'em No Limit ($50/$100 USD) - 2022/04/30 10:44:51 ET
Table 'Hold'em (Min 25KMax 10K)    69' 6-max Seat #6 is the button
Seat 1: Lucifer999 ($20360.21 in chips) 
Seat 6: manny007 ($2815.8 in chips) 
manny007: posts small blind $50
Lucifer999: posts big blind $100
*** HOLE CARDS ***
Dealt to Lucifer999 [Th 4c]
manny007: calls $50
Lucifer999: checks
*** FLOP *** [2s 2d 8s]
Lucifer999: checks
manny007: checks
*** TURN *** [2s 2d 8s] [Js]
Lucifer999: checks
manny007: checks
*** RIVER *** [2s 2d 8s Js] [9h]
Lucifer999: bets $100
manny007: calls $100
*** SHOW DOWN ***
Lucifer999: shows [Th 4c] (Pair, 22)
manny007: shows [6c Ac] (Pair, 22)
manny007 collected $384.4 from pot
*** SUMMARY ***
Total pot $400.00 | Rake $15.6
Board [2s 2d 8s Js 9h]
Seat 1: Lucifer999 (big blind) showed [Th 4c] and lost with Pair, 22
Seat 6: manny007  (button) (small blind) showed [6c Ac] and won ($384.4) with Pair, 22



PokerStars Game #00327539982: Hold'em No Limit ($25/$50 USD) - 2022/04/30 10:44:57 ET
Table 'Hold'em (Min 1K Max 5K)   216' 6-max Seat #4 is the button
Seat 1: Lucifer999 ($12376.04 in chips) 
Seat 2: rahulh1 ($1900.82 in chips) 
Seat 4: No username ($2299.4 in chips) 
Seat 5: BIG DADDY__ ($1869 in chips) 
Seat 6: bettercall7208 ($5000 in chips) 
BIG DADDY__: posts small blind $25
Lucifer999: posts big blind $50
*** HOLE CARDS ***
Dealt to Lucifer999 [Ac Qd]
rahulh1: folds
No username: raises $125.00 to $175
BIG DADDY__: folds
Lucifer999: raises $575.00 to $750
No username: calls $575
*** FLOP *** [6h Td 8h]
Lucifer999: checks
No username: bets $649.38
Lucifer999: raises $2750.62 to $3400
No username: calls $900.02
Uncalled bet ($1850.6) returned to Lucifer999
*** TURN *** [6h Td 8h] [7h]
*** TURN *** [6h Td 8h] [2s]
*** RIVER *** [6h Td 8h 7h] [Jh]
*** RIVER *** [6h Td 8h 7h] [6c]
*** SHOW DOWN ***
Lucifer999: shows [Ac Qd] (Pair, 66)
No username: shows [Kd Th] (Two pairs, TT66)
No username collected $2196.33 from pot
No username collected $2196.32 from pot
*** SUMMARY ***
Total pot $4623.80 | Rake $231.15
Board [6h Td 8h 7h Jh]
Seat 1: Lucifer999 (big blind) showed [Ac Qd] and lost with Pair, 66
Seat 2: rahulh1 folded before Flop (didn't bet)
Seat 4: No username  (button) showed [Kd Th] and won ($2196.32) with Two pairs, TT66
Seat 5: BIG DADDY__ (small blind) folded before Flop



PokerStars Game #00327540122: Hold'em No Limit ($50/$100 USD) - 2022/04/30 10:45:46 ET
Table 'Hold'em (Min 25KMax 10K)    69' 6-max Seat #1 is the button
Seat 1: Lucifer999 ($20160.21 in chips) 
Seat 6: manny007 ($3000.2 in chips) 
Lucifer999: posts small blind $50
manny007: posts big blind $100
*** HOLE CARDS ***
Dealt to Lucifer999 [8d 5d]
Lucifer999: calls $50
manny007: checks
*** FLOP *** [Js Qs 2s]
manny007: bets $131.63
Lucifer999: folds
Uncalled bet ($131.63) returned to manny007
manny007: doesn't show hand
manny007 collected $192.2 from pot
*** SUMMARY ***
Total pot $200.00 | Rake $7.8
Board [Js Qs 2s]
Seat 1: Lucifer999 (button) (small blind) folded on the Flop
Seat 6: manny007 (big blind) collected ($192.2)



PokerStars Game #00327540106: Hold'em No Limit ($10/$25 USD) - 2022/04/30 10:45:42 ET
Table 'Hold'em (Min 500Max 2500)  1282' 6-max Seat #4 is the button
Seat 1: foldmybets ($1570 in chips) 
Seat 2: jaykam ($212.09 in chips) 
Seat 3: Mastkalandar ($2272.05 in chips) 
Seat 4: papadickkies ($457.56 in chips) 
Seat 5: Lucifer999 ($9629.47 in chips) 
Seat 6: devi7 ($2100.37 in chips) 
Lucifer999: posts small blind $10
devi7: posts big blind $25
*** HOLE CARDS ***
Dealt to Lucifer999 [Qc Jd]
foldmybets: folds
jaykam: folds
Mastkalandar: folds
papadickkies: raises $35.00 to $60
Lucifer999: folds
devi7: folds
Uncalled bet ($35) returned to papadickkies
papadickkies: doesn't show hand
papadickkies collected $60 from pot
*** SUMMARY ***
Total pot $60.00 | Rake $0
Board []
Seat 1: foldmybets folded before Flop (didn't bet)
Seat 2: jaykam folded before Flop (didn't bet)
Seat 3: Mastkalandar folded before Flop (didn't bet)
Seat 4: papadickkies (button) collected ($60)
Seat 5: Lucifer999 (small blind) folded before Flop
Seat 6: devi7 (big blind) folded before Flop



PokerStars Game #00327540198: Hold'em No Limit ($50/$100 USD) - 2022/04/30 10:46:09 ET
Table 'Hold'em (Min 25KMax 10K)    69' 6-max Seat #6 is the button
Seat 1: Lucifer999 ($20060.21 in chips) 
Seat 6: manny007 ($3092.4 in chips) 
manny007: posts small blind $50
Lucifer999: posts big blind $100
*** HOLE CARDS ***
Dealt to Lucifer999 [5c Ad]
manny007: folds
Uncalled bet ($50) returned to Lucifer999
Lucifer999: doesn't show hand
Lucifer999 collected $100 from pot
*** SUMMARY ***
Total pot $100.00 | Rake $0
Board []
Seat 1: Lucifer999 (big blind) collected ($100)
Seat 6: manny007 (button) (small blind) folded before Flop



PokerStars Game #00327540099: Hold'em No Limit ($10/$25 USD) - 2022/04/30 10:45:40 ET
Table 'Hold'em (Min 500Max 2500) 1001' 6-max Seat #1 is the button
Seat 1: JaspritBumrah786 ($2430 in chips) 
Seat 2: fishfry123 ($1986.72 in chips) 
Seat 3: EASYWITHACES ($2561.46 in chips) 
Seat 4: devi7 ($2577.18 in chips) 
Seat 5: Lucifer999 ($4144.93 in chips) 
Seat 6: spidy02 ($4193.8 in chips) 
fishfry123: posts small blind $10
EASYWITHACES: posts big blind $25
*** HOLE CARDS ***
Dealt to Lucifer999 [Td 8c]
devi7: folds
Lucifer999: folds
spidy02: folds
JaspritBumrah786: folds
fishfry123: raises $33.75 to $58.75
EASYWITHACES: calls $33.75
*** FLOP *** [Kc 5d 9s]
fishfry123: bets $82.77
EASYWITHACES: calls $82.77
*** TURN *** [Kc 5d 9s] [Ad]
fishfry123: bets $199.64
EASYWITHACES: folds
Uncalled bet ($199.64) returned to fishfry123
fishfry123: doesn't show hand
fishfry123 collected $266.19 from pot
*** SUMMARY ***
Total pot $283.04 | Rake $16.85
Board [Kc 5d 9s Ad]
Seat 1: JaspritBumrah786 (button) folded before Flop (didn't bet)
Seat 2: fishfry123 (small blind) collected ($266.19)
Seat 3: EASYWITHACES (big blind) folded on the Turn
Seat 4: devi7 folded before Flop (didn't bet)
Seat 5: Lucifer999 folded before Flop (didn't bet)
Seat 6: spidy02 folded before Flop (didn't bet)



PokerStars Game #00327540182: Hold'em No Limit ($25/$50 USD) - 2022/04/30 10:46:04 ET
Table 'Hold'em (Min 1K Max 5K)   216' 6-max Seat #5 is the button
Seat 1: Lucifer999 ($10076.64 in chips) 
Seat 2: rahulh1 ($1900.82 in chips) 
Seat 4: No username ($4392.65 in chips) 
Seat 5: BIG DADDY__ ($1844 in chips) 
Seat 6: anshu86 ($5000 in chips) 
Lucifer999: posts small blind $25
rahulh1: posts big blind $50
*** HOLE CARDS ***
Dealt to Lucifer999 [7h 8h]
No username: folds
BIG DADDY__: folds
Lucifer999: raises $100.00 to $150
rahulh1: calls $100
*** FLOP *** [7d 6s 5h]
Lucifer999: bets $150
rahulh1: folds
Uncalled bet ($150) returned to Lucifer999
Lucifer999: doesn't show hand
Lucifer999 collected $285 from pot
*** SUMMARY ***
Total pot $300.00 | Rake $15
Board [7d 6s 5h]
Seat 1: Lucifer999 (small blind) collected ($285)
Seat 2: rahulh1 (big blind) folded on the Flop
Seat 4: No username folded before Flop (didn't bet)
Seat 5: BIG DADDY__ (button) folded before Flop (didn't bet)



PokerStars Game #00327540223: Hold'em No Limit ($50/$100 USD) - 2022/04/30 10:46:18 ET
Table 'Hold'em (Min 25KMax 10K)    69' 6-max Seat #1 is the button
Seat 1: Lucifer999 ($20110.21 in chips) 
Seat 6: manny007 ($3042.4 in chips) 
Lucifer999: posts small blind $50
manny007: posts big blind $100
*** HOLE CARDS ***
Dealt to Lucifer999 [3s 3c]
Lucifer999: calls $50
manny007: checks
*** FLOP *** [9h 2d 7s]
manny007: checks
Lucifer999: checks
*** TURN *** [9h 2d 7s] [Kc]
manny007: bets $100
Lucifer999: calls $100
*** RIVER *** [9h 2d 7s Kc] [Ks]
manny007: bets $100
Lucifer999: folds
Uncalled bet ($100) returned to manny007
manny007: doesn't show hand
manny007 collected $384.4 from pot
*** SUMMARY ***
Total pot $400.00 | Rake $15.6
Board [9h 2d 7s Kc Ks]
Seat 1: Lucifer999 (button) (small blind) folded on the River
Seat 6: manny007 (big blind) collected ($384.4)



PokerStars Game #00327540231: Hold'em No Limit ($10/$25 USD) - 2022/04/30 10:46:21 ET
Table 'Hold'em (Min 500Max 2500) 1001' 6-max Seat #2 is the button
Seat 1: JaspritBumrah786 ($2430 in chips) 
Seat 2: fishfry123 ($2111.39 in chips) 
Seat 3: EASYWITHACES ($2419.94 in chips) 
Seat 4: devi7 ($2577.18 in chips) 
Seat 5: Lucifer999 ($4144.93 in chips) 
Seat 6: spidy02 ($4193.8 in chips) 
EASYWITHACES: posts small blind $10
devi7: posts big blind $25
*** HOLE CARDS ***
Dealt to Lucifer999 [6c 2c]
Lucifer999: folds
spidy02: calls $25
JaspritBumrah786: calls $25
fishfry123: folds
EASYWITHACES: folds
devi7: checks
*** FLOP *** [9d Js Ad]
devi7: checks
spidy02: bets $60.41
JaspritBumrah786: raises $139.59 to $200
devi7: folds
spidy02: folds
Uncalled bet ($139.59) returned to JaspritBumrah786
JaspritBumrah786: doesn't show hand
JaspritBumrah786 collected $193.06 from pot
*** SUMMARY ***
Total pot $205.82 | Rake $12.76
Board [9d Js Ad]
Seat 1: JaspritBumrah786 collected ($193.06)
Seat 2: fishfry123 (button) folded before Flop (didn't bet)
Seat 3: EASYWITHACES (small blind) folded before Flop
Seat 4: devi7 (big blind) folded on the Flop
Seat 5: Lucifer999 folded before Flop (didn't bet)
Seat 6: spidy02 folded on the Flop



PokerStars Game #00327540212: Hold'em No Limit ($10/$25 USD) - 2022/04/30 10:46:13 ET
Table 'Hold'em (Min 500Max 2500)  1282' 6-max Seat #5 is the button
Seat 1: foldmybets ($1570 in chips) 
Seat 2: jaykam ($212.09 in chips) 
Seat 3: Mastkalandar ($2272.05 in chips) 
Seat 4: papadickkies ($492.56 in chips) 
Seat 5: Lucifer999 ($9619.47 in chips) 
Seat 6: devi7 ($2075.37 in chips) 
devi7: posts small blind $10
foldmybets: posts big blind $25
*** HOLE CARDS ***
Dealt to Lucifer999 [Th 3h]
jaykam: folds
Mastkalandar: folds
papadickkies: raises $35.00 to $60
Lucifer999: folds
devi7: raises $230.00 to $290
foldmybets: folds
papadickkies: calls $230
*** FLOP *** [8c 5h Jh]
devi7: bets $1785.37
papadickkies: calls $202.56
Uncalled bet ($1582.81) returned to devi7
*** TURN *** [8c 5h Jh] [8h]
*** RIVER *** [8c 5h Jh 8h] [3c]
*** SHOW DOWN ***
papadickkies: shows [Ts Js] (Two pairs, JJ88)
devi7: shows [Qd As] (Pair, 88)
papadickkies collected $952.1 from pot
*** SUMMARY ***
Total pot $1010.12 | Rake $58.02
Board [8c 5h Jh 8h 3c]
Seat 1: foldmybets (big blind) folded before Flop
Seat 2: jaykam folded before Flop (didn't bet)
Seat 3: Mastkalandar folded before Flop (didn't bet)
Seat 4: papadickkies  showed [Ts Js] and won ($952.1) with Two pairs, JJ88
Seat 5: Lucifer999 (button) folded before Flop (didn't bet)
Seat 6: devi7 (small blind) showed [Qd As] and lost with Pair, 88



PokerStars Game #00327540276: Hold'em No Limit ($25/$50 USD) - 2022/04/30 10:46:39 ET
Table 'Hold'em (Min 1K Max 5K)   216' 6-max Seat #1 is the button
Seat 1: Lucifer999 ($10211.64 in chips) 
Seat 2: rahulh1 ($1750.82 in chips) 
Seat 4: No username ($4392.65 in chips) 
Seat 5: BIG DADDY__ ($1844 in chips) 
Seat 6: anshu86 ($5000 in chips) 
rahulh1: posts small blind $25
No username: posts big blind $50
anshu86: posts big blind $50
*** HOLE CARDS ***
Dealt to Lucifer999 [4c Tc]
BIG DADDY__: raises $100.00 to $150
anshu86: folds
Lucifer999: folds
rahulh1: calls $125
No username: calls $100
*** FLOP *** [Ts Th 9h]
rahulh1: checks
No username: checks
BIG DADDY__: checks
*** TURN *** [Ts Th 9h] [5c]
rahulh1: checks
No username: bets $237.5
BIG DADDY__: calls $237.5
rahulh1: calls $237.5
*** RIVER *** [Ts Th 9h 5c] [9d]
rahulh1: checks
No username: checks
BIG DADDY__: checks
*** SHOW DOWN ***
No username: shows [Js 9c] (Full house, 999TT)
BIG DADDY__: doesn't show hand
rahulh1: doesn't show hand
No username collected $1151.9 from pot
*** SUMMARY ***
Total pot $1212.50 | Rake $60.6
Board [Ts Th 9h 5c 9d]
Seat 1: Lucifer999 (button) folded before Flop (didn't bet)
Seat 2: rahulh1 (small blind) mucked
Seat 4: No username  (big blind) showed [Js 9c] and won ($1151.9) with Full house, 999TT
Seat 5: BIG DADDY__ mucked
Seat 6: anshu86 folded before Flop



PokerStars Game #00327540375: Hold'em No Limit ($10/$25 USD) - 2022/04/30 10:47:10 ET
Table 'Hold'em (Min 500Max 2500) 1001' 6-max Seat #3 is the button
Seat 1: JaspritBumrah786 ($2537.65 in chips) 
Seat 2: fishfry123 ($2111.39 in chips) 
Seat 3: EASYWITHACES ($2409.94 in chips) 
Seat 4: devi7 ($2552.18 in chips) 
Seat 5: Lucifer999 ($4144.93 in chips) 
Seat 6: spidy02 ($4108.39 in chips) 
devi7: posts small blind $10
Lucifer999: posts big blind $25
*** HOLE CARDS ***
Dealt to Lucifer999 [Ts 5h]
spidy02: folds
JaspritBumrah786: folds
fishfry123: folds
EASYWITHACES: folds
devi7: raises $55.00 to $80
Lucifer999: folds
Uncalled bet ($55) returned to devi7
devi7: doesn't show hand
devi7 collected $50 from pot
*** SUMMARY ***
Total pot $50.00 | Rake $0
Board []
Seat 1: JaspritBumrah786 folded before Flop (didn't bet)
Seat 2: fishfry123 folded before Flop (didn't bet)
Seat 3: EASYWITHACES (button) folded before Flop (didn't bet)
Seat 4: devi7 (small blind) collected ($50)
Seat 5: Lucifer999 (big blind) folded before Flop
Seat 6: spidy02 folded before Flop (didn't bet)



PokerStars Game #00327540429: Hold'em No Limit ($25/$50 USD) - 2022/04/30 10:47:32 ET
Table 'Hold'em (Min 1K Max 5K)   216' 6-max Seat #2 is the button
Seat 1: Lucifer999 ($10211.64 in chips) 
Seat 2: rahulh1 ($1363.32 in chips) 
Seat 3: Avaroni ($6736.5 in chips) 
Seat 4: No username ($5157.05 in chips) 
Seat 5: BIG DADDY__ ($1456.5 in chips) 
Seat 6: anshu86 ($4950 in chips) 
No username: posts small blind $25
BIG DADDY__: posts big blind $50
*** HOLE CARDS ***
Dealt to Lucifer999 [4s Jd]
anshu86: folds
Lucifer999: folds
rahulh1: folds
No username: folds
Uncalled bet ($25) returned to BIG DADDY__
BIG DADDY__: doesn't show hand
BIG DADDY__ collected $50 from pot
*** SUMMARY ***
Total pot $50.00 | Rake $0
Board []
Seat 1: Lucifer999 folded before Flop (didn't bet)
Seat 2: rahulh1 (button) folded before Flop (didn't bet)
Seat 4: No username (small blind) folded before Flop
Seat 5: BIG DADDY__ (big blind) collected ($50)
Seat 6: anshu86 folded before Flop (didn't bet)



PokerStars Game #00327540353: Hold'em No Limit ($50/$100 USD) - 2022/04/30 10:47:03 ET
Table 'Hold'em (Min 25KMax 10K)    69' 6-max Seat #6 is the button
Seat 1: Lucifer999 ($19910.21 in chips) 
Seat 5: tabby20 ($31499.68 in chips) 
Seat 6: manny007 ($3226.8 in chips) 
Lucifer999: posts small blind $50
tabby20: posts big blind $100
*** HOLE CARDS ***
Dealt to Lucifer999 [Qh 7s]
manny007: calls $100
Lucifer999: calls $50
tabby20: checks
*** FLOP *** [2h 4h 2s]
Lucifer999: checks
tabby20: checks
manny007: checks
*** TURN *** [2h 4h 2s] [6h]
Lucifer999: checks
tabby20: bets $286.8
manny007: folds
Lucifer999: raises $313.20 to $600
tabby20: raises $1000.00 to $1600
Lucifer999: folds
Uncalled bet ($1000) returned to tabby20
tabby20: doesn't show hand
tabby20 collected $1434 from pot
*** SUMMARY ***
Total pot $1500.00 | Rake $66
Board [2h 4h 2s 6h]
Seat 1: Lucifer999 (small blind) folded on the Turn
Seat 5: tabby20 (big blind) collected ($1434)
Seat 6: manny007 (button) folded on the Turn



PokerStars Game #00327540476: Hold'em No Limit ($10/$25 USD) - 2022/04/30 10:47:45 ET
Table 'Hold'em (Min 500Max 2500) 1001' 6-max Seat #4 is the button
Seat 1: JaspritBumrah786 ($2537.65 in chips) 
Seat 2: fishfry123 ($2111.39 in chips) 
Seat 3: EASYWITHACES ($2409.94 in chips) 
Seat 4: devi7 ($2577.18 in chips) 
Seat 5: Lucifer999 ($4119.93 in chips) 
Seat 6: spidy02 ($4108.39 in chips) 
Lucifer999: posts small blind $10
spidy02: posts big blind $25
*** HOLE CARDS ***
Dealt to Lucifer999 [Qd 4s]
JaspritBumrah786: folds
fishfry123: folds
EASYWITHACES: calls $25
devi7: raises $85.00 to $110
Lucifer999: folds
spidy02: folds
EASYWITHACES: folds
Uncalled bet ($85) returned to devi7
devi7: doesn't show hand
devi7 collected $85 from pot
*** SUMMARY ***
Total pot $85.00 | Rake $0
Board []
Seat 1: JaspritBumrah786 folded before Flop (didn't bet)
Seat 2: fishfry123 folded before Flop (didn't bet)
Seat 3: EASYWITHACES folded before Flop
Seat 4: devi7 (button) collected ($85)
Seat 5: Lucifer999 (small blind) folded before Flop
Seat 6: spidy02 (big blind) folded before Flop



PokerStars Game #00327540497: Hold'em No Limit ($25/$50 USD) - 2022/04/30 10:47:53 ET
Table 'Hold'em (Min 1K Max 5K)   216' 6-max Seat #4 is the button
Seat 1: Lucifer999 ($10211.64 in chips) 
Seat 2: rahulh1 ($1363.32 in chips) 
Seat 3: Avaroni ($6736.5 in chips) 
Seat 4: No username ($5132.05 in chips) 
Seat 5: BIG DADDY__ ($1481.5 in chips) 
Seat 6: anshu86 ($4950 in chips) 
BIG DADDY__: posts small blind $25
anshu86: posts big blind $50
*** HOLE CARDS ***
Dealt to Lucifer999 [Kd Qc]
Lucifer999: folds
rahulh1: folds
No username: raises $125.00 to $175
BIG DADDY__: folds
anshu86: raises $4775.00 to $4950
No username: folds
Uncalled bet ($4775) returned to anshu86
anshu86: doesn't show hand
anshu86 collected $375 from pot
*** SUMMARY ***
Total pot $375.00 | Rake $0
Board []
Seat 1: Lucifer999 folded before Flop (didn't bet)
Seat 2: rahulh1 folded before Flop (didn't bet)
Seat 4: No username (button) folded before Flop
Seat 5: BIG DADDY__ (small blind) folded before Flop
Seat 6: anshu86 (big blind) collected ($375)



PokerStars Game #00327540499: Hold'em No Limit ($50/$100 USD) - 2022/04/30 10:47:53 ET
Table 'Hold'em (Min 25KMax 10K)    69' 6-max Seat #1 is the button
Seat 1: Lucifer999 ($19210.21 in chips) 
Seat 2: anshu86 ($10000 in chips) 
Seat 5: tabby20 ($32233.68 in chips) 
Seat 6: manny007 ($3126.8 in chips) 
tabby20: posts small blind $50
manny007: posts big blind $100
*** HOLE CARDS ***
Dealt to Lucifer999 [2d 8c]
Lucifer999: folds
tabby20: raises $200.00 to $300
manny007: calls $200
*** FLOP *** [Tc Th 5d]
tabby20: checks
manny007: checks
*** TURN *** [Tc Th 5d] [6s]
tabby20: checks
manny007: bets $430.2
tabby20: folds
Uncalled bet ($430.2) returned to manny007
manny007: doesn't show hand
manny007 collected $573.6 from pot
*** SUMMARY ***
Total pot $600.00 | Rake $26.4
Board [Tc Th 5d 6s]
Seat 1: Lucifer999 (button) folded before Flop (didn't bet)
Seat 5: tabby20 (small blind) folded on the Turn
Seat 6: manny007 (big blind) collected ($573.6)



PokerStars Game #00327540413: Hold'em No Limit ($10/$25 USD) - 2022/04/30 10:47:27 ET
Table 'Hold'em (Min 500Max 2500)  1282' 6-max Seat #6 is the button
Seat 1: foldmybets ($1545 in chips) 
Seat 2: jaykam ($212.09 in chips) 
Seat 3: Mastkalandar ($2272.05 in chips) 
Seat 4: papadickkies ($952.1 in chips) 
Seat 5: Lucifer999 ($9619.47 in chips) 
Seat 6: devi7 ($2500 in chips) 
foldmybets: posts small blind $10
jaykam: posts big blind $25
*** HOLE CARDS ***
Dealt to Lucifer999 [3c 3h]
Mastkalandar: folds
papadickkies: raises $27.02 to $52.02
Lucifer999: calls $52.02
devi7: folds
foldmybets: folds
jaykam: calls $27.02
*** FLOP *** [Ts Td 7s]
jaykam: checks
papadickkies: checks
Lucifer999: checks
*** TURN *** [Ts Td 7s] [2d]
jaykam: checks
papadickkies: checks
Lucifer999: checks
*** RIVER *** [Ts Td 7s 2d] [Jh]
jaykam: checks
papadickkies: bets $78.18
Lucifer999: folds
jaykam: folds
Uncalled bet ($78.18) returned to papadickkies
papadickkies: doesn't show hand
papadickkies collected $156.35 from pot
*** SUMMARY ***
Total pot $166.06 | Rake $9.71
Board [Ts Td 7s 2d Jh]
Seat 1: foldmybets (small blind) folded before Flop
Seat 2: jaykam (big blind) folded on the River
Seat 3: Mastkalandar folded before Flop (didn't bet)
Seat 4: papadickkies collected ($156.35)
Seat 5: Lucifer999 folded on the River
Seat 6: devi7 (button) folded before Flop (didn't bet)



PokerStars Game #00327540590: Hold'em No Limit ($25/$50 USD) - 2022/04/30 10:48:26 ET
Table 'Hold'em (Min 1K Max 5K)   216' 6-max Seat #5 is the button
Seat 1: Lucifer999 ($10211.64 in chips) 
Seat 2: rahulh1 ($1363.32 in chips) 
Seat 3: Avaroni ($6736.5 in chips) 
Seat 4: No username ($4957.05 in chips) 
Seat 5: BIG DADDY__ ($1456.5 in chips) 
Seat 6: anshu86 ($5150 in chips) 
anshu86: posts small blind $25
Lucifer999: posts big blind $50
*** HOLE CARDS ***
Dealt to Lucifer999 [Qs Ts]
rahulh1: raises $81.25 to $131.25
No username: calls $131.25
BIG DADDY__: folds
anshu86: raises $5018.75 to $5150
Lucifer999: folds
rahulh1: calls $1232.07
No username: folds
Uncalled bet ($3786.68) returned to anshu86
*** FLOP *** [9h 6d 4h]
*** FLOP *** [4s 7c 3h]
*** TURN *** [9h 6d 4h] [Ah]
*** TURN *** [9h 6d 4h] [2h]
*** RIVER *** [9h 6d 4h Ah] [As]
*** RIVER *** [9h 6d 4h Ah] [8s]
*** SHOW DOWN ***
rahulh1: shows [Ac 5c] (Straight, 5-A)
anshu86: shows [Ad Kh] (High card, A)
anshu86 collected $1381.27 from pot
rahulh1 collected $1381.27 from pot
*** SUMMARY ***
Total pot $2907.89 | Rake $145.35
Board [9h 6d 4h Ah As]
Seat 1: Lucifer999 (big blind) folded before Flop
Seat 2: rahulh1  showed [Ac 5c] and won ($1381.27) with Straight, 5-A
Seat 4: No username folded before Flop
Seat 5: BIG DADDY__ (button) folded before Flop (didn't bet)
Seat 6: anshu86  (small blind) showed [Ad Kh] and won ($1381.27) with High card, A



PokerStars Game #00327540621: Hold'em No Limit ($10/$25 USD) - 2022/04/30 10:48:40 ET
Table 'Hold'em (Min 500Max 2500)  1282' 6-max Seat #1 is the button
Seat 1: foldmybets ($1535 in chips) 
Seat 2: jaykam ($160.07 in chips) 
Seat 3: Mastkalandar ($2272.05 in chips) 
Seat 4: papadickkies ($1056.43 in chips) 
Seat 5: Lucifer999 ($9567.45 in chips) 
Seat 6: devi7 ($2500 in chips) 
jaykam: posts small blind $10
Mastkalandar: posts big blind $25
*** HOLE CARDS ***
Dealt to Lucifer999 [Ts 3d]
papadickkies: folds
Lucifer999: folds
devi7: folds
foldmybets: raises $50.00 to $75
jaykam: raises $85.07 to $160.07
Mastkalandar: folds
foldmybets: raises $239.93 to $400
Uncalled bet ($239.93) returned to foldmybets
*** FLOP *** [4c 2d 6h]
*** TURN *** [4c 2d 6h] [Ah]
*** RIVER *** [4c 2d 6h Ah] [6s]
*** SHOW DOWN ***
foldmybets: shows [9d Qd] (Pair, 66)
jaykam: shows [Td Ac] (Two pairs, AA66)
jaykam collected $324.03 from pot
*** SUMMARY ***
Total pot $345.14 | Rake $21.11
Board [4c 2d 6h Ah 6s]
Seat 1: foldmybets (button) showed [9d Qd] and lost with Pair, 66
Seat 2: jaykam  (small blind) showed [Td Ac] and won ($324.03) with Two pairs, AA66
Seat 3: Mastkalandar (big blind) folded before Flop
Seat 4: papadickkies folded before Flop (didn't bet)
Seat 5: Lucifer999 folded before Flop (didn't bet)
Seat 6: devi7 folded before Flop (didn't bet)



PokerStars Game #00327540582: Hold'em No Limit ($10/$25 USD) - 2022/04/30 10:48:25 ET
Table 'Hold'em (Min 500Max 2500) 1001' 6-max Seat #5 is the button
Seat 1: JaspritBumrah786 ($2537.65 in chips) 
Seat 2: fishfry123 ($2111.39 in chips) 
Seat 3: EASYWITHACES ($2384.94 in chips) 
Seat 4: devi7 ($2637.18 in chips) 
Seat 5: Lucifer999 ($4109.93 in chips) 
Seat 6: spidy02 ($4083.39 in chips) 
spidy02: posts small blind $10
JaspritBumrah786: posts big blind $25
*** HOLE CARDS ***
Dealt to Lucifer999 [Js 7c]
fishfry123: folds
EASYWITHACES: calls $25
devi7: folds
Lucifer999: folds
spidy02: calls $15
JaspritBumrah786: checks
*** FLOP *** [Qs 4h 4c]
spidy02: checks
JaspritBumrah786: checks
EASYWITHACES: checks
*** TURN *** [Qs 4h 4c] [8d]
spidy02: checks
JaspritBumrah786: checks
EASYWITHACES: checks
*** RIVER *** [Qs 4h 4c 8d] [4s]
spidy02: checks
JaspritBumrah786: bets $50
EASYWITHACES: folds
spidy02: folds
Uncalled bet ($50) returned to JaspritBumrah786
JaspritBumrah786: doesn't show hand
JaspritBumrah786 collected $71.07 from pot
*** SUMMARY ***
Total pot $75.00 | Rake $3.93
Board [Qs 4h 4c 8d 4s]
Seat 1: JaspritBumrah786 (big blind) collected ($71.07)
Seat 2: fishfry123 folded before Flop (didn't bet)
Seat 3: EASYWITHACES folded on the River
Seat 4: devi7 folded before Flop (didn't bet)
Seat 5: Lucifer999 (button) folded before Flop (didn't bet)
Seat 6: spidy02 (small blind) folded on the River



PokerStars Game #00327540682: Hold'em No Limit ($25/$50 USD) - 2022/04/30 10:49:02 ET
Table 'Hold'em (Min 1K Max 5K)   216' 6-max Seat #6 is the button
Seat 1: Lucifer999 ($10161.64 in chips) 
Seat 2: rahulh1 ($1381.27 in chips) 
Seat 3: Avaroni ($6736.5 in chips) 
Seat 4: No username ($4825.8 in chips) 
Seat 5: BIG DADDY__ ($1456.5 in chips) 
Seat 6: anshu86 ($5167.95 in chips) 
Lucifer999: posts small blind $25
rahulh1: posts big blind $50
*** HOLE CARDS ***
Dealt to Lucifer999 [Kc Ah]
No username: folds
BIG DADDY__: raises $75.00 to $125
anshu86: folds
Lucifer999: raises $1475.00 to $1600
rahulh1: folds
BIG DADDY__: folds
Uncalled bet ($1475) returned to Lucifer999
Lucifer999: doesn't show hand
Lucifer999 collected $300 from pot
*** SUMMARY ***
Total pot $300.00 | Rake $0
Board []
Seat 1: Lucifer999 (small blind) collected ($300)
Seat 2: rahulh1 (big blind) folded before Flop
Seat 4: No username folded before Flop (didn't bet)
Seat 5: BIG DADDY__ folded before Flop
Seat 6: anshu86 (button) folded before Flop (didn't bet)



PokerStars Game #00327540609: Hold'em No Limit ($50/$100 USD) - 2022/04/30 10:48:33 ET
Table 'Hold'em (Min 25KMax 10K)    69' 6-max Seat #5 is the button
Seat 1: Lucifer999 ($19210.21 in chips) 
Seat 2: anshu86 ($10000 in chips) 
Seat 5: tabby20 ($31933.68 in chips) 
Seat 6: manny007 ($3400.4 in chips) 
manny007: posts small blind $50
Lucifer999: posts big blind $100
*** HOLE CARDS ***
Dealt to Lucifer999 [Td Jh]
anshu86: checks
tabby20: raises $250.00 to $350
manny007: calls $300
Lucifer999: calls $250
anshu86: folds
*** FLOP *** [6d 3s 4h]
manny007: bets $100
Lucifer999: folds
tabby20: calls $100
*** TURN *** [6d 3s 4h] [6c]
manny007: bets $100
tabby20: calls $100
*** RIVER *** [6d 3s 4h 6c] [Tc]
manny007: bets $100
tabby20: calls $100
*** SHOW DOWN ***
manny007: shows [Ts As] (Two pairs, TT66)
tabby20: doesn't show hand
manny007 collected $1673 from pot
*** SUMMARY ***
Total pot $1750.00 | Rake $77
Board [6d 3s 4h 6c Tc]
Seat 1: Lucifer999 (big blind) folded on the Flop
Seat 2: anshu86 folded before Flop (didn't bet)
Seat 5: tabby20 (button) mucked
Seat 6: manny007  (small blind) showed [Ts As] and won ($1673) with Two pairs, TT66



PokerStars Game #00327540763: Hold'em No Limit ($25/$50 USD) - 2022/04/30 10:49:32 ET
Table 'Hold'em (Min 1K Max 5K)   216' 6-max Seat #1 is the button
Seat 1: Lucifer999 ($10336.64 in chips) 
Seat 2: rahulh1 ($1331.27 in chips) 
Seat 3: Avaroni ($6736.5 in chips) 
Seat 4: No username ($4825.8 in chips) 
Seat 5: BIG DADDY__ ($1331.5 in chips) 
Seat 6: anshu86 ($5167.95 in chips) 
rahulh1: posts small blind $25
Avaroni: posts big blind $50
*** HOLE CARDS ***
Dealt to Lucifer999 [2d 7s]
No username: raises $66.67 to $116.67
BIG DADDY__: folds
anshu86: folds
Lucifer999: folds
rahulh1: folds
Avaroni: folds
Uncalled bet ($66.67) returned to No username
No username: doesn't show hand
No username collected $125 from pot
*** SUMMARY ***
Total pot $125.00 | Rake $0
Board []
Seat 1: Lucifer999 (button) folded before Flop (didn't bet)
Seat 2: rahulh1 (small blind) folded before Flop
Seat 3: Avaroni (big blind) folded before Flop
Seat 4: No username collected ($125)
Seat 5: BIG DADDY__ folded before Flop (didn't bet)
Seat 6: anshu86 folded before Flop (didn't bet)



PokerStars Game #00327540734: Hold'em No Limit ($10/$25 USD) - 2022/04/30 10:49:22 ET
Table 'Hold'em (Min 500Max 2500) 1001' 6-max Seat #6 is the button
Seat 1: JaspritBumrah786 ($2583.72 in chips) 
Seat 2: fishfry123 ($2111.39 in chips) 
Seat 3: EASYWITHACES ($2359.94 in chips) 
Seat 4: devi7 ($2637.18 in chips) 
Seat 5: Lucifer999 ($4109.93 in chips) 
Seat 6: spidy02 ($4058.39 in chips) 
JaspritBumrah786: posts small blind $10
fishfry123: posts big blind $25
*** HOLE CARDS ***
Dealt to Lucifer999 [8s Ks]
EASYWITHACES: folds
devi7: folds
Lucifer999: raises $55.00 to $80
spidy02: folds
JaspritBumrah786: folds
fishfry123: calls $55
*** FLOP *** [4d Jd 4h]
fishfry123: checks
Lucifer999: bets $100
fishfry123: folds
Uncalled bet ($100) returned to Lucifer999
Lucifer999: doesn't show hand
Lucifer999 collected $160.08 from pot
*** SUMMARY ***
Total pot $170.00 | Rake $9.92
Board [4d Jd 4h]
Seat 1: JaspritBumrah786 (small blind) folded before Flop
Seat 2: fishfry123 (big blind) folded on the Flop
Seat 3: EASYWITHACES folded before Flop (didn't bet)
Seat 4: devi7 folded before Flop (didn't bet)
Seat 5: Lucifer999 collected ($160.08)
Seat 6: spidy02 (button) folded before Flop (didn't bet)



PokerStars Game #00327540786: Hold'em No Limit ($50/$100 USD) - 2022/04/30 10:49:41 ET
Table 'Hold'em (Min 25KMax 10K)    69' 6-max Seat #6 is the button
Seat 1: Lucifer999 ($18860.21 in chips) 
Seat 2: anshu86 ($9900 in chips) 
Seat 5: tabby20 ($31283.68 in chips) 
Seat 6: manny007 ($4423.4 in chips) 
Lucifer999: posts small blind $50
anshu86: posts big blind $100
*** HOLE CARDS ***
Dealt to Lucifer999 [4c 7d]
tabby20: folds
manny007: calls $100
Lucifer999: folds
anshu86: raises $187.50 to $287.5
manny007: calls $187.5
*** FLOP *** [Qd 9s 6c]
anshu86: bets $298.75
manny007: folds
Uncalled bet ($298.75) returned to anshu86
anshu86: doesn't show hand
anshu86 collected $597.5 from pot
*** SUMMARY ***
Total pot $625.00 | Rake $27.5
Board [Qd 9s 6c]
Seat 1: Lucifer999 (small blind) folded before Flop
Seat 2: anshu86 (big blind) collected ($597.5)
Seat 5: tabby20 folded before Flop (didn't bet)
Seat 6: manny007 (button) folded on the Flop



PokerStars Game #00327540726: Hold'em No Limit ($10/$25 USD) - 2022/04/30 10:49:19 ET
Table 'Hold'em (Min 500Max 2500)  1282' 6-max Seat #2 is the button
Seat 1: foldmybets ($1374.93 in chips) 
Seat 2: jaykam ($324.03 in chips) 
Seat 3: Mastkalandar ($2247.05 in chips) 
Seat 4: papadickkies ($1056.43 in chips) 
Seat 5: Lucifer999 ($9567.45 in chips) 
Seat 6: devi7 ($2500 in chips) 
Mastkalandar: posts small blind $10
papadickkies: posts big blind $25
*** HOLE CARDS ***
Dealt to Lucifer999 [9d 6c]
Lucifer999: folds
devi7: folds
foldmybets: folds
jaykam: calls $25
Mastkalandar: calls $15
papadickkies: checks
*** FLOP *** [Qc Kh 9c]
Mastkalandar: checks
papadickkies: checks
jaykam: checks
*** TURN *** [Qc Kh 9c] [4h]
Mastkalandar: checks
papadickkies: bets $35.53
jaykam: folds
Mastkalandar: folds
Uncalled bet ($35.53) returned to papadickkies
papadickkies: doesn't show hand
papadickkies collected $71.07 from pot
*** SUMMARY ***
Total pot $75.00 | Rake $3.93
Board [Qc Kh 9c 4h]
Seat 1: foldmybets folded before Flop (didn't bet)
Seat 2: jaykam (button) folded on the Turn
Seat 3: Mastkalandar (small blind) folded on the Turn
Seat 4: papadickkies (big blind) collected ($71.07)
Seat 5: Lucifer999 folded before Flop (didn't bet)
Seat 6: devi7 folded before Flop (didn't bet)



PokerStars Game #00327540842: Hold'em No Limit ($25/$50 USD) - 2022/04/30 10:50:02 ET
Table 'Hold'em (Min 1K Max 5K)   216' 6-max Seat #2 is the button
Seat 1: Lucifer999 ($10336.64 in chips) 
Seat 2: rahulh1 ($1306.27 in chips) 
Seat 3: Avaroni ($6686.5 in chips) 
Seat 4: No username ($4900.8 in chips) 
Seat 5: BIG DADDY__ ($1331.5 in chips) 
Seat 6: anshu86 ($5167.95 in chips) 
Avaroni: posts small blind $25
No username: posts big blind $50
*** HOLE CARDS ***
Dealt to Lucifer999 [Kd 6s]
BIG DADDY__: folds
anshu86: folds
Lucifer999: folds
rahulh1: folds
Avaroni: folds
Uncalled bet ($25) returned to No username
No username: doesn't show hand
No username collected $50 from pot
*** SUMMARY ***
Total pot $50.00 | Rake $0
Board []
Seat 1: Lucifer999 folded before Flop (didn't bet)
Seat 2: rahulh1 (button) folded before Flop (didn't bet)
Seat 3: Avaroni (small blind) folded before Flop
Seat 4: No username (big blind) collected ($50)
Seat 5: BIG DADDY__ folded before Flop (didn't bet)
Seat 6: anshu86 folded before Flop (didn't bet)



PokerStars Game #00327540883: Hold'em No Limit ($50/$100 USD) - 2022/04/30 10:50:15 ET
Table 'Hold'em (Min 25KMax 10K)    69' 6-max Seat #1 is the button
Seat 1: Lucifer999 ($18810.21 in chips) 
Seat 2: anshu86 ($10210 in chips) 
Seat 5: tabby20 ($31283.68 in chips) 
Seat 6: manny007 ($4135.9 in chips) 
anshu86: posts small blind $50
tabby20: posts big blind $100
*** HOLE CARDS ***
Dealt to Lucifer999 [Qh Ah]
manny007: folds
Lucifer999: raises $200.00 to $300
anshu86: folds
tabby20: folds
Uncalled bet ($200) returned to Lucifer999
Lucifer999: doesn't show hand
Lucifer999 collected $250 from pot
*** SUMMARY ***
Total pot $250.00 | Rake $0
Board []
Seat 1: Lucifer999 (button) collected ($250)
Seat 2: anshu86 (small blind) folded before Flop
Seat 5: tabby20 (big blind) folded before Flop
Seat 6: manny007 folded before Flop (didn't bet)



PokerStars Game #00327540923: Hold'em No Limit ($25/$50 USD) - 2022/04/30 10:50:29 ET
Table 'Hold'em (Min 1K Max 5K)   216' 6-max Seat #3 is the button
Seat 1: Lucifer999 ($10336.64 in chips) 
Seat 2: rahulh1 ($1306.27 in chips) 
Seat 3: Avaroni ($6661.5 in chips) 
Seat 4: No username ($4925.8 in chips) 
Seat 5: BIG DADDY__ ($1331.5 in chips) 
Seat 6: anshu86 ($5167.95 in chips) 
No username: posts small blind $25
BIG DADDY__: posts big blind $50
*** HOLE CARDS ***
Dealt to Lucifer999 [6d 9c]
anshu86: folds
Lucifer999: folds
rahulh1: raises $1256.27 to $1306.27
Avaroni: folds
No username: folds
BIG DADDY__: folds
Uncalled bet ($1256.27) returned to rahulh1
rahulh1: doesn't show hand
rahulh1 collected $125 from pot
*** SUMMARY ***
Total pot $125.00 | Rake $0
Board []
Seat 1: Lucifer999 folded before Flop (didn't bet)
Seat 2: rahulh1 collected ($125)
Seat 3: Avaroni (button) folded before Flop (didn't bet)
Seat 4: No username (small blind) folded before Flop
Seat 5: BIG DADDY__ (big blind) folded before Flop
Seat 6: anshu86 folded before Flop (didn't bet)



PokerStars Game #00327540953: Hold'em No Limit ($50/$100 USD) - 2022/04/30 10:50:42 ET
Table 'Hold'em (Min 25KMax 10K)    69' 6-max Seat #2 is the button
Seat 1: Lucifer999 ($18960.21 in chips) 
Seat 2: anshu86 ($10160 in chips) 
Seat 5: tabby20 ($31183.68 in chips) 
Seat 6: manny007 ($4135.9 in chips) 
tabby20: posts small blind $50
manny007: posts big blind $100
*** HOLE CARDS ***
Dealt to Lucifer999 [Js 7d]
Lucifer999: folds
anshu86: folds
tabby20: folds
Uncalled bet ($50) returned to manny007
manny007: doesn't show hand
manny007 collected $100 from pot
*** SUMMARY ***
Total pot $100.00 | Rake $0
Board []
Seat 1: Lucifer999 folded before Flop (didn't bet)
Seat 2: anshu86 (button) folded before Flop (didn't bet)
Seat 5: tabby20 (small blind) folded before Flop
Seat 6: manny007 (big blind) collected ($100)



PokerStars Game #00327540862: Hold'em No Limit ($10/$25 USD) - 2022/04/30 10:50:07 ET
Table 'Hold'em (Min 500Max 2500) 1001' 6-max Seat #1 is the button
Seat 1: JaspritBumrah786 ($2573.72 in chips) 
Seat 2: fishfry123 ($2031.39 in chips) 
Seat 3: EASYWITHACES ($2359.94 in chips) 
Seat 4: devi7 ($2637.18 in chips) 
Seat 5: Lucifer999 ($4190.01 in chips) 
Seat 6: spidy02 ($4058.39 in chips) 
fishfry123: posts small blind $10
EASYWITHACES: posts big blind $25
*** HOLE CARDS ***
Dealt to Lucifer999 [9s 6s]
devi7: folds
Lucifer999: folds
spidy02: raises $38.75 to $63.75
JaspritBumrah786: calls $63.75
fishfry123: folds
EASYWITHACES: folds
*** FLOP *** [Qd 6h 6c]
spidy02: bets $76.5
JaspritBumrah786: calls $76.5
*** TURN *** [Qd 6h 6c] [As]
spidy02: checks
JaspritBumrah786: checks
*** RIVER *** [Qd 6h 6c As] [Kc]
spidy02: checks
JaspritBumrah786: bets $200
spidy02: folds
Uncalled bet ($200) returned to JaspritBumrah786
JaspritBumrah786: doesn't show hand
JaspritBumrah786 collected $295.97 from pot
*** SUMMARY ***
Total pot $315.50 | Rake $19.53
Board [Qd 6h 6c As Kc]
Seat 1: JaspritBumrah786 (button) collected ($295.97)
Seat 2: fishfry123 (small blind) folded before Flop
Seat 3: EASYWITHACES (big blind) folded before Flop
Seat 4: devi7 folded before Flop (didn't bet)
Seat 5: Lucifer999 folded before Flop (didn't bet)
Seat 6: spidy02 folded on the River



PokerStars Game #00327540888: Hold'em No Limit ($10/$25 USD) - 2022/04/30 10:50:18 ET
Table 'Hold'em (Min 500Max 2500)  1282' 6-max Seat #3 is the button
Seat 1: foldmybets ($1500 in chips) 
Seat 2: jaykam ($299.03 in chips) 
Seat 3: Mastkalandar ($2222.05 in chips) 
Seat 4: papadickkies ($1102.5 in chips) 
Seat 5: Lucifer999 ($9567.45 in chips) 
Seat 6: devi7 ($2500 in chips) 
papadickkies: posts small blind $10
Lucifer999: posts big blind $25
*** HOLE CARDS ***
Dealt to Lucifer999 [Jd Ad]
devi7: folds
foldmybets: folds
jaykam: folds
Mastkalandar: folds
papadickkies: raises $35.00 to $60
Lucifer999: calls $35
*** FLOP *** [7d 3d Ts]
papadickkies: checks
Lucifer999: bets $80
papadickkies: folds
Uncalled bet ($80) returned to Lucifer999
Lucifer999: doesn't show hand
Lucifer999 collected $112.7 from pot
*** SUMMARY ***
Total pot $120.00 | Rake $7.3
Board [7d 3d Ts]
Seat 1: foldmybets folded before Flop (didn't bet)
Seat 2: jaykam folded before Flop (didn't bet)
Seat 3: Mastkalandar (button) folded before Flop (didn't bet)
Seat 4: papadickkies (small blind) folded on the Flop
Seat 5: Lucifer999 (big blind) collected ($112.7)
Seat 6: devi7 folded before Flop (didn't bet)



PokerStars Game #00327541031: Hold'em No Limit ($10/$25 USD) - 2022/04/30 10:51:09 ET
Table 'Hold'em (Min 500Max 2500) 1001' 6-max Seat #2 is the button
Seat 1: JaspritBumrah786 ($2729.44 in chips) 
Seat 2: fishfry123 ($2021.39 in chips) 
Seat 3: EASYWITHACES ($2334.94 in chips) 
Seat 4: devi7 ($2637.18 in chips) 
Seat 5: Lucifer999 ($4190.01 in chips) 
Seat 6: spidy02 ($3918.14 in chips) 
EASYWITHACES: posts small blind $10
devi7: posts big blind $25
*** HOLE CARDS ***
Dealt to Lucifer999 [Qh 3h]
Lucifer999: folds
spidy02: folds
JaspritBumrah786: folds
fishfry123: folds
EASYWITHACES: folds
Uncalled bet ($15) returned to devi7
devi7: doesn't show hand
devi7 collected $20 from pot
*** SUMMARY ***
Total pot $20.00 | Rake $0
Board []
Seat 1: JaspritBumrah786 folded before Flop (didn't bet)
Seat 2: fishfry123 (button) folded before Flop (didn't bet)
Seat 3: EASYWITHACES (small blind) folded before Flop
Seat 4: devi7 (big blind) collected ($20)
Seat 5: Lucifer999 folded before Flop (didn't bet)
Seat 6: spidy02 folded before Flop (didn't bet)



PokerStars Game #00327541009: Hold'em No Limit ($50/$100 USD) - 2022/04/30 10:51:00 ET
Table 'Hold'em (Min 25KMax 10K)    69' 6-max Seat #5 is the button
Seat 1: Lucifer999 ($18960.21 in chips) 
Seat 2: anshu86 ($10160 in chips) 
Seat 5: tabby20 ($31133.68 in chips) 
Seat 6: manny007 ($4185.9 in chips) 
manny007: posts small blind $50
Lucifer999: posts big blind $100
*** HOLE CARDS ***
Dealt to Lucifer999 [Ad Tc]
anshu86: folds
tabby20: folds
manny007: calls $50
Lucifer999: raises $250.00 to $350
manny007: folds
Uncalled bet ($250) returned to Lucifer999
Lucifer999: doesn't show hand
Lucifer999 collected $200 from pot
*** SUMMARY ***
Total pot $200.00 | Rake $0
Board []
Seat 1: Lucifer999 (big blind) collected ($200)
Seat 2: anshu86 folded before Flop (didn't bet)
Seat 5: tabby20 (button) folded before Flop (didn't bet)
Seat 6: manny007 (small blind) folded before Flop



PokerStars Game #00327541049: Hold'em No Limit ($10/$25 USD) - 2022/04/30 10:51:15 ET
Table 'Hold'em (Min 500Max 2500)  1282' 6-max Seat #4 is the button
Seat 1: foldmybets ($1500 in chips) 
Seat 2: jaykam ($299.03 in chips) 
Seat 3: Mastkalandar ($2222.05 in chips) 
Seat 4: papadickkies ($1042.5 in chips) 
Seat 5: Lucifer999 ($9620.15 in chips) 
Seat 6: devi7 ($2500 in chips) 
Lucifer999: posts small blind $10
devi7: posts big blind $25
*** HOLE CARDS ***
Dealt to Lucifer999 [Ad 7c]
foldmybets: folds
jaykam: folds
Mastkalandar: folds
papadickkies: folds
Lucifer999: raises $55.00 to $80
devi7: calls $55
*** FLOP *** [2d 8h Js]
Lucifer999: checks
devi7: checks
*** TURN *** [2d 8h Js] [Qh]
Lucifer999: checks
devi7: bets $99.4
Lucifer999: folds
Uncalled bet ($99.4) returned to devi7
devi7: doesn't show hand
devi7 collected $150.6 from pot
*** SUMMARY ***
Total pot $160.00 | Rake $9.4
Board [2d 8h Js Qh]
Seat 1: foldmybets folded before Flop (didn't bet)
Seat 2: jaykam folded before Flop (didn't bet)
Seat 3: Mastkalandar folded before Flop (didn't bet)
Seat 4: papadickkies (button) folded before Flop (didn't bet)
Seat 5: Lucifer999 (small blind) folded on the Turn
Seat 6: devi7 (big blind) collected ($150.6)



PokerStars Game #00327541001: Hold'em No Limit ($25/$50 USD) - 2022/04/30 10:50:58 ET
Table 'Hold'em (Min 1K Max 5K)   216' 6-max Seat #4 is the button
Seat 1: Lucifer999 ($10336.64 in chips) 
Seat 2: rahulh1 ($1381.27 in chips) 
Seat 3: Avaroni ($6661.5 in chips) 
Seat 4: No username ($4900.8 in chips) 
Seat 5: BIG DADDY__ ($1281.5 in chips) 
Seat 6: anshu86 ($5167.95 in chips) 
BIG DADDY__: posts small blind $25
anshu86: posts big blind $50
*** HOLE CARDS ***
Dealt to Lucifer999 [Kd 7d]
Lucifer999: folds
rahulh1: folds
Avaroni: folds
No username: raises $125.00 to $175
BIG DADDY__: calls $150
anshu86: calls $125
*** FLOP *** [Qd 7s 7h]
BIG DADDY__: checks
anshu86: checks
No username: checks
*** TURN *** [Qd 7s 7h] [8d]
BIG DADDY__: checks
anshu86: bets $206.48
No username: calls $206.48
BIG DADDY__: calls $206.48
*** RIVER *** [Qd 7s 7h 8d] [Jh]
BIG DADDY__: bets $543.62
anshu86: calls $543.62
No username: folds
*** SHOW DOWN ***
BIG DADDY__: shows [Th 9h] (Straight, Q-8)
anshu86: doesn't show hand
BIG DADDY__ collected $2120.13 from pot
*** SUMMARY ***
Total pot $2231.68 | Rake $111.55
Board [Qd 7s 7h 8d Jh]
Seat 1: Lucifer999 folded before Flop (didn't bet)
Seat 2: rahulh1 folded before Flop (didn't bet)
Seat 3: Avaroni folded before Flop (didn't bet)
Seat 4: No username (button) folded on the River
Seat 5: BIG DADDY__  (small blind) showed [Th 9h] and won ($2120.13) with Straight, Q-8
Seat 6: anshu86 (big blind) mucked



PokerStars Game #00327541182: Hold'em No Limit ($10/$25 USD) - 2022/04/30 10:52:00 ET
Table 'Hold'em (Min 500Max 2500)  1282' 6-max Seat #5 is the button
Seat 1: foldmybets ($1500 in chips) 
Seat 2: jaykam ($299.03 in chips) 
Seat 3: Mastkalandar ($2222.05 in chips) 
Seat 4: papadickkies ($1042.5 in chips) 
Seat 5: Lucifer999 ($9540.15 in chips) 
Seat 6: devi7 ($2570.6 in chips) 
devi7: posts small blind $10
jaykam: posts big blind $25
*** HOLE CARDS ***
Dealt to Lucifer999 [7d 5s]
Mastkalandar: folds
papadickkies: folds
Lucifer999: folds
devi7: folds
Uncalled bet ($15) returned to jaykam
jaykam: doesn't show hand
jaykam collected $20 from pot
*** SUMMARY ***
Total pot $20.00 | Rake $0
Board []
Seat 2: jaykam (big blind) collected ($20)
Seat 3: Mastkalandar folded before Flop (didn't bet)
Seat 4: papadickkies folded before Flop (didn't bet)
Seat 5: Lucifer999 (button) folded before Flop (didn't bet)
Seat 6: devi7 (small blind) folded before Flop



PokerStars Game #00327541113: Hold'em No Limit ($10/$25 USD) - 2022/04/30 10:51:37 ET
Table 'Hold'em (Min 500Max 2500) 1001' 6-max Seat #3 is the button
Seat 1: JaspritBumrah786 ($2729.44 in chips) 
Seat 2: fishfry123 ($2021.39 in chips) 
Seat 3: EASYWITHACES ($2324.94 in chips) 
Seat 4: devi7 ($2647.18 in chips) 
Seat 5: Lucifer999 ($4190.01 in chips) 
Seat 6: spidy02 ($3918.14 in chips) 
devi7: posts small blind $10
Lucifer999: posts big blind $25
*** HOLE CARDS ***
Dealt to Lucifer999 [8s Th]
spidy02: folds
JaspritBumrah786: folds
fishfry123: folds
EASYWITHACES: calls $25
devi7: calls $15
Lucifer999: checks
*** FLOP *** [5d Td 2d]
devi7: checks
Lucifer999: bets $80
EASYWITHACES: folds
devi7: raises $125.31 to $205.31
Lucifer999: folds
Uncalled bet ($125.31) returned to devi7
devi7: doesn't show hand
devi7 collected $220.67 from pot
*** SUMMARY ***
Total pot $235.00 | Rake $14.33
Board [5d Td 2d]
Seat 1: JaspritBumrah786 folded before Flop (didn't bet)
Seat 2: fishfry123 folded before Flop (didn't bet)
Seat 3: EASYWITHACES (button) folded on the Flop
Seat 4: devi7 (small blind) collected ($220.67)
Seat 5: Lucifer999 (big blind) folded on the Flop
Seat 6: spidy02 folded before Flop (didn't bet)



PokerStars Game #00327541129: Hold'em No Limit ($50/$100 USD) - 2022/04/30 10:51:43 ET
Table 'Hold'em (Min 25KMax 10K)    69' 6-max Seat #6 is the button
Seat 1: Lucifer999 ($19060.21 in chips) 
Seat 2: anshu86 ($10160 in chips) 
Seat 5: tabby20 ($31133.68 in chips) 
Seat 6: manny007 ($4085.9 in chips) 
Lucifer999: posts small blind $50
anshu86: posts big blind $100
*** HOLE CARDS ***
Dealt to Lucifer999 [9d Qc]
tabby20: folds
manny007: folds
Lucifer999: raises $200.00 to $300
anshu86: calls $200
*** FLOP *** [8c Kc 4s]
Lucifer999: bets $450
anshu86: calls $450
*** TURN *** [8c Kc 4s] [Jc]
Lucifer999: bets $1000
anshu86: calls $1000
*** RIVER *** [8c Kc 4s Jc] [Tc]
Lucifer999: checks
anshu86: checks
*** SHOW DOWN ***
Lucifer999: shows [9d Qc] (Flush, K high)
anshu86: doesn't show hand
Lucifer999 collected $3346 from pot
*** SUMMARY ***
Total pot $3500.00 | Rake $154
Board [8c Kc 4s Jc Tc]
Seat 1: Lucifer999  (small blind) showed [9d Qc] and won ($3346) with Flush, K high
Seat 2: anshu86 (big blind) mucked
Seat 5: tabby20 folded before Flop (didn't bet)
Seat 6: manny007 (button) folded before Flop (didn't bet)



PokerStars Game #00327541207: Hold'em No Limit ($25/$50 USD) - 2022/04/30 10:52:09 ET
Table 'Hold'em (Min 1K Max 5K)   216' 6-max Seat #5 is the button
Seat 1: Lucifer999 ($10336.64 in chips) 
Seat 2: rahulh1 ($1381.27 in chips) 
Seat 3: Avaroni ($6661.5 in chips) 
Seat 4: No username ($4519.32 in chips) 
Seat 5: BIG DADDY__ ($2476.53 in chips) 
Seat 6: anshu86 ($4242.85 in chips) 
anshu86: posts small blind $25
Lucifer999: posts big blind $50
*** HOLE CARDS ***
Dealt to Lucifer999 [4c 3c]
rahulh1: folds
Avaroni: folds
No username: raises $81.25 to $131.25
BIG DADDY__: folds
anshu86: folds
Lucifer999: calls $81.25
*** FLOP *** [2h 7d 2c]
Lucifer999: checks
No username: bets $204.86
Lucifer999: folds
Uncalled bet ($204.86) returned to No username
No username: doesn't show hand
No username collected $273.15 from pot
*** SUMMARY ***
Total pot $287.50 | Rake $14.35
Board [2h 7d 2c]
Seat 1: Lucifer999 (big blind) folded on the Flop
Seat 2: rahulh1 folded before Flop (didn't bet)
Seat 3: Avaroni folded before Flop (didn't bet)
Seat 4: No username collected ($273.15)
Seat 5: BIG DADDY__ (button) folded before Flop (didn't bet)
Seat 6: anshu86 (small blind) folded before Flop



PokerStars Game #00327541248: Hold'em No Limit ($10/$25 USD) - 2022/04/30 10:52:23 ET
Table 'Hold'em (Min 500Max 2500)  1282' 6-max Seat #6 is the button
Seat 2: jaykam ($309.03 in chips) 
Seat 3: Mastkalandar ($2222.05 in chips) 
Seat 4: papadickkies ($1042.5 in chips) 
Seat 5: Lucifer999 ($9540.15 in chips) 
Seat 6: devi7 ($2560.6 in chips) 
jaykam: posts small blind $10
Mastkalandar: posts big blind $25
*** HOLE CARDS ***
Dealt to Lucifer999 [Jd 6d]
papadickkies: folds
Lucifer999: folds
devi7: raises $50.00 to $75
jaykam: folds
Mastkalandar: calls $50
*** FLOP *** [9h 9s 8c]
Mastkalandar: checks
devi7: bets $99.4
Mastkalandar: folds
Uncalled bet ($99.4) returned to devi7
devi7: doesn't show hand
devi7 collected $150.6 from pot
*** SUMMARY ***
Total pot $160.00 | Rake $9.4
Board [9h 9s 8c]
Seat 2: jaykam (small blind) folded before Flop
Seat 3: Mastkalandar (big blind) folded on the Flop
Seat 4: papadickkies folded before Flop (didn't bet)
Seat 5: Lucifer999 folded before Flop (didn't bet)
Seat 6: devi7 (button) collected ($150.6)



PokerStars Game #00327541302: Hold'em No Limit ($10/$25 USD) - 2022/04/30 10:52:41 ET
Table 'Hold'em (Min 500Max 2500) 1001' 6-max Seat #4 is the button
Seat 1: JaspritBumrah786 ($2729.44 in chips) 
Seat 2: fishfry123 ($2021.39 in chips) 
Seat 3: EASYWITHACES ($2299.94 in chips) 
Seat 4: devi7 ($2762.85 in chips) 
Seat 5: Lucifer999 ($4085.01 in chips) 
Seat 6: spidy02 ($3918.14 in chips) 
Lucifer999: posts small blind $10
spidy02: posts big blind $25
*** HOLE CARDS ***
Dealt to Lucifer999 [Ks Jd]
JaspritBumrah786: folds
fishfry123: folds
EASYWITHACES: folds
devi7: folds
Lucifer999: raises $55.00 to $80
spidy02: folds
Uncalled bet ($55) returned to Lucifer999
Lucifer999: doesn't show hand
Lucifer999 collected $50 from pot
*** SUMMARY ***
Total pot $50.00 | Rake $0
Board []
Seat 1: JaspritBumrah786 folded before Flop (didn't bet)
Seat 2: fishfry123 folded before Flop (didn't bet)
Seat 3: EASYWITHACES folded before Flop (didn't bet)
Seat 4: devi7 (button) folded before Flop (didn't bet)
Seat 5: Lucifer999 (small blind) collected ($50)
Seat 6: spidy02 (big blind) folded before Flop



PokerStars Game #00327541343: Hold'em No Limit ($25/$50 USD) - 2022/04/30 10:52:55 ET
Table 'Hold'em (Min 1K Max 5K)   216' 6-max Seat #6 is the button
Seat 1: Lucifer999 ($10205.39 in chips) 
Seat 2: rahulh1 ($1381.27 in chips) 
Seat 3: Avaroni ($6661.5 in chips) 
Seat 4: No username ($4661.22 in chips) 
Seat 5: BIG DADDY__ ($2476.53 in chips) 
Seat 6: anshu86 ($4217.85 in chips) 
Lucifer999: posts small blind $25
rahulh1: posts big blind $50
*** HOLE CARDS ***
Dealt to Lucifer999 [Th Js]
Avaroni: folds
No username: raises $81.25 to $131.25
BIG DADDY__: folds
anshu86: folds
Lucifer999: folds
rahulh1: calls $81.25
*** FLOP *** [Kd Ac 7h]
rahulh1: checks
No username: bets $136.57
rahulh1: folds
Uncalled bet ($136.57) returned to No username
No username: doesn't show hand
No username collected $273.15 from pot
*** SUMMARY ***
Total pot $287.50 | Rake $14.35
Board [Kd Ac 7h]
Seat 1: Lucifer999 (small blind) folded before Flop
Seat 2: rahulh1 (big blind) folded on the Flop
Seat 3: Avaroni folded before Flop (didn't bet)
Seat 4: No username collected ($273.15)
Seat 5: BIG DADDY__ folded before Flop (didn't bet)
Seat 6: anshu86 (button) folded before Flop (didn't bet)



PokerStars Game #00327541309: Hold'em No Limit ($50/$100 USD) - 2022/04/30 10:52:42 ET
Table 'Hold'em (Min 25KMax 10K)    69' 6-max Seat #1 is the button
Seat 1: Lucifer999 ($20656.21 in chips) 
Seat 2: anshu86 ($8410 in chips) 
Seat 5: tabby20 ($31133.68 in chips) 
Seat 6: manny007 ($4085.9 in chips) 
anshu86: posts small blind $50
tabby20: posts big blind $100
*** HOLE CARDS ***
Dealt to Lucifer999 [Jd Ah]
manny007: folds
Lucifer999: folds
anshu86: raises $137.50 to $237.5
tabby20: calls $137.5
*** FLOP *** [9h 4d Kc]
anshu86: bets $227.05
tabby20: calls $227.05
*** TURN *** [9h 4d Kc] [Jh]
anshu86: bets $444.12
tabby20: raises $855.88 to $1300
anshu86: calls $855.88
*** RIVER *** [9h 4d Kc Jh] [As]
anshu86: bets $3373.83
tabby20: folds
Uncalled bet ($3373.83) returned to anshu86
anshu86: doesn't show hand
anshu86 collected $3373.83 from pot
*** SUMMARY ***
Total pot $3529.10 | Rake $155.27
Board [9h 4d Kc Jh As]
Seat 1: Lucifer999 (button) folded before Flop (didn't bet)
Seat 2: anshu86 (small blind) collected ($3373.83)
Seat 5: tabby20 (big blind) folded on the River
Seat 6: manny007 folded before Flop (didn't bet)



PokerStars Game #00327541434: Hold'em No Limit ($10/$25 USD) - 2022/04/30 10:53:27 ET
Table 'Hold'em (Min 500Max 2500) 1001' 6-max Seat #5 is the button
Seat 1: JaspritBumrah786 ($2729.44 in chips) 
Seat 2: fishfry123 ($2021.39 in chips) 
Seat 3: EASYWITHACES ($2299.94 in chips) 
Seat 4: devi7 ($2762.85 in chips) 
Seat 5: Lucifer999 ($4110.01 in chips) 
Seat 6: spidy02 ($3893.14 in chips) 
spidy02: posts small blind $10
JaspritBumrah786: posts big blind $25
*** HOLE CARDS ***
Dealt to Lucifer999 [3c 5c]
fishfry123: folds
EASYWITHACES: folds
devi7: folds
Lucifer999: raises $55.00 to $80
spidy02: folds
JaspritBumrah786: folds
Uncalled bet ($55) returned to Lucifer999
Lucifer999: doesn't show hand
Lucifer999 collected $60 from pot
*** SUMMARY ***
Total pot $60.00 | Rake $0
Board []
Seat 1: JaspritBumrah786 (big blind) folded before Flop
Seat 2: fishfry123 folded before Flop (didn't bet)
Seat 3: EASYWITHACES folded before Flop (didn't bet)
Seat 4: devi7 folded before Flop (didn't bet)
Seat 5: Lucifer999 (button) collected ($60)
Seat 6: spidy02 (small blind) folded before Flop



PokerStars Game #00327541368: Hold'em No Limit ($10/$25 USD) - 2022/04/30 10:53:03 ET
Table 'Hold'em (Min 500Max 2500)  1282' 6-max Seat #2 is the button
Seat 2: jaykam ($299.03 in chips) 
Seat 3: Mastkalandar ($2147.05 in chips) 
Seat 4: papadickkies ($1042.5 in chips) 
Seat 5: Lucifer999 ($9540.15 in chips) 
Seat 6: devi7 ($2636.2 in chips) 
Mastkalandar: posts small blind $10
papadickkies: posts big blind $25
*** HOLE CARDS ***
Dealt to Lucifer999 [9c 9h]
Lucifer999: raises $55.00 to $80
devi7: folds
jaykam: folds
Mastkalandar: folds
papadickkies: calls $55
*** FLOP *** [6h 6s 3c]
papadickkies: checks
Lucifer999: bets $100
papadickkies: folds
Uncalled bet ($100) returned to Lucifer999
Lucifer999: doesn't show hand
Lucifer999 collected $160.08 from pot
*** SUMMARY ***
Total pot $170.00 | Rake $9.92
Board [6h 6s 3c]
Seat 2: jaykam (button) folded before Flop (didn't bet)
Seat 3: Mastkalandar (small blind) folded before Flop
Seat 4: papadickkies (big blind) folded on the Flop
Seat 5: Lucifer999 collected ($160.08)
Seat 6: devi7 folded before Flop (didn't bet)



PokerStars Game #00327541463: Hold'em No Limit ($25/$50 USD) - 2022/04/30 10:53:38 ET
Table 'Hold'em (Min 1K Max 5K)   216' 6-max Seat #1 is the button
Seat 1: Lucifer999 ($10180.39 in chips) 
Seat 2: rahulh1 ($1250.02 in chips) 
Seat 3: Avaroni ($6661.5 in chips) 
Seat 4: No username ($4803.12 in chips) 
Seat 5: BIG DADDY__ ($2476.53 in chips) 
Seat 6: anshu86 ($4217.85 in chips) 
rahulh1: posts small blind $25
Avaroni: posts big blind $50
*** HOLE CARDS ***
Dealt to Lucifer999 [Ah 6d]
No username: folds
BIG DADDY__: raises $75.00 to $125
anshu86: folds
Lucifer999: calls $125
rahulh1: folds
Avaroni: raises $6536.50 to $6661.5
BIG DADDY__: folds
Lucifer999: folds
Uncalled bet ($6536.5) returned to Avaroni
Avaroni: doesn't show hand
Avaroni collected $400 from pot
*** SUMMARY ***
Total pot $400.00 | Rake $0
Board []
Seat 1: Lucifer999 (button) folded before Flop
Seat 2: rahulh1 (small blind) folded before Flop
Seat 3: Avaroni (big blind) collected ($400)
Seat 4: No username folded before Flop (didn't bet)
Seat 5: BIG DADDY__ folded before Flop
Seat 6: anshu86 folded before Flop (didn't bet)



PokerStars Game #00327541532: Hold'em No Limit ($10/$25 USD) - 2022/04/30 10:54:00 ET
Table 'Hold'em (Min 500Max 2500) 1001' 6-max Seat #6 is the button
Seat 1: JaspritBumrah786 ($2704.44 in chips) 
Seat 2: fishfry123 ($2021.39 in chips) 
Seat 3: EASYWITHACES ($2299.94 in chips) 
Seat 4: devi7 ($2762.85 in chips) 
Seat 5: Lucifer999 ($4145.01 in chips) 
Seat 6: spidy02 ($3883.14 in chips) 
JaspritBumrah786: posts small blind $10
fishfry123: posts big blind $25
*** HOLE CARDS ***
Dealt to Lucifer999 [Ks 5h]
EASYWITHACES: folds
devi7: folds
Lucifer999: folds
spidy02: folds
JaspritBumrah786: raises $50.00 to $75
fishfry123: folds
Uncalled bet ($50) returned to JaspritBumrah786
JaspritBumrah786: doesn't show hand
JaspritBumrah786 collected $50 from pot
*** SUMMARY ***
Total pot $50.00 | Rake $0
Board []
Seat 1: JaspritBumrah786 (small blind) collected ($50)
Seat 2: fishfry123 (big blind) folded before Flop
Seat 3: EASYWITHACES folded before Flop (didn't bet)
Seat 4: devi7 folded before Flop (didn't bet)
Seat 5: Lucifer999 folded before Flop (didn't bet)
Seat 6: spidy02 (button) folded before Flop (didn't bet)



PokerStars Game #00327541504: Hold'em No Limit ($50/$100 USD) - 2022/04/30 10:53:51 ET
Table 'Hold'em (Min 25KMax 10K)    69' 6-max Seat #2 is the button
Seat 1: Lucifer999 ($20656.21 in chips) 
Seat 2: anshu86 ($10019.28 in chips) 
Seat 5: tabby20 ($29369.13 in chips) 
Seat 6: manny007 ($4085.9 in chips) 
tabby20: posts small blind $50
manny007: posts big blind $100
*** HOLE CARDS ***
Dealt to Lucifer999 [Kc 2c]
Lucifer999: raises $200.00 to $300
anshu86: folds
tabby20: folds
manny007: calls $200
*** FLOP *** [Jh Ts Th]
manny007: bets $274.96
Lucifer999: folds
Uncalled bet ($274.96) returned to manny007
manny007: doesn't show hand
manny007 collected $621.4 from pot
*** SUMMARY ***
Total pot $650.00 | Rake $28.6
Board [Jh Ts Th]
Seat 1: Lucifer999 folded on the Flop
Seat 2: anshu86 (button) folded before Flop (didn't bet)
Seat 5: tabby20 (small blind) folded before Flop
Seat 6: manny007 (big blind) collected ($621.4)



PokerStars Game #00327541614: Hold'em No Limit ($50/$100 USD) - 2022/04/30 10:54:31 ET
Table 'Hold'em (Min 25KMax 10K)    69' 6-max Seat #5 is the button
Seat 1: Lucifer999 ($20356.21 in chips) 
Seat 2: anshu86 ($10019.28 in chips) 
Seat 5: tabby20 ($29319.13 in chips) 
Seat 6: manny007 ($4407.3 in chips) 
manny007: posts small blind $50
Lucifer999: posts big blind $100
*** HOLE CARDS ***
Dealt to Lucifer999 [5h 2h]
anshu86: folds
tabby20: folds
manny007: folds
Uncalled bet ($50) returned to Lucifer999
Lucifer999: doesn't show hand
Lucifer999 collected $100 from pot
*** SUMMARY ***
Total pot $100.00 | Rake $0
Board []
Seat 1: Lucifer999 (big blind) collected ($100)
Seat 2: anshu86 folded before Flop (didn't bet)
Seat 5: tabby20 (button) folded before Flop (didn't bet)
Seat 6: manny007 (small blind) folded before Flop



PokerStars Game #00327541555: Hold'em No Limit ($10/$25 USD) - 2022/04/30 10:54:09 ET
Table 'Hold'em (Min 500Max 2500)  1282' 6-max Seat #3 is the button
Seat 2: jaykam ($299.03 in chips) 
Seat 3: Mastkalandar ($2137.05 in chips) 
Seat 4: papadickkies ($962.5 in chips) 
Seat 5: Lucifer999 ($9620.23 in chips) 
Seat 6: devi7 ($2636.2 in chips) 
papadickkies: posts small blind $10
Lucifer999: posts big blind $25
*** HOLE CARDS ***
Dealt to Lucifer999 [7c 3c]
devi7: folds
jaykam: raises $60.00 to $85
Mastkalandar: folds
papadickkies: folds
Lucifer999: folds
Uncalled bet ($60) returned to jaykam
jaykam: doesn't show hand
jaykam collected $60 from pot
*** SUMMARY ***
Total pot $60.00 | Rake $0
Board []
Seat 2: jaykam collected ($60)
Seat 3: Mastkalandar (button) folded before Flop (didn't bet)
Seat 4: papadickkies (small blind) folded before Flop
Seat 5: Lucifer999 (big blind) folded before Flop
Seat 6: devi7 folded before Flop (didn't bet)



PokerStars Game #00327541587: Hold'em No Limit ($25/$50 USD) - 2022/04/30 10:54:20 ET
Table 'Hold'em (Min 1K Max 5K)   216' 6-max Seat #2 is the button
Seat 1: Lucifer999 ($10055.39 in chips) 
Seat 2: rahulh1 ($1225.02 in chips) 
Seat 3: Avaroni ($6936.5 in chips) 
Seat 4: No username ($4803.12 in chips) 
Seat 5: BIG DADDY__ ($2351.53 in chips) 
Seat 6: anshu86 ($4217.85 in chips) 
Avaroni: posts small blind $25
No username: posts big blind $50
*** HOLE CARDS ***
Dealt to Lucifer999 [Qh 8h]
BIG DADDY__: folds
anshu86: folds
Lucifer999: folds
rahulh1: raises $1175.02 to $1225.02
Avaroni: folds
No username: calls $1175.02
*** FLOP *** [4s Ac Th]
*** FLOP *** [Jc 4h 6c]
*** TURN *** [4s Ac Th] [8c]
*** TURN *** [4s Ac Th] [4c]
*** RIVER *** [4s Ac Th 8c] [Qc]
*** RIVER *** [4s Ac Th 8c] [7h]
*** SHOW DOWN ***
rahulh1: shows [Ts Ah] (Pair, 44)
No username: shows [7s 7c] (Full house, 77744)
rahulh1 collected $1175.65 from pot
No username collected $1175.64 from pot
*** SUMMARY ***
Total pot $2475.04 | Rake $123.75
Board [4s Ac Th 8c Qc]
Seat 1: Lucifer999 folded before Flop (didn't bet)
Seat 2: rahulh1  (button) showed [Ts Ah] and won ($1175.65) with Pair, 44
Seat 3: Avaroni (small blind) folded before Flop
Seat 4: No username  (big blind) showed [7s 7c] and won ($1175.64) with Full house, 77744
Seat 5: BIG DADDY__ folded before Flop (didn't bet)
Seat 6: anshu86 folded before Flop (didn't bet)



PokerStars Game #00327541635: Hold'em No Limit ($50/$100 USD) - 2022/04/30 10:54:41 ET
Table 'Hold'em (Min 25KMax 10K)    69' 6-max Seat #6 is the button
Seat 1: Lucifer999 ($20406.21 in chips) 
Seat 2: anshu86 ($10019.28 in chips) 
Seat 5: tabby20 ($29319.13 in chips) 
Seat 6: manny007 ($4357.3 in chips) 
Lucifer999: posts small blind $50
anshu86: posts big blind $100
*** HOLE CARDS ***
Dealt to Lucifer999 [Ks 2h]
tabby20: folds
manny007: folds
Lucifer999: raises $200.00 to $300
anshu86: folds
Uncalled bet ($200) returned to Lucifer999
Lucifer999: doesn't show hand
Lucifer999 collected $200 from pot
*** SUMMARY ***
Total pot $200.00 | Rake $0
Board []
Seat 1: Lucifer999 (small blind) collected ($200)
Seat 2: anshu86 (big blind) folded before Flop
Seat 5: tabby20 folded before Flop (didn't bet)
Seat 6: manny007 (button) folded before Flop (didn't bet)



PokerStars Game #00327541607: Hold'em No Limit ($10/$25 USD) - 2022/04/30 10:54:29 ET
Table 'Hold'em (Min 500Max 2500) 1001' 6-max Seat #1 is the button
Seat 1: JaspritBumrah786 ($2729.44 in chips) 
Seat 2: fishfry123 ($1996.39 in chips) 
Seat 3: EASYWITHACES ($2299.94 in chips) 
Seat 4: devi7 ($2762.85 in chips) 
Seat 5: Lucifer999 ($4145.01 in chips) 
Seat 6: spidy02 ($3883.14 in chips) 
fishfry123: posts small blind $10
EASYWITHACES: posts big blind $25
*** HOLE CARDS ***
Dealt to Lucifer999 [Ad 2h]
devi7: folds
Lucifer999: folds
spidy02: folds
JaspritBumrah786: folds
fishfry123: raises $33.75 to $58.75
EASYWITHACES: calls $33.75
*** FLOP *** [3c 5h 7h]
fishfry123: checks
EASYWITHACES: checks
*** TURN *** [3c 5h 7h] [2s]
fishfry123: checks
EASYWITHACES: checks
*** RIVER *** [3c 5h 7h 2s] [Js]
fishfry123: checks
EASYWITHACES: bets $55.18
fishfry123: folds
Uncalled bet ($55.18) returned to EASYWITHACES
EASYWITHACES: doesn't show hand
EASYWITHACES collected $110.36 from pot
*** SUMMARY ***
Total pot $117.50 | Rake $7.14
Board [3c 5h 7h 2s Js]
Seat 1: JaspritBumrah786 (button) folded before Flop (didn't bet)
Seat 2: fishfry123 (small blind) folded on the River
Seat 3: EASYWITHACES (big blind) collected ($110.36)
Seat 4: devi7 folded before Flop (didn't bet)
Seat 5: Lucifer999 folded before Flop (didn't bet)
Seat 6: spidy02 folded before Flop (didn't bet)



PokerStars Game #00327541649: Hold'em No Limit ($10/$25 USD) - 2022/04/30 10:54:44 ET
Table 'Hold'em (Min 500Max 2500)  1282' 6-max Seat #4 is the button
Seat 2: jaykam ($334.03 in chips) 
Seat 3: Mastkalandar ($2137.05 in chips) 
Seat 4: papadickkies ($952.5 in chips) 
Seat 5: Lucifer999 ($9595.23 in chips) 
Seat 6: devi7 ($2636.2 in chips) 
Lucifer999: posts small blind $10
devi7: posts big blind $25
*** HOLE CARDS ***
Dealt to Lucifer999 [Tc Kh]
jaykam: calls $25
Mastkalandar: calls $25
papadickkies: folds
Lucifer999: raises $115.00 to $140
devi7: folds
jaykam: calls $115
Mastkalandar: calls $115
*** FLOP *** [Ts 7s Kd]
Lucifer999: checks
jaykam: checks
Mastkalandar: bets $300
Lucifer999: raises $400.00 to $700
jaykam: folds
Mastkalandar: calls $400
*** TURN *** [Ts 7s Kd] [4d]
Lucifer999: bets $1750
Mastkalandar: folds
Uncalled bet ($1750) returned to Lucifer999
Lucifer999: doesn't show hand
Lucifer999 collected $1743.14 from pot
*** SUMMARY ***
Total pot $1845.00 | Rake $101.86
Board [Ts 7s Kd 4d]
Seat 2: jaykam folded on the Flop
Seat 3: Mastkalandar folded on the Turn
Seat 4: papadickkies (button) folded before Flop (didn't bet)
Seat 5: Lucifer999 (small blind) collected ($1743.14)
Seat 6: devi7 (big blind) folded before Flop



PokerStars Game #00327541692: Hold'em No Limit ($25/$50 USD) - 2022/04/30 10:54:59 ET
Table 'Hold'em (Min 1K Max 5K)   216' 6-max Seat #3 is the button
Seat 1: Lucifer999 ($10055.39 in chips) 
Seat 2: rahulh1 ($1175.65 in chips) 
Seat 3: Avaroni ($6911.5 in chips) 
Seat 4: No username ($4753.74 in chips) 
Seat 5: BIG DADDY__ ($2351.53 in chips) 
Seat 6: anshu86 ($4217.85 in chips) 
No username: posts small blind $25
BIG DADDY__: posts big blind $50
*** HOLE CARDS ***
Dealt to Lucifer999 [3s 3c]
anshu86: folds
Lucifer999: raises $100.00 to $150
rahulh1: folds
Avaroni: folds
No username: folds
BIG DADDY__: calls $100
*** FLOP *** [2s Jh 5c]
BIG DADDY__: checks
Lucifer999: checks
*** TURN *** [2s Jh 5c] [Ts]
BIG DADDY__: checks
Lucifer999: checks
*** RIVER *** [2s Jh 5c Ts] [6c]
BIG DADDY__: checks
Lucifer999: checks
*** SHOW DOWN ***
Lucifer999: shows [3s 3c] (Pair, 33)
BIG DADDY__: doesn't show hand
Lucifer999 collected $308.75 from pot
*** SUMMARY ***
Total pot $325.00 | Rake $16.25
Board [2s Jh 5c Ts 6c]
Seat 1: Lucifer999  showed [3s 3c] and won ($308.75) with Pair, 33
Seat 2: rahulh1 folded before Flop (didn't bet)
Seat 3: Avaroni (button) folded before Flop (didn't bet)
Seat 4: No username (small blind) folded before Flop
Seat 5: BIG DADDY__ (big blind) mucked
Seat 6: anshu86 folded before Flop (didn't bet)



PokerStars Game #00327541744: Hold'em No Limit ($10/$25 USD) - 2022/04/30 10:55:19 ET
Table 'Hold'em (Min 500Max 2500) 1001' 6-max Seat #2 is the button
Seat 1: JaspritBumrah786 ($2729.44 in chips) 
Seat 2: fishfry123 ($1937.64 in chips) 
Seat 3: EASYWITHACES ($2351.55 in chips) 
Seat 4: devi7 ($2762.85 in chips) 
Seat 5: Lucifer999 ($4145.01 in chips) 
Seat 6: spidy02 ($3883.14 in chips) 
EASYWITHACES: posts small blind $10
devi7: posts big blind $25
*** HOLE CARDS ***
Dealt to Lucifer999 [9h 4h]
Lucifer999: folds
spidy02: folds
JaspritBumrah786: folds
fishfry123: calls $25
EASYWITHACES: folds
devi7: raises $75.00 to $100
fishfry123: folds
Uncalled bet ($75) returned to devi7
devi7: doesn't show hand
devi7 collected $60 from pot
*** SUMMARY ***
Total pot $60.00 | Rake $0
Board []
Seat 1: JaspritBumrah786 folded before Flop (didn't bet)
Seat 2: fishfry123 (button) folded before Flop
Seat 3: EASYWITHACES (small blind) folded before Flop
Seat 4: devi7 (big blind) collected ($60)
Seat 5: Lucifer999 folded before Flop (didn't bet)
Seat 6: spidy02 folded before Flop (didn't bet)



PokerStars Game #00327541718: Hold'em No Limit ($50/$100 USD) - 2022/04/30 10:55:09 ET
Table 'Hold'em (Min 25KMax 10K)    69' 6-max Seat #1 is the button
Seat 1: Lucifer999 ($20506.21 in chips) 
Seat 2: anshu86 ($9919.28 in chips) 
Seat 5: tabby20 ($29319.13 in chips) 
Seat 6: manny007 ($4357.3 in chips) 
anshu86: posts small blind $50
tabby20: posts big blind $100
*** HOLE CARDS ***
Dealt to Lucifer999 [Td 2c]
manny007: raises $250.00 to $350
Lucifer999: folds
anshu86: folds
tabby20: calls $250
*** FLOP *** [6d 3h Qh]
tabby20: checks
manny007: checks
*** TURN *** [6d 3h Qh] [6s]
tabby20: bets $450
manny007: calls $450
*** RIVER *** [6d 3h Qh 6s] [Qc]
tabby20: bets $1577.4
manny007: folds
Uncalled bet ($1577.4) returned to tabby20
tabby20: doesn't show hand
tabby20 collected $1577.4 from pot
*** SUMMARY ***
Total pot $1650.00 | Rake $72.6
Board [6d 3h Qh 6s Qc]
Seat 1: Lucifer999 (button) folded before Flop (didn't bet)
Seat 2: anshu86 (small blind) folded before Flop
Seat 5: tabby20 (big blind) collected ($1577.4)
Seat 6: manny007 folded on the River



PokerStars Game #00327541825: Hold'em No Limit ($10/$25 USD) - 2022/04/30 10:55:57 ET
Table 'Hold'em (Min 500Max 2500) 1001' 6-max Seat #3 is the button
Seat 1: JaspritBumrah786 ($2729.44 in chips) 
Seat 2: fishfry123 ($1912.64 in chips) 
Seat 3: EASYWITHACES ($2341.55 in chips) 
Seat 4: devi7 ($2797.85 in chips) 
Seat 5: Lucifer999 ($4145.01 in chips) 
Seat 6: spidy02 ($3883.14 in chips) 
devi7: posts small blind $10
Lucifer999: posts big blind $25
*** HOLE CARDS ***
Dealt to Lucifer999 [9d Th]
spidy02: folds
JaspritBumrah786: raises $50.00 to $75
fishfry123: folds
EASYWITHACES: folds
devi7: folds
Lucifer999: folds
Uncalled bet ($50) returned to JaspritBumrah786
JaspritBumrah786: doesn't show hand
JaspritBumrah786 collected $60 from pot
*** SUMMARY ***
Total pot $60.00 | Rake $0
Board []
Seat 1: JaspritBumrah786 collected ($60)
Seat 2: fishfry123 folded before Flop (didn't bet)
Seat 3: EASYWITHACES (button) folded before Flop (didn't bet)
Seat 4: devi7 (small blind) folded before Flop
Seat 5: Lucifer999 (big blind) folded before Flop
Seat 6: spidy02 folded before Flop (didn't bet)



PokerStars Game #00327541806: Hold'em No Limit ($25/$50 USD) - 2022/04/30 10:55:50 ET
Table 'Hold'em (Min 1K Max 5K)   216' 6-max Seat #4 is the button
Seat 1: Lucifer999 ($10214.14 in chips) 
Seat 2: rahulh1 ($1175.65 in chips) 
Seat 3: Avaroni ($6911.5 in chips) 
Seat 4: No username ($4728.74 in chips) 
Seat 5: BIG DADDY__ ($2201.53 in chips) 
Seat 6: anshu86 ($4217.85 in chips) 
BIG DADDY__: posts small blind $25
anshu86: posts big blind $50
*** HOLE CARDS ***
Dealt to Lucifer999 [6d 3h]
Lucifer999: folds
rahulh1: folds
Avaroni: folds
No username: folds
BIG DADDY__: raises $75.00 to $125
anshu86: calls $75
*** FLOP *** [3c Ac Jc]
BIG DADDY__: bets $125
anshu86: folds
Uncalled bet ($125) returned to BIG DADDY__
BIG DADDY__: doesn't show hand
BIG DADDY__ collected $237.5 from pot
*** SUMMARY ***
Total pot $250.00 | Rake $12.5
Board [3c Ac Jc]
Seat 1: Lucifer999 folded before Flop (didn't bet)
Seat 2: rahulh1 folded before Flop (didn't bet)
Seat 3: Avaroni folded before Flop (didn't bet)
Seat 4: No username (button) folded before Flop (didn't bet)
Seat 5: BIG DADDY__ (small blind) collected ($237.5)
Seat 6: anshu86 (big blind) folded on the Flop



PokerStars Game #00327541797: Hold'em No Limit ($10/$25 USD) - 2022/04/30 10:55:46 ET
Table 'Hold'em (Min 500Max 2500)  1282' 6-max Seat #5 is the button
Seat 2: jaykam ($194.03 in chips) 
Seat 3: Mastkalandar ($1325 in chips) 
Seat 4: papadickkies ($952.5 in chips) 
Seat 5: Lucifer999 ($10498.37 in chips) 
Seat 6: devi7 ($2611.2 in chips) 
devi7: posts small blind $10
jaykam: posts big blind $25
*** HOLE CARDS ***
Dealt to Lucifer999 [2c 2d]
Mastkalandar: folds
papadickkies: raises $50.00 to $75
Lucifer999: calls $75
devi7: calls $65
jaykam: calls $50
*** FLOP *** [4c 8h 6d]
devi7: checks
jaykam: bets $119.03
papadickkies: calls $119.03
Lucifer999: folds
devi7: folds
*** TURN *** [4c 8h 6d] [Jc]
*** RIVER *** [4c 8h 6d Jc] [Kc]
*** SHOW DOWN ***
jaykam: shows [8c Qh] (Pair, 88)
papadickkies: shows [9c 9d] (Pair, 99)
papadickkies collected $504.82 from pot
*** SUMMARY ***
Total pot $538.06 | Rake $33.24
Board [4c 8h 6d Jc Kc]
Seat 2: jaykam (big blind) showed [8c Qh] and lost with Pair, 88
Seat 3: Mastkalandar folded before Flop (didn't bet)
Seat 4: papadickkies  showed [9c 9d] and won ($504.82) with Pair, 99
Seat 5: Lucifer999 (button) folded on the Flop
Seat 6: devi7 (small blind) folded on the Flop



PokerStars Game #00327541857: Hold'em No Limit ($50/$100 USD) - 2022/04/30 10:56:10 ET
Table 'Hold'em (Min 25KMax 10K)    69' 6-max Seat #2 is the button
Seat 1: Lucifer999 ($20506.21 in chips) 
Seat 2: anshu86 ($9869.28 in chips) 
Seat 5: tabby20 ($30096.53 in chips) 
Seat 6: manny007 ($3557.3 in chips) 
tabby20: posts small blind $50
manny007: posts big blind $100
*** HOLE CARDS ***
Dealt to Lucifer999 [Js 6s]
Lucifer999: folds
anshu86: raises $133.33 to $233.33
tabby20: calls $183.33
manny007: calls $133.33
*** FLOP *** [9c Kh 3c]
tabby20: checks
manny007: checks
anshu86: bets $334.62
tabby20: calls $334.62
manny007: folds
*** TURN *** [9c Kh 3c] [Qs]
tabby20: checks
anshu86: bets $981.75
tabby20: folds
Uncalled bet ($981.75) returned to anshu86
anshu86: doesn't show hand
anshu86 collected $1309 from pot
*** SUMMARY ***
Total pot $1369.23 | Rake $60.23
Board [9c Kh 3c Qs]
Seat 1: Lucifer999 folded before Flop (didn't bet)
Seat 2: anshu86 (button) collected ($1309)
Seat 5: tabby20 (small blind) folded on the Turn
Seat 6: manny007 (big blind) folded on the Flop



PokerStars Game #00327541932: Hold'em No Limit ($10/$25 USD) - 2022/04/30 10:56:38 ET
Table 'Hold'em (Min 500Max 2500)  1282' 6-max Seat #6 is the button
Seat 3: Mastkalandar ($2025 in chips) 
Seat 4: papadickkies ($1263.29 in chips) 
Seat 5: Lucifer999 ($10423.37 in chips) 
Seat 6: devi7 ($2536.2 in chips) 
Mastkalandar: posts small blind $10
papadickkies: posts big blind $25
*** HOLE CARDS ***
Dealt to Lucifer999 [9h 2d]
Lucifer999: folds
devi7: raises $50.00 to $75
Mastkalandar: folds
papadickkies: folds
Uncalled bet ($50) returned to devi7
devi7: doesn't show hand
devi7 collected $60 from pot
*** SUMMARY ***
Total pot $60.00 | Rake $0
Board []
Seat 3: Mastkalandar (small blind) folded before Flop
Seat 4: papadickkies (big blind) folded before Flop
Seat 5: Lucifer999 folded before Flop (didn't bet)
Seat 6: devi7 (button) collected ($60)



PokerStars Game #00327541896: Hold'em No Limit ($10/$25 USD) - 2022/04/30 10:56:23 ET
Table 'Hold'em (Min 500Max 2500) 1001' 6-max Seat #4 is the button
Seat 1: JaspritBumrah786 ($2764.44 in chips) 
Seat 2: fishfry123 ($1912.64 in chips) 
Seat 3: EASYWITHACES ($2341.55 in chips) 
Seat 4: devi7 ($2787.85 in chips) 
Seat 5: Lucifer999 ($4120.01 in chips) 
Seat 6: spidy02 ($3883.14 in chips) 
Lucifer999: posts small blind $10
spidy02: posts big blind $25
*** HOLE CARDS ***
Dealt to Lucifer999 [Jh 5d]
JaspritBumrah786: raises $50.00 to $75
fishfry123: folds
EASYWITHACES: folds
devi7: folds
Lucifer999: folds
spidy02: calls $50
*** FLOP *** [Kh 3s 9s]
spidy02: checks
JaspritBumrah786: checks
*** TURN *** [Kh 3s 9s] [9h]
spidy02: bets $75.3
JaspritBumrah786: raises $199.70 to $275
spidy02: calls $199.7
*** RIVER *** [Kh 3s 9s 9h] [6s]
spidy02: checks
JaspritBumrah786: checks
*** SHOW DOWN ***
JaspritBumrah786: shows [8d 8c] (Two pairs, 9988)
spidy02: shows [Td 9c] (Three of a kind, 999)
spidy02 collected $667.73 from pot
*** SUMMARY ***
Total pot $710.00 | Rake $42.27
Board [Kh 3s 9s 9h 6s]
Seat 1: JaspritBumrah786 showed [8d 8c] and lost with Two pairs, 9988
Seat 2: fishfry123 folded before Flop (didn't bet)
Seat 3: EASYWITHACES folded before Flop (didn't bet)
Seat 4: devi7 (button) folded before Flop (didn't bet)
Seat 5: Lucifer999 (small blind) folded before Flop
Seat 6: spidy02  (big blind) showed [Td 9c] and won ($667.73) with Three of a kind, 999



PokerStars Game #00327541993: Hold'em No Limit ($10/$25 USD) - 2022/04/30 10:57:08 ET
Table 'Hold'em (Min 500Max 2500)  1282' 6-max Seat #3 is the button
Seat 3: Mastkalandar ($2015 in chips) 
Seat 4: papadickkies ($1238.29 in chips) 
Seat 5: Lucifer999 ($10423.37 in chips) 
Seat 6: devi7 ($2571.2 in chips) 
papadickkies: posts small blind $10
Lucifer999: posts big blind $25
*** HOLE CARDS ***
Dealt to Lucifer999 [5h 9h]
devi7: folds
Mastkalandar: folds
papadickkies: folds
Uncalled bet ($15) returned to Lucifer999
Lucifer999: doesn't show hand
Lucifer999 collected $20 from pot
*** SUMMARY ***
Total pot $20.00 | Rake $0
Board []
Seat 3: Mastkalandar (button) folded before Flop (didn't bet)
Seat 4: papadickkies (small blind) folded before Flop
Seat 5: Lucifer999 (big blind) collected ($20)
Seat 6: devi7 folded before Flop (didn't bet)



PokerStars Game #00327541910: Hold'em No Limit ($25/$50 USD) - 2022/04/30 10:56:30 ET
Table 'Hold'em (Min 1K Max 5K)   216' 6-max Seat #5 is the button
Seat 1: Lucifer999 ($10214.14 in chips) 
Seat 2: rahulh1 ($1175.65 in chips) 
Seat 3: Avaroni ($6911.5 in chips) 
Seat 4: No username ($4728.74 in chips) 
Seat 5: BIG DADDY__ ($2314.03 in chips) 
Seat 6: anshu86 ($4092.85 in chips) 
anshu86: posts small blind $25
Lucifer999: posts big blind $50
*** HOLE CARDS ***
Dealt to Lucifer999 [8h 5c]
rahulh1: folds
Avaroni: folds
No username: raises $66.67 to $116.67
BIG DADDY__: folds
anshu86: calls $91.67
Lucifer999: folds
*** FLOP *** [8c Jh 8s]
anshu86: checks
No username: bets $134.6
anshu86: calls $134.6
*** TURN *** [8c Jh 8s] [3h]
anshu86: checks
No username: checks
*** RIVER *** [8c Jh 8s 3h] [3c]
anshu86: checks
No username: bets $262.47
anshu86: calls $262.47
*** SHOW DOWN ***
No username: shows [Ad 3d] (Full house, 33388)
anshu86: doesn't show hand
No username collected $1023.63 from pot
*** SUMMARY ***
Total pot $1077.48 | Rake $53.85
Board [8c Jh 8s 3h 3c]
Seat 1: Lucifer999 (big blind) folded before Flop
Seat 2: rahulh1 folded before Flop (didn't bet)
Seat 3: Avaroni folded before Flop (didn't bet)
Seat 4: No username  showed [Ad 3d] and won ($1023.63) with Full house, 33388
Seat 5: BIG DADDY__ (button) folded before Flop (didn't bet)
Seat 6: anshu86 (small blind) mucked



PokerStars Game #00327542031: Hold'em No Limit ($10/$25 USD) - 2022/04/30 10:57:24 ET
Table 'Hold'em (Min 500Max 2500)  1282' 6-max Seat #4 is the button
Seat 3: Mastkalandar ($2015 in chips) 
Seat 4: papadickkies ($1228.29 in chips) 
Seat 5: Lucifer999 ($10433.37 in chips) 
Seat 6: devi7 ($2571.2 in chips) 
Lucifer999: posts small blind $10
devi7: posts big blind $25
*** HOLE CARDS ***
Dealt to Lucifer999 [7d Qs]
Mastkalandar: folds
papadickkies: folds
Lucifer999: folds
Uncalled bet ($15) returned to devi7
devi7: doesn't show hand
devi7 collected $20 from pot
*** SUMMARY ***
Total pot $20.00 | Rake $0
Board []
Seat 3: Mastkalandar folded before Flop (didn't bet)
Seat 4: papadickkies (button) folded before Flop (didn't bet)
Seat 5: Lucifer999 (small blind) folded before Flop
Seat 6: devi7 (big blind) collected ($20)



PokerStars Game #00327541979: Hold'em No Limit ($50/$100 USD) - 2022/04/30 10:57:00 ET
Table 'Hold'em (Min 25KMax 10K)    69' 6-max Seat #5 is the button
Seat 1: Lucifer999 ($20506.21 in chips) 
Seat 2: anshu86 ($10610.33 in chips) 
Seat 3: Mpr@59  ($2500 in chips) 
Seat 5: tabby20 ($29528.58 in chips) 
Seat 6: manny007 ($3323.97 in chips) 
manny007: posts small blind $50
Lucifer999: posts big blind $100
Mpr@59 : posts big blind $100
*** HOLE CARDS ***
Dealt to Lucifer999 [Th 3d]
anshu86: folds
Mpr@59 : checks
tabby20: folds
manny007: folds
Lucifer999: raises $250.00 to $350
Mpr@59 : folds
Uncalled bet ($250) returned to Lucifer999
Lucifer999: doesn't show hand
Lucifer999 collected $250 from pot
*** SUMMARY ***
Total pot $250.00 | Rake $0
Board []
Seat 1: Lucifer999 (big blind) collected ($250)
Seat 2: anshu86 folded before Flop (didn't bet)
Seat 3: Mpr@59  folded before Flop
Seat 5: tabby20 (button) folded before Flop (didn't bet)
Seat 6: manny007 (small blind) folded before Flop



PokerStars Game #00327542023: Hold'em No Limit ($10/$25 USD) - 2022/04/30 10:57:21 ET
Table 'Hold'em (Min 500Max 2500) 1001' 6-max Seat #5 is the button
Seat 1: JaspritBumrah786 ($2414.44 in chips) 
Seat 2: fishfry123 ($1912.64 in chips) 
Seat 3: EASYWITHACES ($2341.55 in chips) 
Seat 4: devi7 ($2787.85 in chips) 
Seat 5: Lucifer999 ($4110.01 in chips) 
Seat 6: spidy02 ($4200.87 in chips) 
spidy02: posts small blind $10
JaspritBumrah786: posts big blind $25
*** HOLE CARDS ***
Dealt to Lucifer999 [Js 5h]
fishfry123: folds
EASYWITHACES: folds
devi7: folds
Lucifer999: folds
spidy02: calls $15
JaspritBumrah786: raises $100.00 to $125
spidy02: folds
Uncalled bet ($100) returned to JaspritBumrah786
JaspritBumrah786: doesn't show hand
JaspritBumrah786 collected $50 from pot
*** SUMMARY ***
Total pot $50.00 | Rake $0
Board []
Seat 1: JaspritBumrah786 (big blind) collected ($50)
Seat 2: fishfry123 folded before Flop (didn't bet)
Seat 3: EASYWITHACES folded before Flop (didn't bet)
Seat 4: devi7 folded before Flop (didn't bet)
Seat 5: Lucifer999 (button) folded before Flop (didn't bet)
Seat 6: spidy02 (small blind) folded before Flop



PokerStars Game #00327542054: Hold'em No Limit ($25/$50 USD) - 2022/04/30 10:57:35 ET
Table 'Hold'em (Min 1K Max 5K)   216' 6-max Seat #6 is the button
Seat 1: Lucifer999 ($10164.14 in chips) 
Seat 2: rahulh1 ($1175.65 in chips) 
Seat 3: Avaroni ($6911.5 in chips) 
Seat 4: No username ($5238.63 in chips) 
Seat 5: BIG DADDY__ ($2314.03 in chips) 
Seat 6: anshu86 ($3579.11 in chips) 
Lucifer999: posts small blind $25
rahulh1: posts big blind $50
*** HOLE CARDS ***
Dealt to Lucifer999 [2h 4s]
Avaroni: folds
No username: raises $66.67 to $116.67
BIG DADDY__: folds
anshu86: folds
Lucifer999: folds
rahulh1: raises $1058.98 to $1175.65
No username: folds
Uncalled bet ($1058.98) returned to rahulh1
rahulh1: doesn't show hand
rahulh1 collected $258.34 from pot
*** SUMMARY ***
Total pot $258.34 | Rake $0
Board []
Seat 1: Lucifer999 (small blind) folded before Flop
Seat 2: rahulh1 (big blind) collected ($258.34)
Seat 3: Avaroni folded before Flop (didn't bet)
Seat 4: No username folded before Flop
Seat 5: BIG DADDY__ folded before Flop (didn't bet)
Seat 6: anshu86 (button) folded before Flop (didn't bet)



PokerStars Game #00327542069: Hold'em No Limit ($10/$25 USD) - 2022/04/30 10:57:43 ET
Table 'Hold'em (Min 500Max 2500)  1282' 6-max Seat #5 is the button
Seat 3: Mastkalandar ($2015 in chips) 
Seat 4: papadickkies ($1228.29 in chips) 
Seat 5: Lucifer999 ($10423.37 in chips) 
Seat 6: devi7 ($2581.2 in chips) 
devi7: posts small blind $10
Mastkalandar: posts big blind $25
*** HOLE CARDS ***
Dealt to Lucifer999 [Ah 8s]
papadickkies: raises $45.00 to $70
Lucifer999: folds
devi7: folds
Mastkalandar: folds
Uncalled bet ($45) returned to papadickkies
papadickkies: doesn't show hand
papadickkies collected $60 from pot
*** SUMMARY ***
Total pot $60.00 | Rake $0
Board []
Seat 3: Mastkalandar (big blind) folded before Flop
Seat 4: papadickkies collected ($60)
Seat 5: Lucifer999 (button) folded before Flop (didn't bet)
Seat 6: devi7 (small blind) folded before Flop



PokerStars Game #00327542083: Hold'em No Limit ($50/$100 USD) - 2022/04/30 10:57:48 ET
Table 'Hold'em (Min 25KMax 10K)    69' 6-max Seat #6 is the button
Seat 1: Lucifer999 ($20656.21 in chips) 
Seat 2: anshu86 ($10610.33 in chips) 
Seat 3: Mpr@59  ($2400 in chips) 
Seat 5: tabby20 ($29528.58 in chips) 
Seat 6: manny007 ($3273.97 in chips) 
Lucifer999: posts small blind $50
anshu86: posts big blind $100
*** HOLE CARDS ***
Dealt to Lucifer999 [3h Kh]
Mpr@59 : folds
tabby20: folds
manny007: folds
Lucifer999: raises $200.00 to $300
anshu86: folds
Uncalled bet ($200) returned to Lucifer999
Lucifer999: doesn't show hand
Lucifer999 collected $200 from pot
*** SUMMARY ***
Total pot $200.00 | Rake $0
Board []
Seat 1: Lucifer999 (small blind) collected ($200)
Seat 2: anshu86 (big blind) folded before Flop
Seat 3: Mpr@59  folded before Flop (didn't bet)
Seat 5: tabby20 folded before Flop (didn't bet)
Seat 6: manny007 (button) folded before Flop (didn't bet)



PokerStars Game #00327542147: Hold'em No Limit ($10/$25 USD) - 2022/04/30 10:58:16 ET
Table 'Hold'em (Min 500Max 2500)  1282' 6-max Seat #6 is the button
Seat 1: bettercall7208 ($1758.62 in chips) 
Seat 3: Mastkalandar ($2025 in chips) 
Seat 4: papadickkies ($1263.29 in chips) 
Seat 5: Lucifer999 ($10423.37 in chips) 
Seat 6: devi7 ($2571.2 in chips) 
Mastkalandar: posts small blind $10
papadickkies: posts big blind $25
*** HOLE CARDS ***
Dealt to Lucifer999 [8d 9s]
Lucifer999: folds
devi7: folds
Mastkalandar: raises $50.00 to $75
papadickkies: folds
Uncalled bet ($50) returned to Mastkalandar
Mastkalandar: doesn't show hand
Mastkalandar collected $50 from pot
*** SUMMARY ***
Total pot $50.00 | Rake $0
Board []
Seat 3: Mastkalandar (small blind) collected ($50)
Seat 4: papadickkies (big blind) folded before Flop
Seat 5: Lucifer999 folded before Flop (didn't bet)
Seat 6: devi7 (button) folded before Flop (didn't bet)



PokerStars Game #00327542092: Hold'em No Limit ($10/$25 USD) - 2022/04/30 10:57:51 ET
Table 'Hold'em (Min 500Max 2500) 1001' 6-max Seat #6 is the button
Seat 1: JaspritBumrah786 ($2439.44 in chips) 
Seat 2: fishfry123 ($1912.64 in chips) 
Seat 3: EASYWITHACES ($2341.55 in chips) 
Seat 4: devi7 ($2787.85 in chips) 
Seat 5: Lucifer999 ($4110.01 in chips) 
Seat 6: spidy02 ($4175.87 in chips) 
JaspritBumrah786: posts small blind $10
fishfry123: posts big blind $25
*** HOLE CARDS ***
Dealt to Lucifer999 [4c 5s]
EASYWITHACES: calls $25
devi7: folds
Lucifer999: folds
spidy02: raises $35.00 to $60
JaspritBumrah786: folds
fishfry123: calls $35
EASYWITHACES: calls $35
*** FLOP *** [Td Tc 6d]
fishfry123: checks
EASYWITHACES: checks
spidy02: bets $134.27
fishfry123: calls $134.27
EASYWITHACES: folds
*** TURN *** [Td Tc 6d] [3d]
fishfry123: checks
spidy02: bets $215.25
fishfry123: calls $215.25
*** RIVER *** [Td Tc 6d 3d] [6c]
fishfry123: bets $837.37
spidy02: folds
Uncalled bet ($837.37) returned to fishfry123
fishfry123: doesn't show hand
fishfry123 collected $837.37 from pot
*** SUMMARY ***
Total pot $889.04 | Rake $51.67
Board [Td Tc 6d 3d 6c]
Seat 1: JaspritBumrah786 (small blind) folded before Flop
Seat 2: fishfry123 (big blind) collected ($837.37)
Seat 3: EASYWITHACES folded on the Flop
Seat 4: devi7 folded before Flop (didn't bet)
Seat 5: Lucifer999 folded before Flop (didn't bet)
Seat 6: spidy02 (button) folded on the River



PokerStars Game #00327542136: Hold'em No Limit ($25/$50 USD) - 2022/04/30 10:58:11 ET
Table 'Hold'em (Min 1K Max 5K)   216' 6-max Seat #1 is the button
Seat 1: Lucifer999 ($10139.14 in chips) 
Seat 2: rahulh1 ($1317.32 in chips) 
Seat 3: Avaroni ($6911.5 in chips) 
Seat 4: No username ($5121.96 in chips) 
Seat 5: BIG DADDY__ ($2314.03 in chips) 
Seat 6: anshu86 ($3579.11 in chips) 
rahulh1: posts small blind $25
Avaroni: posts big blind $50
*** HOLE CARDS ***
Dealt to Lucifer999 [9h Kh]
No username: folds
BIG DADDY__: raises $75.00 to $125
anshu86: folds
Lucifer999: calls $125
rahulh1: folds
Avaroni: folds
*** FLOP *** [2s Qc 7c]
BIG DADDY__: bets $175
Lucifer999: folds
Uncalled bet ($175) returned to BIG DADDY__
BIG DADDY__: doesn't show hand
BIG DADDY__ collected $308.75 from pot
*** SUMMARY ***
Total pot $325.00 | Rake $16.25
Board [2s Qc 7c]
Seat 1: Lucifer999 (button) folded on the Flop
Seat 2: rahulh1 (small blind) folded before Flop
Seat 3: Avaroni (big blind) folded before Flop
Seat 4: No username folded before Flop (didn't bet)
Seat 5: BIG DADDY__ collected ($308.75)
Seat 6: anshu86 folded before Flop (didn't bet)



PokerStars Game #00327542210: Hold'em No Limit ($10/$25 USD) - 2022/04/30 10:58:49 ET
Table 'Hold'em (Min 500Max 2500) 1001' 6-max Seat #1 is the button
Seat 1: JaspritBumrah786 ($2429.44 in chips) 
Seat 2: fishfry123 ($2340.49 in chips) 
Seat 3: EASYWITHACES ($2281.55 in chips) 
Seat 4: devi7 ($2787.85 in chips) 
Seat 5: Lucifer999 ($4110.01 in chips) 
Seat 6: spidy02 ($3766.35 in chips) 
fishfry123: posts small blind $10
EASYWITHACES: posts big blind $25
*** HOLE CARDS ***
Dealt to Lucifer999 [4c Jd]
devi7: folds
Lucifer999: folds
spidy02: folds
JaspritBumrah786: raises $50.00 to $75
fishfry123: folds
EASYWITHACES: folds
Uncalled bet ($50) returned to JaspritBumrah786
JaspritBumrah786: doesn't show hand
JaspritBumrah786 collected $60 from pot
*** SUMMARY ***
Total pot $60.00 | Rake $0
Board []
Seat 1: JaspritBumrah786 (button) collected ($60)
Seat 2: fishfry123 (small blind) folded before Flop
Seat 3: EASYWITHACES (big blind) folded before Flop
Seat 4: devi7 folded before Flop (didn't bet)
Seat 5: Lucifer999 folded before Flop (didn't bet)
Seat 6: spidy02 folded before Flop (didn't bet)



PokerStars Game #00327542215: Hold'em No Limit ($25/$50 USD) - 2022/04/30 10:58:52 ET
Table 'Hold'em (Min 1K Max 5K)   216' 6-max Seat #2 is the button
Seat 1: Lucifer999 ($10014.14 in chips) 
Seat 2: rahulh1 ($1292.32 in chips) 
Seat 3: Avaroni ($6861.5 in chips) 
Seat 4: No username ($5121.96 in chips) 
Seat 5: BIG DADDY__ ($2497.78 in chips) 
Seat 6: anshu86 ($3579.11 in chips) 
Avaroni: posts small blind $25
No username: posts big blind $50
*** HOLE CARDS ***
Dealt to Lucifer999 [9s Js]
BIG DADDY__: calls $50
anshu86: folds
Lucifer999: raises $175.00 to $225
rahulh1: folds
Avaroni: calls $200
No username: folds
BIG DADDY__: calls $175
*** FLOP *** [2c 9d Ac]
Avaroni: checks
BIG DADDY__: checks
Lucifer999: checks
*** TURN *** [2c 9d Ac] [Jd]
Avaroni: checks
BIG DADDY__: checks
Lucifer999: bets $500
Avaroni: folds
BIG DADDY__: folds
Uncalled bet ($500) returned to Lucifer999
Lucifer999: doesn't show hand
Lucifer999 collected $688.75 from pot
*** SUMMARY ***
Total pot $725.00 | Rake $36.25
Board [2c 9d Ac Jd]
Seat 1: Lucifer999 collected ($688.75)
Seat 2: rahulh1 (button) folded before Flop (didn't bet)
Seat 3: Avaroni (small blind) folded on the Turn
Seat 4: No username (big blind) folded before Flop
Seat 5: BIG DADDY__ folded on the Turn
Seat 6: anshu86 folded before Flop (didn't bet)



PokerStars Game #00327542275: Hold'em No Limit ($10/$25 USD) - 2022/04/30 10:59:22 ET
Table 'Hold'em (Min 500Max 2500) 1001' 6-max Seat #2 is the button
Seat 1: JaspritBumrah786 ($2464.44 in chips) 
Seat 2: fishfry123 ($2330.49 in chips) 
Seat 3: EASYWITHACES ($2256.55 in chips) 
Seat 4: devi7 ($2787.85 in chips) 
Seat 5: Lucifer999 ($4110.01 in chips) 
Seat 6: spidy02 ($3766.35 in chips) 
EASYWITHACES: posts small blind $10
devi7: posts big blind $25
*** HOLE CARDS ***
Dealt to Lucifer999 [Ad 3c]
Lucifer999: folds
spidy02: folds
JaspritBumrah786: folds
fishfry123: calls $25
EASYWITHACES: folds
devi7: raises $75.00 to $100
fishfry123: folds
Uncalled bet ($75) returned to devi7
devi7: doesn't show hand
devi7 collected $60 from pot
*** SUMMARY ***
Total pot $60.00 | Rake $0
Board []
Seat 1: JaspritBumrah786 folded before Flop (didn't bet)
Seat 2: fishfry123 (button) folded before Flop
Seat 3: EASYWITHACES (small blind) folded before Flop
Seat 4: devi7 (big blind) collected ($60)
Seat 5: Lucifer999 folded before Flop (didn't bet)
Seat 6: spidy02 folded before Flop (didn't bet)



PokerStars Game #00327542193: Hold'em No Limit ($10/$25 USD) - 2022/04/30 10:58:41 ET
Table 'Hold'em (Min 500Max 2500)  1282' 6-max Seat #3 is the button
Seat 1: bettercall7208 ($1758.62 in chips) 
Seat 3: Mastkalandar ($2125 in chips) 
Seat 4: papadickkies ($1238.29 in chips) 
Seat 5: Lucifer999 ($10423.37 in chips) 
Seat 6: devi7 ($2571.2 in chips) 
papadickkies: posts small blind $10
Lucifer999: posts big blind $25
bettercall7208: posts big blind $25
*** HOLE CARDS ***
Dealt to Lucifer999 [2c 6d]
devi7: folds
bettercall7208: checks
Mastkalandar: raises $75.00 to $100
papadickkies: folds
Lucifer999: folds
bettercall7208: calls $75
*** FLOP *** [7d 4s 3s]
bettercall7208: checks
Mastkalandar: bets $175
bettercall7208: calls $175
*** TURN *** [7d 4s 3s] [Qs]
bettercall7208: checks
Mastkalandar: checks
*** RIVER *** [7d 4s 3s Qs] [2d]
bettercall7208: bets $449.29
Mastkalandar: calls $449.29
*** SHOW DOWN ***
bettercall7208: shows [9d Ts] (High card, Q)
Mastkalandar: shows [Qc 8c] (Pair, QQ)
Mastkalandar collected $1400.73 from pot
*** SUMMARY ***
Total pot $1483.58 | Rake $82.85
Board [7d 4s 3s Qs 2d]
Seat 1: bettercall7208 showed [9d Ts] and lost with High card, Q
Seat 3: Mastkalandar  (button) showed [Qc 8c] and won ($1400.73) with Pair, QQ
Seat 4: papadickkies (small blind) folded before Flop
Seat 5: Lucifer999 (big blind) folded before Flop
Seat 6: devi7 folded before Flop (didn't bet)



PokerStars Game #00327542156: Hold'em No Limit ($50/$100 USD) - 2022/04/30 10:58:20 ET
Table 'Hold'em (Min 25KMax 10K)    69' 6-max Seat #1 is the button
Seat 1: Lucifer999 ($20756.21 in chips) 
Seat 2: anshu86 ($10510.33 in chips) 
Seat 3: Mpr@59  ($2400 in chips) 
Seat 4: vinuth ($10000 in chips) 
Seat 5: tabby20 ($29528.58 in chips) 
Seat 6: manny007 ($3273.97 in chips) 
anshu86: posts small blind $50
Mpr@59 : posts big blind $100
*** HOLE CARDS ***
Dealt to Lucifer999 [Ks 4s]
vinuth: checks
tabby20: folds
manny007: calls $100
Lucifer999: calls $100
anshu86: calls $50
Mpr@59 : checks
*** FLOP *** [Tc 3d 6c]
anshu86: checks
Mpr@59 : checks
vinuth: checks
manny007: checks
Lucifer999: bets $400
anshu86: folds
Mpr@59 : folds
vinuth: folds
manny007: folds
Uncalled bet ($400) returned to Lucifer999
Lucifer999: doesn't show hand
Lucifer999 collected $478 from pot
*** SUMMARY ***
Total pot $500.00 | Rake $22
Board [Tc 3d 6c]
Seat 1: Lucifer999 (button) collected ($478)
Seat 2: anshu86 (small blind) folded on the Flop
Seat 3: Mpr@59  (big blind) folded on the Flop
Seat 4: vinuth folded on the Flop
Seat 5: tabby20 folded before Flop (didn't bet)
Seat 6: manny007 folded on the Flop



PokerStars Game #00327542308: Hold'em No Limit ($25/$50 USD) - 2022/04/30 10:59:38 ET
Table 'Hold'em (Min 1K Max 5K)   216' 6-max Seat #3 is the button
Seat 1: Lucifer999 ($10477.89 in chips) 
Seat 2: rahulh1 ($1292.32 in chips) 
Seat 3: Avaroni ($6636.5 in chips) 
Seat 4: No username ($5071.96 in chips) 
Seat 5: BIG DADDY__ ($2272.78 in chips) 
Seat 6: anshu86 ($3579.11 in chips) 
No username: posts small blind $25
BIG DADDY__: posts big blind $50
*** HOLE CARDS ***
Dealt to Lucifer999 [4d 6s]
anshu86: folds
Lucifer999: folds
rahulh1: folds
Avaroni: raises $100.00 to $150
No username: folds
BIG DADDY__: calls $100
*** FLOP *** [2d 7c 9d]
BIG DADDY__: checks
Avaroni: bets $225
BIG DADDY__: calls $225
*** TURN *** [2d 7c 9d] [3h]
BIG DADDY__: checks
Avaroni: checks
*** RIVER *** [2d 7c 9d 3h] [8c]
BIG DADDY__: checks
Avaroni: checks
*** SHOW DOWN ***
Avaroni: shows [5d 3d] (Pair, 33)
BIG DADDY__: doesn't show hand
Avaroni collected $736.25 from pot
*** SUMMARY ***
Total pot $775.00 | Rake $38.75
Board [2d 7c 9d 3h 8c]
Seat 1: Lucifer999 folded before Flop (didn't bet)
Seat 2: rahulh1 folded before Flop (didn't bet)
Seat 3: Avaroni  (button) showed [5d 3d] and won ($736.25) with Pair, 33
Seat 4: No username (small blind) folded before Flop
Seat 5: BIG DADDY__ (big blind) mucked
Seat 6: anshu86 folded before Flop (didn't bet)



PokerStars Game #00327542336: Hold'em No Limit ($10/$25 USD) - 2022/04/30 10:59:51 ET
Table 'Hold'em (Min 500Max 2500) 1001' 6-max Seat #3 is the button
Seat 1: JaspritBumrah786 ($2464.44 in chips) 
Seat 2: fishfry123 ($2305.49 in chips) 
Seat 3: EASYWITHACES ($2246.55 in chips) 
Seat 4: devi7 ($2822.85 in chips) 
Seat 5: Lucifer999 ($4110.01 in chips) 
Seat 6: spidy02 ($3766.35 in chips) 
devi7: posts small blind $10
Lucifer999: posts big blind $25
*** HOLE CARDS ***
Dealt to Lucifer999 [8s 7s]
spidy02: folds
JaspritBumrah786: folds
fishfry123: folds
EASYWITHACES: folds
devi7: raises $55.00 to $80
Lucifer999: calls $55
*** FLOP *** [7c Qs 2c]
devi7: bets $99.4
Lucifer999: calls $99.4
*** TURN *** [7c Qs 2c] [Jd]
devi7: bets $270
Lucifer999: calls $270
*** RIVER *** [7c Qs 2c Jd] [Ac]
devi7: bets $558.8
Lucifer999: folds
Uncalled bet ($558.8) returned to devi7
devi7: doesn't show hand
devi7 collected $846.66 from pot
*** SUMMARY ***
Total pot $898.80 | Rake $52.14
Board [7c Qs 2c Jd Ac]
Seat 1: JaspritBumrah786 folded before Flop (didn't bet)
Seat 2: fishfry123 folded before Flop (didn't bet)
Seat 3: EASYWITHACES (button) folded before Flop (didn't bet)
Seat 4: devi7 (small blind) collected ($846.66)
Seat 5: Lucifer999 (big blind) folded on the River
Seat 6: spidy02 folded before Flop (didn't bet)



PokerStars Game #00327542341: Hold'em No Limit ($10/$25 USD) - 2022/04/30 10:59:53 ET
Table 'Hold'em (Min 500Max 2500)  1282' 6-max Seat #4 is the button
Seat 1: bettercall7208 ($1034.33 in chips) 
Seat 3: Mastkalandar ($2801.44 in chips) 
Seat 4: papadickkies ($1228.29 in chips) 
Seat 5: Lucifer999 ($10398.37 in chips) 
Seat 6: devi7 ($2571.2 in chips) 
Lucifer999: posts small blind $10
devi7: posts big blind $25
*** HOLE CARDS ***
Dealt to Lucifer999 [Th Js]
bettercall7208: calls $25
Mastkalandar: folds
papadickkies: folds
Lucifer999: calls $15
devi7: checks
*** FLOP *** [Qd 5c Qc]
Lucifer999: checks
devi7: checks
bettercall7208: checks
*** TURN *** [Qd 5c Qc] [Kc]
Lucifer999: checks
devi7: checks
bettercall7208: bets $35.54
Lucifer999: folds
devi7: calls $35.54
*** RIVER *** [Qd 5c Qc Kc] [4s]
devi7: checks
bettercall7208: checks
*** SHOW DOWN ***
bettercall7208: shows [Ks 7c] (Two pairs, KKQQ)
devi7: doesn't show hand
bettercall7208 collected $137.42 from pot
*** SUMMARY ***
Total pot $146.08 | Rake $8.66
Board [Qd 5c Qc Kc 4s]
Seat 1: bettercall7208  showed [Ks 7c] and won ($137.42) with Two pairs, KKQQ
Seat 3: Mastkalandar folded before Flop (didn't bet)
Seat 4: papadickkies (button) folded before Flop (didn't bet)
Seat 5: Lucifer999 (small blind) folded on the Turn
Seat 6: devi7 (big blind) mucked



PokerStars Game #00327542394: Hold'em No Limit ($50/$100 USD) - 2022/04/30 11:00:20 ET
Table 'Hold'em (Min 25KMax 10K)    69' 6-max Seat #3 is the button
Seat 1: Lucifer999 ($21134.21 in chips) 
Seat 3: Mpr@59  ($2300 in chips) 
Seat 4: vinuth ($9900 in chips) 
Seat 5: tabby20 ($29528.58 in chips) 
Seat 6: manny007 ($3173.97 in chips) 
tabby20: posts small blind $50
manny007: posts big blind $100
*** HOLE CARDS ***
Dealt to Lucifer999 [As 5h]
Lucifer999: folds
Mpr@59 : calls $100
tabby20: folds
manny007: raises $250.00 to $350
Mpr@59 : calls $250
*** FLOP *** [9d 3c Kh]
manny007: bets $430.2
Mpr@59 : folds
Uncalled bet ($430.2) returned to manny007
manny007: doesn't show hand
manny007 collected $717 from pot
*** SUMMARY ***
Total pot $750.00 | Rake $33
Board [9d 3c Kh]
Seat 1: Lucifer999 folded before Flop (didn't bet)
Seat 3: Mpr@59  (button) folded on the Flop
Seat 5: tabby20 (small blind) folded before Flop
Seat 6: manny007 (big blind) collected ($717)



PokerStars Game #00327542461: Hold'em No Limit ($10/$25 USD) - 2022/04/30 11:00:51 ET
Table 'Hold'em (Min 500Max 2500) 1001' 6-max Seat #4 is the button
Seat 1: JaspritBumrah786 ($2464.44 in chips) 
Seat 2: fishfry123 ($2305.49 in chips) 
Seat 3: EASYWITHACES ($2246.55 in chips) 
Seat 4: devi7 ($3220.11 in chips) 
Seat 5: Lucifer999 ($3660.61 in chips) 
Seat 6: spidy02 ($3766.35 in chips) 
Lucifer999: posts small blind $10
spidy02: posts big blind $25
*** HOLE CARDS ***
Dealt to Lucifer999 [Th 3s]
JaspritBumrah786: folds
fishfry123: raises $31.67 to $56.67
devi7: folds
Lucifer999: folds
spidy02: folds
Uncalled bet ($31.67) returned to fishfry123
fishfry123: doesn't show hand
fishfry123 collected $60 from pot
*** SUMMARY ***
Total pot $60.00 | Rake $0
Board []
Seat 1: JaspritBumrah786 folded before Flop (didn't bet)
Seat 2: fishfry123 collected ($60)
Seat 4: devi7 (button) folded before Flop (didn't bet)
Seat 5: Lucifer999 (small blind) folded before Flop
Seat 6: spidy02 (big blind) folded before Flop



PokerStars Game #00327542436: Hold'em No Limit ($25/$50 USD) - 2022/04/30 11:00:39 ET
Table 'Hold'em (Min 1K Max 5K)   216' 6-max Seat #4 is the button
Seat 1: Lucifer999 ($10477.89 in chips) 
Seat 2: rahulh1 ($1292.32 in chips) 
Seat 3: Avaroni ($6997.75 in chips) 
Seat 4: No username ($5046.96 in chips) 
Seat 5: BIG DADDY__ ($1897.78 in chips) 
Seat 6: RaghSaiAyy ($5000 in chips) 
BIG DADDY__: posts small blind $25
Lucifer999: posts big blind $50
*** HOLE CARDS ***
Dealt to Lucifer999 [7s 9h]
rahulh1: folds
Avaroni: raises $100.00 to $150
No username: calls $150
BIG DADDY__: folds
Lucifer999: folds
*** FLOP *** [7h 2s 6s]
Avaroni: checks
No username: checks
*** TURN *** [7h 2s 6s] [Ts]
Avaroni: bets $300
No username: calls $300
*** RIVER *** [7h 2s 6s Ts] [Qc]
Avaroni: checks
No username: bets $488.13
Avaroni: folds
Uncalled bet ($488.13) returned to No username
No username: doesn't show hand
No username collected $926.25 from pot
*** SUMMARY ***
Total pot $975.00 | Rake $48.75
Board [7h 2s 6s Ts Qc]
Seat 1: Lucifer999 (big blind) folded before Flop
Seat 2: rahulh1 folded before Flop (didn't bet)
Seat 3: Avaroni folded on the River
Seat 4: No username (button) collected ($926.25)
Seat 5: BIG DADDY__ (small blind) folded before Flop



PokerStars Game #00327542487: Hold'em No Limit ($50/$100 USD) - 2022/04/30 11:01:02 ET
Table 'Hold'em (Min 25KMax 10K)    69' 6-max Seat #5 is the button
Seat 1: Lucifer999 ($21134.21 in chips) 
Seat 3: Mpr@59  ($1950 in chips) 
Seat 4: vinuth ($9900 in chips) 
Seat 5: tabby20 ($29478.58 in chips) 
Seat 6: manny007 ($3540.97 in chips) 
manny007: posts small blind $50
Lucifer999: posts big blind $100
vinuth: posts small blind $50
*** HOLE CARDS ***
Dealt to Lucifer999 [7s 3s]
Mpr@59 : calls $100
vinuth: raises $250.00 to $350
tabby20: folds
manny007: folds
Lucifer999: folds
Mpr@59 : raises $1600.00 to $1950
vinuth: folds
Uncalled bet ($1600) returned to Mpr@59 
Mpr@59 : doesn't show hand
Mpr@59  collected $850 from pot
*** SUMMARY ***
Total pot $850.00 | Rake $0
Board []
Seat 1: Lucifer999 (big blind) folded before Flop
Seat 3: Mpr@59  collected ($850)
Seat 4: vinuth folded before Flop
Seat 5: tabby20 (button) folded before Flop (didn't bet)
Seat 6: manny007 (small blind) folded before Flop



PokerStars Game #00327542579: Hold'em No Limit ($25/$50 USD) - 2022/04/30 11:01:31 ET
Table 'Hold'em (Min 1K Max 5K)   216' 6-max Seat #5 is the button
Seat 1: Lucifer999 ($10427.89 in chips) 
Seat 2: rahulh1 ($1292.32 in chips) 
Seat 3: Avaroni ($6547.75 in chips) 
Seat 4: No username ($5523.21 in chips) 
Seat 5: BIG DADDY__ ($1872.78 in chips) 
Seat 6: Millie ($5000 in chips) 
Lucifer999: posts small blind $25
rahulh1: posts big blind $50
*** HOLE CARDS ***
Dealt to Lucifer999 [3d 4h]
Avaroni: folds
No username: raises $81.25 to $131.25
BIG DADDY__: folds
Lucifer999: folds
rahulh1: folds
Uncalled bet ($81.25) returned to No username
No username: doesn't show hand
No username collected $125 from pot
*** SUMMARY ***
Total pot $125.00 | Rake $0
Board []
Seat 1: Lucifer999 (small blind) folded before Flop
Seat 2: rahulh1 (big blind) folded before Flop
Seat 3: Avaroni folded before Flop (didn't bet)
Seat 4: No username collected ($125)
Seat 5: BIG DADDY__ (button) folded before Flop (didn't bet)



PokerStars Game #00327542611: Hold'em No Limit ($50/$100 USD) - 2022/04/30 11:01:44 ET
Table 'Hold'em (Min 25KMax 10K)    69' 6-max Seat #6 is the button
Seat 1: Lucifer999 ($21034.21 in chips) 
Seat 3: Mpr@59  ($2450 in chips) 
Seat 4: vinuth ($9550 in chips) 
Seat 5: tabby20 ($29478.58 in chips) 
Seat 6: manny007 ($3490.97 in chips) 
Lucifer999: posts small blind $50
Mpr@59 : posts big blind $100
*** HOLE CARDS ***
Dealt to Lucifer999 [7c 2d]
vinuth: folds
tabby20: folds
manny007: folds
Lucifer999: folds
Uncalled bet ($50) returned to Mpr@59 
Mpr@59 : doesn't show hand
Mpr@59  collected $100 from pot
*** SUMMARY ***
Total pot $100.00 | Rake $0
Board []
Seat 1: Lucifer999 (small blind) folded before Flop
Seat 3: Mpr@59  (big blind) collected ($100)
Seat 4: vinuth folded before Flop (didn't bet)
Seat 5: tabby20 folded before Flop (didn't bet)
Seat 6: manny007 (button) folded before Flop (didn't bet)



PokerStars Game #00327542472: Hold'em No Limit ($10/$25 USD) - 2022/04/30 11:00:56 ET
Table 'Hold'em (Min 500Max 2500)  1282' 6-max Seat #5 is the button
Seat 1: bettercall7208 ($1111.21 in chips) 
Seat 3: Mastkalandar ($2801.44 in chips) 
Seat 4: papadickkies ($1228.29 in chips) 
Seat 5: Lucifer999 ($10373.37 in chips) 
Seat 6: devi7 ($2510.66 in chips) 
devi7: posts small blind $10
bettercall7208: posts big blind $25
*** HOLE CARDS ***
Dealt to Lucifer999 [5s 7h]
Mastkalandar: folds
papadickkies: raises $50.00 to $75
Lucifer999: folds
devi7: calls $65
bettercall7208: calls $50
*** FLOP *** [9s Jd Kh]
devi7: checks
bettercall7208: bets $105.6
papadickkies: calls $105.6
devi7: folds
*** TURN *** [9s Jd Kh] [Ac]
bettercall7208: checks
papadickkies: bets $172.49
bettercall7208: calls $172.49
*** RIVER *** [9s Jd Kh Ac] [Kd]
bettercall7208: bets $367.59
papadickkies: folds
Uncalled bet ($367.59) returned to bettercall7208
bettercall7208: doesn't show hand
bettercall7208 collected $735.18 from pot
*** SUMMARY ***
Total pot $781.18 | Rake $46
Board [9s Jd Kh Ac Kd]
Seat 1: bettercall7208 (big blind) collected ($735.18)
Seat 3: Mastkalandar folded before Flop (didn't bet)
Seat 4: papadickkies folded on the River
Seat 5: Lucifer999 (button) folded before Flop (didn't bet)
Seat 6: devi7 (small blind) folded on the Flop



PokerStars Game #00327542640: Hold'em No Limit ($25/$50 USD) - 2022/04/30 11:01:54 ET
Table 'Hold'em (Min 1K Max 5K)   216' 6-max Seat #1 is the button
Seat 1: Lucifer999 ($10402.89 in chips) 
Seat 2: rahulh1 ($1242.32 in chips) 
Seat 3: Avaroni ($6547.75 in chips) 
Seat 4: No username ($5598.21 in chips) 
Seat 5: BIG DADDY__ ($1872.78 in chips) 
Seat 6: Millie ($5000 in chips) 
rahulh1: posts small blind $25
Avaroni: posts big blind $50
*** HOLE CARDS ***
Dealt to Lucifer999 [7d Qh]
No username: raises $81.25 to $131.25
BIG DADDY__: folds
Lucifer999: folds
rahulh1: folds
Avaroni: folds
Uncalled bet ($81.25) returned to No username
No username: doesn't show hand
No username collected $125 from pot
*** SUMMARY ***
Total pot $125.00 | Rake $0
Board []
Seat 1: Lucifer999 (button) folded before Flop (didn't bet)
Seat 2: rahulh1 (small blind) folded before Flop
Seat 3: Avaroni (big blind) folded before Flop
Seat 4: No username collected ($125)
Seat 5: BIG DADDY__ folded before Flop (didn't bet)



PokerStars Game #00327542567: Hold'em No Limit ($10/$25 USD) - 2022/04/30 11:01:26 ET
Table 'Hold'em (Min 500Max 2500) 1001' 6-max Seat #5 is the button
Seat 1: JaspritBumrah786 ($2464.44 in chips) 
Seat 2: fishfry123 ($2340.49 in chips) 
Seat 4: devi7 ($3220.11 in chips) 
Seat 5: Lucifer999 ($3650.61 in chips) 
Seat 6: spidy02 ($3741.35 in chips) 
spidy02: posts small blind $10
JaspritBumrah786: posts big blind $25
*** HOLE CARDS ***
Dealt to Lucifer999 [Kd 8d]
fishfry123: folds
devi7: folds
Lucifer999: raises $55.00 to $80
spidy02: raises $121.25 to $201.25
JaspritBumrah786: folds
Lucifer999: calls $121.25
*** FLOP *** [6h 5c Ks]
spidy02: checks
Lucifer999: checks
*** TURN *** [6h 5c Ks] [8s]
spidy02: bets $200.55
Lucifer999: raises $299.45 to $500
spidy02: calls $299.45
*** RIVER *** [6h 5c Ks 8s] [Qs]
spidy02: checks
Lucifer999: bets $1300
spidy02: calls $1300
*** SHOW DOWN ***
Lucifer999: shows [Kd 8d] (Two pairs, KK88)
spidy02: doesn't show hand
Lucifer999 collected $3823.5 from pot
*** SUMMARY ***
Total pot $4027.50 | Rake $204
Board [6h 5c Ks 8s Qs]
Seat 1: JaspritBumrah786 (big blind) folded before Flop
Seat 2: fishfry123 folded before Flop (didn't bet)
Seat 4: devi7 folded before Flop (didn't bet)
Seat 5: Lucifer999  (button) showed [Kd 8d] and won ($3823.5) with Two pairs, KK88
Seat 6: spidy02 (small blind) mucked



PokerStars Game #00327542678: Hold'em No Limit ($50/$100 USD) - 2022/04/30 11:02:10 ET
Table 'Hold'em (Min 25KMax 10K)    69' 6-max Seat #1 is the button
Seat 1: Lucifer999 ($20984.21 in chips) 
Seat 3: Mpr@59  ($2500 in chips) 
Seat 4: vinuth ($9550 in chips) 
Seat 5: tabby20 ($29478.58 in chips) 
Seat 6: manny007 ($3490.97 in chips) 
Mpr@59 : posts small blind $50
vinuth: posts big blind $100
*** HOLE CARDS ***
Dealt to Lucifer999 [4h 9d]
tabby20: folds
manny007: calls $100
Lucifer999: folds
Mpr@59 : raises $300.00 to $400
vinuth: raises $688.46 to $1088.46
manny007: folds
Mpr@59 : raises $1411.54 to $2500
vinuth: calls $1411.54
*** FLOP *** [8c Kd Ts]
*** FLOP *** [2d 7c 6h]
*** TURN *** [8c Kd Ts] [Jc]
*** TURN *** [8c Kd Ts] [4c]
*** RIVER *** [8c Kd Ts Jc] [Kc]
*** RIVER *** [8c Kd Ts Jc] [2h]
*** SHOW DOWN ***
Mpr@59 : shows [Qc Ac] (Pair, 22)
vinuth: shows [Ad Kh] (Pair, 22)
Mpr@59  collected $2437.8 from pot
vinuth collected $2437.8 from pot
*** SUMMARY ***
Total pot $5100.00 | Rake $224.4
Board [8c Kd Ts Jc Kc]
Seat 1: Lucifer999 (button) folded before Flop (didn't bet)
Seat 3: Mpr@59   (small blind) showed [Qc Ac] and won ($2437.8) with Pair, 22
Seat 4: vinuth  (big blind) showed [Ad Kh] and won ($2437.8) with Pair, 22
Seat 5: tabby20 folded before Flop (didn't bet)
Seat 6: manny007 folded before Flop



PokerStars Game #00327542689: Hold'em No Limit ($10/$25 USD) - 2022/04/30 11:02:14 ET
Table 'Hold'em (Min 500Max 2500)  1282' 6-max Seat #6 is the button
Seat 1: bettercall7208 ($1493.3 in chips) 
Seat 2: RaghSaiAyy ($2500 in chips) 
Seat 3: Mastkalandar ($2801.44 in chips) 
Seat 4: papadickkies ($875.2 in chips) 
Seat 5: Lucifer999 ($10373.37 in chips) 
Seat 6: devi7 ($2435.66 in chips) 
bettercall7208: posts small blind $10
RaghSaiAyy: posts big blind $25
*** HOLE CARDS ***
Dealt to Lucifer999 [Qh 7h]
Mastkalandar: folds
papadickkies: folds
Lucifer999: folds
devi7: raises $50.00 to $75
bettercall7208: raises $175.00 to $250
RaghSaiAyy: calls $225
devi7: calls $175
*** FLOP *** [Qd 9s Js]
bettercall7208: bets $352.82
RaghSaiAyy: calls $352.82
devi7: raises $705.64 to $1058.46
bettercall7208: calls $705.64
RaghSaiAyy: folds
*** TURN *** [Qd 9s Js] [7c]
bettercall7208: bets $184.84
devi7: calls $184.84
*** RIVER *** [Qd 9s Js 7c] [9c]
*** SHOW DOWN ***
bettercall7208: shows [Jd As] (Two pairs, JJ99)
devi7: shows [Qs Kd] (Two pairs, QQ99)
devi7 collected $3396 from pot
*** SUMMARY ***
Total pot $3589.42 | Rake $193.42
Board [Qd 9s Js 7c 9c]
Seat 1: bettercall7208 (small blind) showed [Jd As] and lost with Two pairs, JJ99
Seat 2: RaghSaiAyy (big blind) folded on the Flop
Seat 3: Mastkalandar folded before Flop (didn't bet)
Seat 4: papadickkies folded before Flop (didn't bet)
Seat 5: Lucifer999 folded before Flop (didn't bet)
Seat 6: devi7  (button) showed [Qs Kd] and won ($3396) with Two pairs, QQ99



PokerStars Game #00327542741: Hold'em No Limit ($25/$50 USD) - 2022/04/30 11:02:37 ET
Table 'Hold'em (Min 1K Max 5K)   216' 6-max Seat #2 is the button
Seat 1: Lucifer999 ($10402.89 in chips) 
Seat 2: rahulh1 ($1217.32 in chips) 
Seat 3: Avaroni ($6497.75 in chips) 
Seat 4: No username ($5673.21 in chips) 
Seat 5: BIG DADDY__ ($1872.78 in chips) 
Seat 6: Millie ($5000 in chips) 
Avaroni: posts small blind $25
No username: posts big blind $50
*** HOLE CARDS ***
Dealt to Lucifer999 [9c 8h]
Lucifer999: folds
rahulh1: folds
Avaroni: raises $125.00 to $175
No username: calls $125
*** FLOP *** [Kc Qh Qc]
Avaroni: bets $275
No username: calls $275
*** TURN *** [Kc Qh Qc] [4s]
Avaroni: bets $800
No username: calls $800
*** RIVER *** [Kc Qh Qc 4s] [5d]
Avaroni: checks
No username: bets $810.38
Avaroni: folds
Uncalled bet ($810.38) returned to No username
No username: doesn't show hand
No username collected $2375 from pot
*** SUMMARY ***
Total pot $2500.00 | Rake $125
Board [Kc Qh Qc 4s 5d]
Seat 1: Lucifer999 folded before Flop (didn't bet)
Seat 2: rahulh1 (button) folded before Flop (didn't bet)
Seat 3: Avaroni (small blind) folded on the River
Seat 4: No username (big blind) collected ($2375)



PokerStars Game #00327542767: Hold'em No Limit ($10/$25 USD) - 2022/04/30 11:02:47 ET
Table 'Hold'em (Min 500Max 2500) 1001' 6-max Seat #6 is the button
Seat 1: JaspritBumrah786 ($2439.44 in chips) 
Seat 2: fishfry123 ($2340.49 in chips) 
Seat 4: devi7 ($3220.11 in chips) 
Seat 5: Lucifer999 ($5472.86 in chips) 
Seat 6: spidy02 ($1740.1 in chips) 
JaspritBumrah786: posts small blind $10
fishfry123: posts big blind $25
*** HOLE CARDS ***
Dealt to Lucifer999 [Ah Tc]
devi7: folds
Lucifer999: raises $55.00 to $80
spidy02: folds
JaspritBumrah786: calls $70
fishfry123: calls $55
*** FLOP *** [2h Ts 6c]
JaspritBumrah786: checks
fishfry123: checks
Lucifer999: bets $90
JaspritBumrah786: calls $90
fishfry123: folds
*** TURN *** [2h Ts 6c] [6h]
JaspritBumrah786: checks
Lucifer999: checks
*** RIVER *** [2h Ts 6c 6h] [8c]
JaspritBumrah786: bets $275
Lucifer999: calls $275
*** SHOW DOWN ***
JaspritBumrah786: shows [Qd Td] (Two pairs, TT66)
Lucifer999: shows [Ah Tc] (Two pairs, TT66)
Lucifer999 collected $914.08 from pot
*** SUMMARY ***
Total pot $970.00 | Rake $55.92
Board [2h Ts 6c 6h 8c]
Seat 1: JaspritBumrah786 (small blind) showed [Qd Td] and lost with Two pairs, TT66
Seat 2: fishfry123 (big blind) folded on the Flop
Seat 4: devi7 folded before Flop (didn't bet)
Seat 5: Lucifer999  showed [Ah Tc] and won ($914.08) with Two pairs, TT66
Seat 6: spidy02 (button) folded before Flop (didn't bet)



PokerStars Game #00327542897: Hold'em No Limit ($25/$50 USD) - 2022/04/30 11:03:39 ET
Table 'Hold'em (Min 1K Max 5K)   216' 6-max Seat #3 is the button
Seat 1: Lucifer999 ($10402.89 in chips) 
Seat 2: rahulh1 ($1217.32 in chips) 
Seat 3: Avaroni ($5247.75 in chips) 
Seat 4: No username ($6798.21 in chips) 
Seat 5: BIG DADDY__ ($1872.78 in chips) 
Seat 6: Millie ($5000 in chips) 
No username: posts small blind $25
Millie: posts big blind $50
*** HOLE CARDS ***
Dealt to Lucifer999 [5c 9h]
Lucifer999: folds
rahulh1: folds
Avaroni: folds
No username: folds
Uncalled bet ($25) returned to Millie
Millie: doesn't show hand
Millie collected $50 from pot
*** SUMMARY ***
Total pot $50.00 | Rake $0
Board []
Seat 1: Lucifer999 folded before Flop (didn't bet)
Seat 2: rahulh1 folded before Flop (didn't bet)
Seat 3: Avaroni (button) folded before Flop (didn't bet)
Seat 4: No username (small blind) folded before Flop
Seat 6: Millie (big blind) collected ($50)



PokerStars Game #00327542813: Hold'em No Limit ($50/$100 USD) - 2022/04/30 11:03:04 ET
Table 'Hold'em (Min 25KMax 10K)    69' 6-max Seat #3 is the button
Seat 1: Lucifer999 ($20984.21 in chips) 
Seat 3: Mpr@59  ($2437.8 in chips) 
Seat 4: vinuth ($9487.8 in chips) 
Seat 5: tabby20 ($29478.58 in chips) 
Seat 6: manny007 ($3390.97 in chips) 
vinuth: posts small blind $50
tabby20: posts big blind $100
*** HOLE CARDS ***
Dealt to Lucifer999 [2c Kd]
manny007: folds
Lucifer999: folds
Mpr@59 : folds
vinuth: calls $50
tabby20: checks
*** FLOP *** [Tc 7h 4h]
vinuth: bets $200
tabby20: calls $200
*** TURN *** [Tc 7h 4h] [Ad]
vinuth: checks
tabby20: bets $450
vinuth: folds
Uncalled bet ($450) returned to tabby20
tabby20: doesn't show hand
tabby20 collected $573.6 from pot
*** SUMMARY ***
Total pot $600.00 | Rake $26.4
Board [Tc 7h 4h Ad]
Seat 1: Lucifer999 folded before Flop (didn't bet)
Seat 3: Mpr@59  (button) folded before Flop (didn't bet)
Seat 4: vinuth (small blind) folded on the Turn
Seat 5: tabby20 (big blind) collected ($573.6)
Seat 6: manny007 folded before Flop (didn't bet)



PokerStars Game #00327542830: Hold'em No Limit ($10/$25 USD) - 2022/04/30 11:03:12 ET
Table 'Hold'em (Min 500Max 2500)  1282' 6-max Seat #2 is the button
Seat 2: RaghSaiAyy ($1897.18 in chips) 
Seat 3: Mastkalandar ($2801.44 in chips) 
Seat 4: papadickkies ($875.2 in chips) 
Seat 5: Lucifer999 ($10373.37 in chips) 
Seat 6: devi7 ($4338.36 in chips) 
Mastkalandar: posts small blind $10
papadickkies: posts big blind $25
*** HOLE CARDS ***
Dealt to Lucifer999 [6d 2s]
Lucifer999: folds
devi7: folds
RaghSaiAyy: raises $45.00 to $70
Mastkalandar: calls $60
papadickkies: folds
*** FLOP *** [4c Ad 8s]
Mastkalandar: checks
RaghSaiAyy: checks
*** TURN *** [4c Ad 8s] [As]
Mastkalandar: bets $100
RaghSaiAyy: raises $200.00 to $300
Mastkalandar: folds
Uncalled bet ($200) returned to RaghSaiAyy
RaghSaiAyy: doesn't show hand
RaghSaiAyy collected $342.84 from pot
*** SUMMARY ***
Total pot $365.00 | Rake $22.16
Board [4c Ad 8s As]
Seat 2: RaghSaiAyy (button) collected ($342.84)
Seat 3: Mastkalandar (small blind) folded on the Turn
Seat 4: papadickkies (big blind) folded before Flop
Seat 5: Lucifer999 folded before Flop (didn't bet)
Seat 6: devi7 folded before Flop (didn't bet)



PokerStars Game #00327542958: Hold'em No Limit ($25/$50 USD) - 2022/04/30 11:04:05 ET
Table 'Hold'em (Min 1K Max 5K)   216' 6-max Seat #4 is the button
Seat 1: Lucifer999 ($10402.89 in chips) 
Seat 2: rahulh1 ($1217.32 in chips) 
Seat 3: Avaroni ($5247.75 in chips) 
Seat 4: No username ($6773.21 in chips) 
Seat 5: BIG DADDY__ ($1872.78 in chips) 
Seat 6: Millie ($5025 in chips) 
Millie: posts small blind $25
Lucifer999: posts big blind $50
*** HOLE CARDS ***
Dealt to Lucifer999 [Qd 3h]
rahulh1: folds
Avaroni: folds
No username: folds
Millie: raises $100.00 to $150
Lucifer999: folds
Uncalled bet ($100) returned to Millie
Millie: doesn't show hand
Millie collected $100 from pot
*** SUMMARY ***
Total pot $100.00 | Rake $0
Board []
Seat 1: Lucifer999 (big blind) folded before Flop
Seat 2: rahulh1 folded before Flop (didn't bet)
Seat 3: Avaroni folded before Flop (didn't bet)
Seat 4: No username (button) folded before Flop (didn't bet)
Seat 6: Millie (small blind) collected ($100)



PokerStars Game #00327542933: Hold'em No Limit ($10/$25 USD) - 2022/04/30 11:03:54 ET
Table 'Hold'em (Min 500Max 2500) 1001' 6-max Seat #1 is the button
Seat 1: JaspritBumrah786 ($2025 in chips) 
Seat 2: fishfry123 ($2260.49 in chips) 
Seat 4: devi7 ($3220.11 in chips) 
Seat 5: Lucifer999 ($5941.94 in chips) 
Seat 6: spidy02 ($1740.1 in chips) 
fishfry123: posts small blind $10
devi7: posts big blind $25
*** HOLE CARDS ***
Dealt to Lucifer999 [Qd 4d]
Lucifer999: folds
spidy02: raises $35.00 to $60
JaspritBumrah786: folds
fishfry123: calls $50
devi7: folds
*** FLOP *** [Jd 8h 7s]
fishfry123: checks
spidy02: checks
*** TURN *** [Jd 8h 7s] [2d]
fishfry123: checks
spidy02: checks
*** RIVER *** [Jd 8h 7s 2d] [6c]
fishfry123: checks
spidy02: checks
*** SHOW DOWN ***
spidy02: shows [5c Ah] (High card, A)
fishfry123: doesn't show hand
spidy02 collected $136.39 from pot
*** SUMMARY ***
Total pot $145.00 | Rake $8.61
Board [Jd 8h 7s 2d 6c]
Seat 1: JaspritBumrah786 (button) folded before Flop (didn't bet)
Seat 2: fishfry123 (small blind) mucked
Seat 4: devi7 (big blind) folded before Flop
Seat 5: Lucifer999 folded before Flop (didn't bet)
Seat 6: spidy02  showed [5c Ah] and won ($136.39) with High card, A



PokerStars Game #00327542978: Hold'em No Limit ($10/$25 USD) - 2022/04/30 11:04:12 ET
Table 'Hold'em (Min 500Max 2500)  1282' 6-max Seat #3 is the button
Seat 2: RaghSaiAyy ($2070.02 in chips) 
Seat 3: Mastkalandar ($2631.44 in chips) 
Seat 4: papadickkies ($850.2 in chips) 
Seat 5: Lucifer999 ($10373.37 in chips) 
Seat 6: devi7 ($4338.36 in chips) 
papadickkies: posts small blind $10
Lucifer999: posts big blind $25
*** HOLE CARDS ***
Dealt to Lucifer999 [7s 9c]
devi7: raises $50.00 to $75
RaghSaiAyy: calls $75
Mastkalandar: folds
papadickkies: folds
Lucifer999: folds
*** FLOP *** [4h Ad 8s]
devi7: bets $87.15
RaghSaiAyy: folds
Uncalled bet ($87.15) returned to devi7
devi7: doesn't show hand
devi7 collected $174.29 from pot
*** SUMMARY ***
Total pot $185.00 | Rake $10.71
Board [4h Ad 8s]
Seat 2: RaghSaiAyy folded on the Flop
Seat 3: Mastkalandar (button) folded before Flop (didn't bet)
Seat 4: papadickkies (small blind) folded before Flop
Seat 5: Lucifer999 (big blind) folded before Flop
Seat 6: devi7 collected ($174.29)



PokerStars Game #00327543040: Hold'em No Limit ($25/$50 USD) - 2022/04/30 11:04:33 ET
Table 'Hold'em (Min 1K Max 5K)   216' 6-max Seat #6 is the button
Seat 1: Lucifer999 ($10352.89 in chips) 
Seat 2: rahulh1 ($1217.32 in chips) 
Seat 3: Avaroni ($5247.75 in chips) 
Seat 4: No username ($6773.21 in chips) 
Seat 5: BIG DADDY__ ($1872.78 in chips) 
Seat 6: Millie ($5075 in chips) 
Lucifer999: posts small blind $25
rahulh1: posts big blind $50
*** HOLE CARDS ***
Dealt to Lucifer999 [Td 6h]
Avaroni: folds
No username: raises $81.25 to $131.25
Millie: folds
Lucifer999: folds
rahulh1: folds
Uncalled bet ($81.25) returned to No username
No username: doesn't show hand
No username collected $125 from pot
*** SUMMARY ***
Total pot $125.00 | Rake $0
Board []
Seat 1: Lucifer999 (small blind) folded before Flop
Seat 2: rahulh1 (big blind) folded before Flop
Seat 3: Avaroni folded before Flop (didn't bet)
Seat 4: No username collected ($125)
Seat 6: Millie (button) folded before Flop (didn't bet)



PokerStars Game #00327543093: Hold'em No Limit ($10/$25 USD) - 2022/04/30 11:04:59 ET
Table 'Hold'em (Min 500Max 2500) 1001' 6-max Seat #2 is the button
Seat 1: JaspritBumrah786 ($2025 in chips) 
Seat 2: fishfry123 ($2200.49 in chips) 
Seat 4: devi7 ($3195.11 in chips) 
Seat 5: Lucifer999 ($5941.94 in chips) 
Seat 6: spidy02 ($1816.49 in chips) 
devi7: posts small blind $10
Lucifer999: posts big blind $25
*** HOLE CARDS ***
Dealt to Lucifer999 [Qh 5s]
spidy02: raises $35.00 to $60
JaspritBumrah786: folds
fishfry123: folds
devi7: folds
Lucifer999: folds
Uncalled bet ($35) returned to spidy02
spidy02: doesn't show hand
spidy02 collected $60 from pot
*** SUMMARY ***
Total pot $60.00 | Rake $0
Board []
Seat 1: JaspritBumrah786 folded before Flop (didn't bet)
Seat 2: fishfry123 (button) folded before Flop (didn't bet)
Seat 4: devi7 (small blind) folded before Flop
Seat 5: Lucifer999 (big blind) folded before Flop
Seat 6: spidy02 collected ($60)



PokerStars Game #00327543103: Hold'em No Limit ($25/$50 USD) - 2022/04/30 11:05:02 ET
Table 'Hold'em (Min 1K Max 5K)   216' 6-max Seat #1 is the button
Seat 1: Lucifer999 ($10327.89 in chips) 
Seat 2: rahulh1 ($1167.32 in chips) 
Seat 3: Avaroni ($5247.75 in chips) 
Seat 4: No username ($6848.21 in chips) 
Seat 5: BIG DADDY__ ($1872.78 in chips) 
Seat 6: Millie ($5075 in chips) 
rahulh1: posts small blind $25
Avaroni: posts big blind $50
BIG DADDY__: posts small & big blinds $75
*** HOLE CARDS ***
Dealt to Lucifer999 [Ah 5d]
No username: folds
BIG DADDY__: checks
Millie: folds
Lucifer999: calls $50
rahulh1: raises $1092.32 to $1167.32
Avaroni: folds
BIG DADDY__: folds
Lucifer999: folds
Uncalled bet ($1117.32) returned to rahulh1
rahulh1: doesn't show hand
rahulh1 collected $225 from pot
*** SUMMARY ***
Total pot $225.00 | Rake $0
Board []
Seat 1: Lucifer999 (button) folded before Flop
Seat 2: rahulh1 (small blind) collected ($225)
Seat 3: Avaroni (big blind) folded before Flop
Seat 4: No username folded before Flop (didn't bet)
Seat 5: BIG DADDY__ folded before Flop
Seat 6: Millie folded before Flop (didn't bet)



PokerStars Game #00327543099: Hold'em No Limit ($10/$25 USD) - 2022/04/30 11:05:00 ET
Table 'Hold'em (Min 500Max 2500)  1282' 6-max Seat #4 is the button
Seat 2: RaghSaiAyy ($1995.02 in chips) 
Seat 3: Mastkalandar ($2631.44 in chips) 
Seat 4: papadickkies ($840.2 in chips) 
Seat 5: Lucifer999 ($10348.37 in chips) 
Seat 6: devi7 ($4437.65 in chips) 
Lucifer999: posts small blind $10
devi7: posts big blind $25
*** HOLE CARDS ***
Dealt to Lucifer999 [Jd 3h]
RaghSaiAyy: raises $45.00 to $70
Mastkalandar: folds
papadickkies: folds
Lucifer999: folds
devi7: folds
Uncalled bet ($45) returned to RaghSaiAyy
RaghSaiAyy: doesn't show hand
RaghSaiAyy collected $60 from pot
*** SUMMARY ***
Total pot $60.00 | Rake $0
Board []
Seat 2: RaghSaiAyy collected ($60)
Seat 3: Mastkalandar folded before Flop (didn't bet)
Seat 4: papadickkies (button) folded before Flop (didn't bet)
Seat 5: Lucifer999 (small blind) folded before Flop
Seat 6: devi7 (big blind) folded before Flop



PokerStars Game #00327542968: Hold'em No Limit ($50/$100 USD) - 2022/04/30 11:04:08 ET
Table 'Hold'em (Min 25KMax 10K)    69' 6-max Seat #4 is the button
Seat 1: Lucifer999 ($20984.21 in chips) 
Seat 3: Mpr@59  ($2437.8 in chips) 
Seat 4: vinuth ($9187.8 in chips) 
Seat 5: tabby20 ($29752.18 in chips) 
Seat 6: manny007 ($3390.97 in chips) 
tabby20: posts small blind $50
manny007: posts big blind $100
*** HOLE CARDS ***
Dealt to Lucifer999 [9d Kd]
Lucifer999: raises $200.00 to $300
Mpr@59 : folds
vinuth: calls $300
tabby20: folds
manny007: folds
*** FLOP *** [8c 4c 8s]
Lucifer999: bets $600
vinuth: calls $600
*** TURN *** [8c 4c 8s] [Ah]
Lucifer999: checks
vinuth: bets $932.1
Lucifer999: folds
Uncalled bet ($932.1) returned to vinuth
vinuth: doesn't show hand
vinuth collected $1864.2 from pot
*** SUMMARY ***
Total pot $1950.00 | Rake $85.8
Board [8c 4c 8s Ah]
Seat 1: Lucifer999 folded on the Turn
Seat 3: Mpr@59  folded before Flop (didn't bet)
Seat 4: vinuth (button) collected ($1864.2)
Seat 5: tabby20 (small blind) folded before Flop
Seat 6: manny007 (big blind) folded before Flop



PokerStars Game #00327543157: Hold'em No Limit ($10/$25 USD) - 2022/04/30 11:05:26 ET
Table 'Hold'em (Min 500Max 2500) 1001' 6-max Seat #4 is the button
Seat 1: JaspritBumrah786 ($2025 in chips) 
Seat 2: fishfry123 ($2200.49 in chips) 
Seat 4: devi7 ($3185.11 in chips) 
Seat 5: Lucifer999 ($5916.94 in chips) 
Seat 6: spidy02 ($1851.49 in chips) 
Lucifer999: posts small blind $10
spidy02: posts big blind $25
*** HOLE CARDS ***
Dealt to Lucifer999 [4s 3c]
JaspritBumrah786: folds
fishfry123: raises $38.75 to $63.75
devi7: folds
Lucifer999: folds
spidy02: folds
Uncalled bet ($38.75) returned to fishfry123
fishfry123: doesn't show hand
fishfry123 collected $60 from pot
*** SUMMARY ***
Total pot $60.00 | Rake $0
Board []
Seat 1: JaspritBumrah786 folded before Flop (didn't bet)
Seat 2: fishfry123 collected ($60)
Seat 4: devi7 (button) folded before Flop (didn't bet)
Seat 5: Lucifer999 (small blind) folded before Flop
Seat 6: spidy02 (big blind) folded before Flop



PokerStars Game #00327543176: Hold'em No Limit ($10/$25 USD) - 2022/04/30 11:05:33 ET
Table 'Hold'em (Min 500Max 2500)  1282' 6-max Seat #5 is the button
Seat 2: RaghSaiAyy ($2030.02 in chips) 
Seat 3: Mastkalandar ($2631.44 in chips) 
Seat 4: papadickkies ($840.2 in chips) 
Seat 5: Lucifer999 ($10338.37 in chips) 
Seat 6: devi7 ($4412.65 in chips) 
devi7: posts small blind $10
RaghSaiAyy: posts big blind $25
*** HOLE CARDS ***
Dealt to Lucifer999 [3h 4s]
Mastkalandar: folds
papadickkies: folds
Lucifer999: folds
devi7: raises $55.00 to $80
RaghSaiAyy: calls $55
*** FLOP *** [6c Ad Qh]
devi7: bets $99.4
RaghSaiAyy: folds
Uncalled bet ($99.4) returned to devi7
devi7: doesn't show hand
devi7 collected $150.6 from pot
*** SUMMARY ***
Total pot $160.00 | Rake $9.4
Board [6c Ad Qh]
Seat 2: RaghSaiAyy (big blind) folded on the Flop
Seat 3: Mastkalandar folded before Flop (didn't bet)
Seat 4: papadickkies folded before Flop (didn't bet)
Seat 5: Lucifer999 (button) folded before Flop (didn't bet)
Seat 6: devi7 (small blind) collected ($150.6)



PokerStars Game #00327543164: Hold'em No Limit ($25/$50 USD) - 2022/04/30 11:05:27 ET
Table 'Hold'em (Min 1K Max 5K)   216' 6-max Seat #2 is the button
Seat 1: Lucifer999 ($10277.89 in chips) 
Seat 2: rahulh1 ($1342.32 in chips) 
Seat 3: Avaroni ($5197.75 in chips) 
Seat 4: No username ($6848.21 in chips) 
Seat 5: BIG DADDY__ ($1797.78 in chips) 
Seat 6: Millie ($5075 in chips) 
Avaroni: posts small blind $25
No username: posts big blind $50
*** HOLE CARDS ***
Dealt to Lucifer999 [6c Ad]
BIG DADDY__: folds
Millie: folds
Lucifer999: folds
rahulh1: folds
Avaroni: raises $125.00 to $175
No username: calls $125
*** FLOP *** [Qc 4d 6h]
Avaroni: checks
No username: checks
*** TURN *** [Qc 4d 6h] [3s]
Avaroni: checks
No username: bets $166.25
Avaroni: calls $166.25
*** RIVER *** [Qc 4d 6h 3s] [5s]
Avaroni: checks
No username: bets $511.3
Avaroni: folds
Uncalled bet ($511.3) returned to No username
*** SHOW DOWN ***
No username: shows [Jd 9c] (High card, Q)
No username collected $648.4 from pot
*** SUMMARY ***
Total pot $682.50 | Rake $34.1
Board [Qc 4d 6h 3s 5s]
Seat 1: Lucifer999 folded before Flop (didn't bet)
Seat 2: rahulh1 (button) folded before Flop (didn't bet)
Seat 3: Avaroni (small blind) folded on the River
Seat 4: No username  (big blind) showed [Jd 9c] and won ($648.4) with High card, Q
Seat 5: BIG DADDY__ folded before Flop (didn't bet)
Seat 6: Millie folded before Flop (didn't bet)



PokerStars Game #00327543221: Hold'em No Limit ($50/$100 USD) - 2022/04/30 11:05:50 ET
Table 'Hold'em (Min 25KMax 10K)    69' 6-max Seat #5 is the button
Seat 1: Lucifer999 ($20084.21 in chips) 
Seat 3: Mpr@59  ($2437.8 in chips) 
Seat 4: vinuth ($10152 in chips) 
Seat 5: tabby20 ($29702.18 in chips) 
Seat 6: manny007 ($3290.97 in chips) 
manny007: posts small blind $50
Lucifer999: posts big blind $100
*** HOLE CARDS ***
Dealt to Lucifer999 [Tc 8h]
Mpr@59 : calls $100
vinuth: folds
tabby20: folds
manny007: folds
Lucifer999: checks
*** FLOP *** [Kd Qs 6c]
Lucifer999: checks
Mpr@59 : checks
*** TURN *** [Kd Qs 6c] [Jc]
Lucifer999: checks
Mpr@59 : bets $239
Lucifer999: folds
Uncalled bet ($239) returned to Mpr@59 
Mpr@59 : doesn't show hand
Mpr@59  collected $239 from pot
*** SUMMARY ***
Total pot $250.00 | Rake $11
Board [Kd Qs 6c Jc]
Seat 1: Lucifer999 (big blind) folded on the Turn
Seat 3: Mpr@59  collected ($239)
Seat 4: vinuth folded before Flop (didn't bet)
Seat 5: tabby20 (button) folded before Flop (didn't bet)
Seat 6: manny007 (small blind) folded before Flop



PokerStars Game #00327543235: Hold'em No Limit ($10/$25 USD) - 2022/04/30 11:05:55 ET
Table 'Hold'em (Min 500Max 2500) 1001' 6-max Seat #5 is the button
Seat 1: JaspritBumrah786 ($2025 in chips) 
Seat 2: fishfry123 ($2235.49 in chips) 
Seat 4: devi7 ($3185.11 in chips) 
Seat 5: Lucifer999 ($5906.94 in chips) 
Seat 6: spidy02 ($1826.49 in chips) 
spidy02: posts small blind $10
JaspritBumrah786: posts big blind $25
*** HOLE CARDS ***
Dealt to Lucifer999 [5c Kc]
fishfry123: folds
devi7: folds
Lucifer999: raises $55.00 to $80
spidy02: raises $121.25 to $201.25
JaspritBumrah786: folds
Lucifer999: calls $121.25
*** FLOP *** [Kd 7s 4d]
spidy02: checks
Lucifer999: checks
*** TURN *** [Kd 7s 4d] [3h]
spidy02: bets $200.55
Lucifer999: calls $200.55
*** RIVER *** [Kd 7s 4d 3h] [6d]
spidy02: bets $390.07
Lucifer999: raises $5115.07 to $5505.14
spidy02: calls $1034.62
Uncalled bet ($4080.45) returned to Lucifer999
*** SHOW DOWN ***
Lucifer999: shows [5c Kc] (Straight, 7-3)
spidy02: shows [Qd Ad] (Flush, A high)
spidy02 collected $3479.94 from pot
*** SUMMARY ***
Total pot $3677.98 | Rake $198.04
Board [Kd 7s 4d 3h 6d]
Seat 1: JaspritBumrah786 (big blind) folded before Flop
Seat 2: fishfry123 folded before Flop (didn't bet)
Seat 4: devi7 folded before Flop (didn't bet)
Seat 5: Lucifer999 (button) showed [5c Kc] and lost with Straight, 7-3
Seat 6: spidy02  (small blind) showed [Qd Ad] and won ($3479.94) with Flush, A high



PokerStars Game #00327543312: Hold'em No Limit ($10/$25 USD) - 2022/04/30 11:06:29 ET
Table 'Hold'em (Min 500Max 2500)  1282' 6-max Seat #6 is the button
Seat 2: RaghSaiAyy ($1950.02 in chips) 
Seat 3: Mastkalandar ($2631.44 in chips) 
Seat 4: papadickkies ($840.2 in chips) 
Seat 5: Lucifer999 ($10338.37 in chips) 
Seat 6: devi7 ($4483.25 in chips) 
RaghSaiAyy: posts small blind $10
Mastkalandar: posts big blind $25
*** HOLE CARDS ***
Dealt to Lucifer999 [5s 2h]
papadickkies: folds
Lucifer999: folds
devi7: raises $25.00 to $50
RaghSaiAyy: raises $155.00 to $205
Mastkalandar: folds
devi7: folds
Uncalled bet ($155) returned to RaghSaiAyy
RaghSaiAyy: doesn't show hand
RaghSaiAyy collected $125 from pot
*** SUMMARY ***
Total pot $125.00 | Rake $0
Board []
Seat 2: RaghSaiAyy (small blind) collected ($125)
Seat 3: Mastkalandar (big blind) folded before Flop
Seat 4: papadickkies folded before Flop (didn't bet)
Seat 5: Lucifer999 folded before Flop (didn't bet)
Seat 6: devi7 (button) folded before Flop



PokerStars Game #00327543331: Hold'em No Limit ($25/$50 USD) - 2022/04/30 11:06:35 ET
Table 'Hold'em (Min 1K Max 5K)   216' 6-max Seat #3 is the button
Seat 1: Lucifer999 ($10277.89 in chips) 
Seat 2: rahulh1 ($1342.32 in chips) 
Seat 3: Avaroni ($5000 in chips) 
Seat 4: No username ($7155.36 in chips) 
Seat 5: BIG DADDY__ ($1797.78 in chips) 
Seat 6: Millie ($5075 in chips) 
No username: posts small blind $25
BIG DADDY__: posts big blind $50
*** HOLE CARDS ***
Dealt to Lucifer999 [8s 5h]
Millie: raises $100.00 to $150
Lucifer999: folds
rahulh1: folds
Avaroni: folds
No username: folds
BIG DADDY__: raises $300.00 to $450
Millie: folds
Uncalled bet ($300) returned to BIG DADDY__
BIG DADDY__: doesn't show hand
BIG DADDY__ collected $325 from pot
*** SUMMARY ***
Total pot $325.00 | Rake $0
Board []
Seat 1: Lucifer999 folded before Flop (didn't bet)
Seat 2: rahulh1 folded before Flop (didn't bet)
Seat 3: Avaroni (button) folded before Flop (didn't bet)
Seat 4: No username (small blind) folded before Flop
Seat 5: BIG DADDY__ (big blind) collected ($325)
Seat 6: Millie folded before Flop



PokerStars Game #00327543356: Hold'em No Limit ($50/$100 USD) - 2022/04/30 11:06:46 ET
Table 'Hold'em (Min 25KMax 10K)    69' 6-max Seat #1 is the button
Seat 1: Lucifer999 ($19984.21 in chips) 
Seat 3: Mpr@59  ($2576.8 in chips) 
Seat 4: vinuth ($10152 in chips) 
Seat 5: tabby20 ($29702.18 in chips) 
Seat 6: manny007 ($3240.97 in chips) 
Mpr@59 : posts small blind $50
tabby20: posts big blind $100
*** HOLE CARDS ***
Dealt to Lucifer999 [4d 2s]
Lucifer999: folds
Mpr@59 : raises $100.00 to $200
tabby20: calls $100
*** FLOP *** [3h 6h Qd]
Mpr@59 : checks
tabby20: bets $191.2
Mpr@59 : folds
Uncalled bet ($191.2) returned to tabby20
tabby20: doesn't show hand
tabby20 collected $382.4 from pot
*** SUMMARY ***
Total pot $400.00 | Rake $17.6
Board [3h 6h Qd]
Seat 1: Lucifer999 (button) folded before Flop (didn't bet)
Seat 3: Mpr@59  (small blind) folded on the Flop
Seat 5: tabby20 (big blind) collected ($382.4)



PokerStars Game #00327543418: Hold'em No Limit ($25/$50 USD) - 2022/04/30 11:07:11 ET
Table 'Hold'em (Min 1K Max 5K)   216' 6-max Seat #4 is the button
Seat 1: Lucifer999 ($10277.89 in chips) 
Seat 2: rahulh1 ($1342.32 in chips) 
Seat 3: Avaroni ($5000 in chips) 
Seat 4: No username ($7130.36 in chips) 
Seat 5: BIG DADDY__ ($1972.78 in chips) 
Seat 6: Millie ($5000 in chips) 
BIG DADDY__: posts small blind $25
Millie: posts big blind $50
*** HOLE CARDS ***
Dealt to Lucifer999 [Js 6h]
Lucifer999: folds
rahulh1: folds
Avaroni: folds
No username: folds
BIG DADDY__: folds
Uncalled bet ($25) returned to Millie
Millie: doesn't show hand
Millie collected $50 from pot
*** SUMMARY ***
Total pot $50.00 | Rake $0
Board []
Seat 1: Lucifer999 folded before Flop (didn't bet)
Seat 2: rahulh1 folded before Flop (didn't bet)
Seat 3: Avaroni folded before Flop (didn't bet)
Seat 4: No username (button) folded before Flop (didn't bet)
Seat 5: BIG DADDY__ (small blind) folded before Flop
Seat 6: Millie (big blind) collected ($50)



PokerStars Game #00327543396: Hold'em No Limit ($10/$25 USD) - 2022/04/30 11:07:03 ET
Table 'Hold'em (Min 500Max 2500) 1001' 6-max Seat #6 is the button
Seat 1: JaspritBumrah786 ($2000 in chips) 
Seat 2: fishfry123 ($2235.49 in chips) 
Seat 4: devi7 ($3185.11 in chips) 
Seat 5: Lucifer999 ($4080.45 in chips) 
Seat 6: spidy02 ($3479.94 in chips) 
JaspritBumrah786: posts small blind $10
fishfry123: posts big blind $25
*** HOLE CARDS ***
Dealt to Lucifer999 [Qd 4h]
devi7: raises $50.00 to $75
Lucifer999: folds
spidy02: calls $75
JaspritBumrah786: folds
fishfry123: folds
*** FLOP *** [9s 6d Ac]
devi7: checks
spidy02: bets $130.72
devi7: folds
Uncalled bet ($130.72) returned to spidy02
spidy02: doesn't show hand
spidy02 collected $174.29 from pot
*** SUMMARY ***
Total pot $185.00 | Rake $10.71
Board [9s 6d Ac]
Seat 1: JaspritBumrah786 (small blind) folded before Flop
Seat 2: fishfry123 (big blind) folded before Flop
Seat 4: devi7 folded on the Flop
Seat 5: Lucifer999 folded before Flop (didn't bet)
Seat 6: spidy02 (button) collected ($174.29)



PokerStars Game #00327543410: Hold'em No Limit ($10/$25 USD) - 2022/04/30 11:07:09 ET
Table 'Hold'em (Min 500Max 2500)  1282' 6-max Seat #2 is the button
Seat 2: RaghSaiAyy ($2025.02 in chips) 
Seat 3: Mastkalandar ($2606.44 in chips) 
Seat 4: papadickkies ($840.2 in chips) 
Seat 5: Lucifer999 ($10338.37 in chips) 
Seat 6: devi7 ($4433.25 in chips) 
Mastkalandar: posts small blind $10
papadickkies: posts big blind $25
*** HOLE CARDS ***
Dealt to Lucifer999 [7h 9s]
Lucifer999: folds
devi7: raises $25.00 to $50
RaghSaiAyy: raises $108.75 to $158.75
Mastkalandar: folds
papadickkies: folds
devi7: folds
Uncalled bet ($108.75) returned to RaghSaiAyy
RaghSaiAyy: doesn't show hand
RaghSaiAyy collected $135 from pot
*** SUMMARY ***
Total pot $135.00 | Rake $0
Board []
Seat 2: RaghSaiAyy (button) collected ($135)
Seat 3: Mastkalandar (small blind) folded before Flop
Seat 4: papadickkies (big blind) folded before Flop
Seat 5: Lucifer999 folded before Flop (didn't bet)
Seat 6: devi7 folded before Flop



PokerStars Game #00327543442: Hold'em No Limit ($50/$100 USD) - 2022/04/30 11:07:21 ET
Table 'Hold'em (Min 25KMax 10K)    69' 6-max Seat #3 is the button
Seat 1: Lucifer999 ($19984.21 in chips) 
Seat 3: Mpr@59  ($2376.8 in chips) 
Seat 4: vinuth ($10152 in chips) 
Seat 5: tabby20 ($29884.58 in chips) 
Seat 6: manny007 ($3240.97 in chips) 
tabby20: posts small blind $50
Lucifer999: posts big blind $100
*** HOLE CARDS ***
Dealt to Lucifer999 [3c 2c]
Mpr@59 : folds
tabby20: raises $200.00 to $300
Lucifer999: calls $200
*** FLOP *** [6c Td Ac]
tabby20: bets $500
Lucifer999: calls $500
*** TURN *** [6c Td Ac] [As]
tabby20: checks
Lucifer999: bets $1000
tabby20: folds
Uncalled bet ($1000) returned to Lucifer999
Lucifer999: doesn't show hand
Lucifer999 collected $1529.6 from pot
*** SUMMARY ***
Total pot $1600.00 | Rake $70.4
Board [6c Td Ac As]
Seat 1: Lucifer999 (big blind) collected ($1529.6)
Seat 3: Mpr@59  (button) folded before Flop (didn't bet)
Seat 5: tabby20 (small blind) folded on the Turn



PokerStars Game #00327543528: Hold'em No Limit ($50/$100 USD) - 2022/04/30 11:07:59 ET
Table 'Hold'em (Min 25KMax 10K)    69' 6-max Seat #5 is the button
Seat 1: Lucifer999 ($20713.81 in chips) 
Seat 3: Mpr@59  ($2376.8 in chips) 
Seat 4: vinuth ($10152 in chips) 
Seat 5: tabby20 ($29084.58 in chips) 
Seat 6: manny007 ($3240.97 in chips) 
Lucifer999: posts small blind $50
Mpr@59 : posts big blind $100
*** HOLE CARDS ***
Dealt to Lucifer999 [4h 3h]
tabby20: folds
Lucifer999: folds
Uncalled bet ($50) returned to Mpr@59 
Mpr@59 : doesn't show hand
Mpr@59  collected $100 from pot
*** SUMMARY ***
Total pot $100.00 | Rake $0
Board []
Seat 1: Lucifer999 (small blind) folded before Flop
Seat 3: Mpr@59  (big blind) collected ($100)
Seat 5: tabby20 (button) folded before Flop (didn't bet)



PokerStars Game #00327543506: Hold'em No Limit ($10/$25 USD) - 2022/04/30 11:07:52 ET
Table 'Hold'em (Min 500Max 2500)  1282' 6-max Seat #3 is the button
Seat 1: movetome ($500 in chips) 
Seat 2: RaghSaiAyy ($2110.02 in chips) 
Seat 3: Mastkalandar ($2596.44 in chips) 
Seat 4: papadickkies ($815.2 in chips) 
Seat 5: Lucifer999 ($10338.37 in chips) 
Seat 6: devi7 ($4383.25 in chips) 
papadickkies: posts small blind $10
Lucifer999: posts big blind $25
*** HOLE CARDS ***
Dealt to Lucifer999 [8h Jc]
devi7: folds
RaghSaiAyy: raises $45.00 to $70
Mastkalandar: folds
papadickkies: folds
Lucifer999: folds
Uncalled bet ($45) returned to RaghSaiAyy
RaghSaiAyy: doesn't show hand
RaghSaiAyy collected $60 from pot
*** SUMMARY ***
Total pot $60.00 | Rake $0
Board []
Seat 2: RaghSaiAyy collected ($60)
Seat 3: Mastkalandar (button) folded before Flop (didn't bet)
Seat 4: papadickkies (small blind) folded before Flop
Seat 5: Lucifer999 (big blind) folded before Flop
Seat 6: devi7 folded before Flop (didn't bet)



PokerStars Game #00327543482: Hold'em No Limit ($10/$25 USD) - 2022/04/30 11:07:39 ET
Table 'Hold'em (Min 500Max 2500) 1001' 6-max Seat #1 is the button
Seat 1: JaspritBumrah786 ($2025 in chips) 
Seat 2: fishfry123 ($2210.49 in chips) 
Seat 4: devi7 ($3110.11 in chips) 
Seat 5: Lucifer999 ($4080.45 in chips) 
Seat 6: spidy02 ($3579.23 in chips) 
fishfry123: posts small blind $10
devi7: posts big blind $25
*** HOLE CARDS ***
Dealt to Lucifer999 [7d As]
Lucifer999: folds
spidy02: raises $60.00 to $85
JaspritBumrah786: calls $85
fishfry123: calls $75
devi7: calls $60
*** FLOP *** [Qc 2h 4d]
fishfry123: checks
devi7: bets $159.57
spidy02: calls $159.57
JaspritBumrah786: folds
fishfry123: folds
*** TURN *** [Qc 2h 4d] [Js]
devi7: bets $610
spidy02: folds
Uncalled bet ($610) returned to devi7
devi7: doesn't show hand
devi7 collected $619.55 from pot
*** SUMMARY ***
Total pot $659.14 | Rake $39.59
Board [Qc 2h 4d Js]
Seat 1: JaspritBumrah786 (button) folded on the Flop
Seat 2: fishfry123 (small blind) folded on the Flop
Seat 4: devi7 (big blind) collected ($619.55)
Seat 5: Lucifer999 folded before Flop (didn't bet)
Seat 6: spidy02 folded on the Turn



PokerStars Game #00327543471: Hold'em No Limit ($25/$50 USD) - 2022/04/30 11:07:35 ET
Table 'Hold'em (Min 1K Max 5K)   216' 6-max Seat #5 is the button
Seat 1: Lucifer999 ($10277.89 in chips) 
Seat 2: rahulh1 ($1342.32 in chips) 
Seat 3: Avaroni ($5000 in chips) 
Seat 4: No username ($7130.36 in chips) 
Seat 5: BIG DADDY__ ($1947.78 in chips) 
Seat 6: Millie ($5025 in chips) 
Millie: posts small blind $25
Lucifer999: posts big blind $50
*** HOLE CARDS ***
Dealt to Lucifer999 [8s 6c]
rahulh1: folds
Avaroni: folds
No username: folds
BIG DADDY__: folds
Millie: raises $100.00 to $150
Lucifer999: calls $100
*** FLOP *** [4h 5h 2h]
Millie: checks
Lucifer999: bets $150
Millie: calls $150
*** TURN *** [4h 5h 2h] [6d]
Millie: checks
Lucifer999: checks
*** RIVER *** [4h 5h 2h 6d] [Qh]
Millie: bets $380
Lucifer999: calls $380
*** SHOW DOWN ***
Millie: shows [Th As] (Flush, Q high)
Lucifer999: doesn't show hand
Millie collected $1292 from pot
*** SUMMARY ***
Total pot $1360.00 | Rake $68
Board [4h 5h 2h 6d Qh]
Seat 1: Lucifer999 (big blind) mucked
Seat 2: rahulh1 folded before Flop (didn't bet)
Seat 3: Avaroni folded before Flop (didn't bet)
Seat 4: No username folded before Flop (didn't bet)
Seat 5: BIG DADDY__ (button) folded before Flop (didn't bet)
Seat 6: Millie  (small blind) showed [Th As] and won ($1292) with Flush, Q high



PokerStars Game #00327543581: Hold'em No Limit ($50/$100 USD) - 2022/04/30 11:08:20 ET
Table 'Hold'em (Min 25KMax 10K)    69' 6-max Seat #1 is the button
Seat 1: Lucifer999 ($20663.81 in chips) 
Seat 3: Mpr@59  ($2426.8 in chips) 
Seat 4: vinuth ($10152 in chips) 
Seat 5: tabby20 ($29084.58 in chips) 
Seat 6: manny007 ($3240.97 in chips) 
Mpr@59 : posts small blind $50
tabby20: posts big blind $100
*** HOLE CARDS ***
Dealt to Lucifer999 [5s 4h]
Lucifer999: folds
Mpr@59 : calls $50
tabby20: raises $200.00 to $300
Mpr@59 : folds
Uncalled bet ($200) returned to tabby20
tabby20: doesn't show hand
tabby20 collected $200 from pot
*** SUMMARY ***
Total pot $200.00 | Rake $0
Board []
Seat 1: Lucifer999 (button) folded before Flop (didn't bet)
Seat 3: Mpr@59  (small blind) folded before Flop
Seat 5: tabby20 (big blind) collected ($200)



PokerStars Game #00327543625: Hold'em No Limit ($10/$25 USD) - 2022/04/30 11:08:37 ET
Table 'Hold'em (Min 500Max 2500) 1001' 6-max Seat #2 is the button
Seat 1: JaspritBumrah786 ($2025 in chips) 
Seat 2: fishfry123 ($2125.49 in chips) 
Seat 3: movetome ($500 in chips) 
Seat 4: devi7 ($3485.09 in chips) 
Seat 5: Lucifer999 ($4080.45 in chips) 
Seat 6: spidy02 ($3334.66 in chips) 
devi7: posts small blind $10
Lucifer999: posts big blind $25
*** HOLE CARDS ***
Dealt to Lucifer999 [5d Ks]
spidy02: folds
JaspritBumrah786: folds
fishfry123: folds
devi7: folds
Uncalled bet ($15) returned to Lucifer999
Lucifer999: doesn't show hand
Lucifer999 collected $20 from pot
*** SUMMARY ***
Total pot $20.00 | Rake $0
Board []
Seat 1: JaspritBumrah786 folded before Flop (didn't bet)
Seat 2: fishfry123 (button) folded before Flop (didn't bet)
Seat 4: devi7 (small blind) folded before Flop
Seat 5: Lucifer999 (big blind) collected ($20)
Seat 6: spidy02 folded before Flop (didn't bet)



PokerStars Game #00327543642: Hold'em No Limit ($25/$50 USD) - 2022/04/30 11:08:43 ET
Table 'Hold'em (Min 1K Max 5K)   216' 6-max Seat #6 is the button
Seat 1: Lucifer999 ($9597.89 in chips) 
Seat 2: rahulh1 ($1342.32 in chips) 
Seat 3: Avaroni ($5000 in chips) 
Seat 4: No username ($7130.36 in chips) 
Seat 5: BIG DADDY__ ($1947.78 in chips) 
Seat 6: Millie ($5637 in chips) 
Lucifer999: posts small blind $25
rahulh1: posts big blind $50
*** HOLE CARDS ***
Dealt to Lucifer999 [7h 5c]
Avaroni: folds
No username: folds
BIG DADDY__: folds
Millie: raises $100.00 to $150
Lucifer999: folds
rahulh1: folds
Uncalled bet ($100) returned to Millie
Millie: doesn't show hand
Millie collected $125 from pot
*** SUMMARY ***
Total pot $125.00 | Rake $0
Board []
Seat 1: Lucifer999 (small blind) folded before Flop
Seat 2: rahulh1 (big blind) folded before Flop
Seat 3: Avaroni folded before Flop (didn't bet)
Seat 4: No username folded before Flop (didn't bet)
Seat 5: BIG DADDY__ folded before Flop (didn't bet)
Seat 6: Millie (button) collected ($125)



PokerStars Game #00327543649: Hold'em No Limit ($50/$100 USD) - 2022/04/30 11:08:47 ET
Table 'Hold'em (Min 25KMax 10K)    69' 6-max Seat #3 is the button
Seat 1: Lucifer999 ($20663.81 in chips) 
Seat 3: Mpr@59  ($2326.8 in chips) 
Seat 4: vinuth ($10152 in chips) 
Seat 5: tabby20 ($29184.58 in chips) 
Seat 6: manny007 ($3240.97 in chips) 
tabby20: posts small blind $50
manny007: posts big blind $100
*** HOLE CARDS ***
Dealt to Lucifer999 [3c 7s]
Lucifer999: folds
Mpr@59 : folds
tabby20: folds
Uncalled bet ($50) returned to manny007
manny007: doesn't show hand
manny007 collected $100 from pot
*** SUMMARY ***
Total pot $100.00 | Rake $0
Board []
Seat 1: Lucifer999 folded before Flop (didn't bet)
Seat 3: Mpr@59  (button) folded before Flop (didn't bet)
Seat 5: tabby20 (small blind) folded before Flop
Seat 6: manny007 (big blind) collected ($100)



PokerStars Game #00327543661: Hold'em No Limit ($10/$25 USD) - 2022/04/30 11:08:51 ET
Table 'Hold'em (Min 500Max 2500) 1001' 6-max Seat #4 is the button
Seat 1: JaspritBumrah786 ($2025 in chips) 
Seat 2: fishfry123 ($2125.49 in chips) 
Seat 3: movetome ($500 in chips) 
Seat 4: devi7 ($3475.09 in chips) 
Seat 5: Lucifer999 ($4090.45 in chips) 
Seat 6: spidy02 ($3334.66 in chips) 
Lucifer999: posts small blind $10
spidy02: posts big blind $25
*** HOLE CARDS ***
Dealt to Lucifer999 [4c 5h]
JaspritBumrah786: folds
fishfry123: folds
devi7: folds
Lucifer999: folds
Uncalled bet ($15) returned to spidy02
spidy02: doesn't show hand
spidy02 collected $20 from pot
*** SUMMARY ***
Total pot $20.00 | Rake $0
Board []
Seat 1: JaspritBumrah786 folded before Flop (didn't bet)
Seat 2: fishfry123 folded before Flop (didn't bet)
Seat 4: devi7 (button) folded before Flop (didn't bet)
Seat 5: Lucifer999 (small blind) folded before Flop
Seat 6: spidy02 (big blind) collected ($20)



PokerStars Game #00327543595: Hold'em No Limit ($10/$25 USD) - 2022/04/30 11:08:25 ET
Table 'Hold'em (Min 500Max 2500)  1282' 6-max Seat #4 is the button
Seat 1: movetome ($500 in chips) 
Seat 2: RaghSaiAyy ($2145.02 in chips) 
Seat 3: Mastkalandar ($2596.44 in chips) 
Seat 4: papadickkies ($805.2 in chips) 
Seat 5: Lucifer999 ($10313.37 in chips) 
Seat 6: devi7 ($4383.25 in chips) 
Lucifer999: posts small blind $10
devi7: posts big blind $25
*** HOLE CARDS ***
Dealt to Lucifer999 [9d 3h]
RaghSaiAyy: raises $45.00 to $70
Mastkalandar: raises $130.00 to $200
papadickkies: folds
Lucifer999: folds
devi7: folds
RaghSaiAyy: calls $130
*** FLOP *** [Jd Ah 2h]
RaghSaiAyy: checks
Mastkalandar: checks
*** TURN *** [Jd Ah 2h] [Qd]
RaghSaiAyy: checks
Mastkalandar: checks
*** RIVER *** [Jd Ah 2h Qd] [Ad]
RaghSaiAyy: checks
Mastkalandar: checks
*** SHOW DOWN ***
Mastkalandar: shows [9c 9h] (Two pairs, AA99)
RaghSaiAyy: doesn't show hand
Mastkalandar collected $408.17 from pot
*** SUMMARY ***
Total pot $435.00 | Rake $26.83
Board [Jd Ah 2h Qd Ad]
Seat 2: RaghSaiAyy mucked
Seat 3: Mastkalandar  showed [9c 9h] and won ($408.17) with Two pairs, AA99
Seat 4: papadickkies (button) folded before Flop (didn't bet)
Seat 5: Lucifer999 (small blind) folded before Flop
Seat 6: devi7 (big blind) folded before Flop



PokerStars Game #00327543711: Hold'em No Limit ($10/$25 USD) - 2022/04/30 11:09:16 ET
Table 'Hold'em (Min 500Max 2500) 1001' 6-max Seat #5 is the button
Seat 1: JaspritBumrah786 ($2025 in chips) 
Seat 2: fishfry123 ($2125.49 in chips) 
Seat 3: movetome ($500 in chips) 
Seat 4: devi7 ($3475.09 in chips) 
Seat 5: Lucifer999 ($4080.45 in chips) 
Seat 6: spidy02 ($3344.66 in chips) 
spidy02: posts small blind $10
JaspritBumrah786: posts big blind $25
*** HOLE CARDS ***
Dealt to Lucifer999 [2d 6c]
fishfry123: folds
devi7: folds
Lucifer999: folds
spidy02: folds
Uncalled bet ($15) returned to JaspritBumrah786
JaspritBumrah786: doesn't show hand
JaspritBumrah786 collected $20 from pot
*** SUMMARY ***
Total pot $20.00 | Rake $0
Board []
Seat 1: JaspritBumrah786 (big blind) collected ($20)
Seat 2: fishfry123 folded before Flop (didn't bet)
Seat 4: devi7 folded before Flop (didn't bet)
Seat 5: Lucifer999 (button) folded before Flop (didn't bet)
Seat 6: spidy02 (small blind) folded before Flop



PokerStars Game #00327543681: Hold'em No Limit ($25/$50 USD) - 2022/04/30 11:09:01 ET
Table 'Hold'em (Min 1K Max 5K)   216' 6-max Seat #1 is the button
Seat 1: Lucifer999 ($9572.89 in chips) 
Seat 2: rahulh1 ($1292.32 in chips) 
Seat 3: Avaroni ($5000 in chips) 
Seat 4: No username ($7130.36 in chips) 
Seat 5: BIG DADDY__ ($1947.78 in chips) 
Seat 6: Millie ($5712 in chips) 
rahulh1: posts small blind $25
Avaroni: posts big blind $50
*** HOLE CARDS ***
Dealt to Lucifer999 [Kh Ah]
No username: raises $81.25 to $131.25
BIG DADDY__: folds
Millie: folds
Lucifer999: raises $368.75 to $500
rahulh1: raises $792.32 to $1292.32
Avaroni: folds
No username: folds
Lucifer999: calls $792.32
*** FLOP *** [6s Tc 2s]
*** FLOP *** [4s 3d Jd]
*** TURN *** [6s Tc 2s] [8c]
*** TURN *** [6s Tc 2s] [5c]
*** RIVER *** [6s Tc 2s 8c] [2c]
*** RIVER *** [6s Tc 2s 8c] [2d]
*** SHOW DOWN ***
Lucifer999: shows [Kh Ah] (Straight, 5-A)
rahulh1: shows [Th Td] (Pair, TT)
rahulh1 collected $1313.82 from pot
Lucifer999 collected $1313.82 from pot
*** SUMMARY ***
Total pot $2765.89 | Rake $138.25
Board [6s Tc 2s 8c 2c]
Seat 1: Lucifer999  (button) showed [Kh Ah] and won ($1313.82) with Straight, 5-A
Seat 2: rahulh1  (small blind) showed [Th Td] and won ($1313.82) with Pair, TT
Seat 3: Avaroni (big blind) folded before Flop
Seat 4: No username folded before Flop
Seat 5: BIG DADDY__ folded before Flop (didn't bet)
Seat 6: Millie folded before Flop (didn't bet)



PokerStars Game #00327543765: Hold'em No Limit ($10/$25 USD) - 2022/04/30 11:09:38 ET
Table 'Hold'em (Min 500Max 2500) 1001' 6-max Seat #6 is the button
Seat 1: JaspritBumrah786 ($2035 in chips) 
Seat 2: fishfry123 ($2125.49 in chips) 
Seat 3: movetome ($500 in chips) 
Seat 4: devi7 ($3475.09 in chips) 
Seat 5: Lucifer999 ($4080.45 in chips) 
Seat 6: spidy02 ($3334.66 in chips) 
JaspritBumrah786: posts small blind $10
fishfry123: posts big blind $25
*** HOLE CARDS ***
Dealt to Lucifer999 [9d 7c]
devi7: folds
Lucifer999: folds
spidy02: folds
JaspritBumrah786: raises $50.00 to $75
fishfry123: folds
Uncalled bet ($50) returned to JaspritBumrah786
JaspritBumrah786: doesn't show hand
JaspritBumrah786 collected $50 from pot
*** SUMMARY ***
Total pot $50.00 | Rake $0
Board []
Seat 1: JaspritBumrah786 (small blind) collected ($50)
Seat 2: fishfry123 (big blind) folded before Flop
Seat 4: devi7 folded before Flop (didn't bet)
Seat 5: Lucifer999 folded before Flop (didn't bet)
Seat 6: spidy02 (button) folded before Flop (didn't bet)



PokerStars Game #00327543694: Hold'em No Limit ($50/$100 USD) - 2022/04/30 11:09:08 ET
Table 'Hold'em (Min 25KMax 10K)    69' 6-max Seat #5 is the button
Seat 1: Lucifer999 ($20663.81 in chips) 
Seat 3: Mpr@59  ($2326.8 in chips) 
Seat 4: vinuth ($10152 in chips) 
Seat 5: tabby20 ($29134.58 in chips) 
Seat 6: manny007 ($3290.97 in chips) 
manny007: posts small blind $50
Lucifer999: posts big blind $100
*** HOLE CARDS ***
Dealt to Lucifer999 [7s 5s]
Mpr@59 : calls $100
tabby20: folds
manny007: calls $50
Lucifer999: checks
*** FLOP *** [Td 6d 9d]
manny007: checks
Lucifer999: checks
Mpr@59 : checks
*** TURN *** [Td 6d 9d] [6h]
manny007: checks
Lucifer999: checks
Mpr@59 : checks
*** RIVER *** [Td 6d 9d 6h] [8h]
manny007: checks
Lucifer999: bets $300
Mpr@59 : folds
manny007: raises $300.00 to $600
Lucifer999: folds
Uncalled bet ($300) returned to manny007
manny007: doesn't show hand
manny007 collected $860.4 from pot
*** SUMMARY ***
Total pot $900.00 | Rake $39.6
Board [Td 6d 9d 6h 8h]
Seat 1: Lucifer999 (big blind) folded on the River
Seat 3: Mpr@59  folded on the River
Seat 5: tabby20 (button) folded before Flop (didn't bet)
Seat 6: manny007 (small blind) collected ($860.4)



PokerStars Game #00327543763: Hold'em No Limit ($10/$25 USD) - 2022/04/30 11:09:37 ET
Table 'Hold'em (Min 500Max 2500)  1282' 6-max Seat #5 is the button
Seat 1: movetome ($500 in chips) 
Seat 2: RaghSaiAyy ($1945.02 in chips) 
Seat 3: Mastkalandar ($2804.61 in chips) 
Seat 4: papadickkies ($805.2 in chips) 
Seat 5: Lucifer999 ($10303.37 in chips) 
Seat 6: devi7 ($4358.25 in chips) 
devi7: posts small blind $10
movetome: posts big blind $25
*** HOLE CARDS ***
Dealt to Lucifer999 [2c Ad]
RaghSaiAyy: raises $38.75 to $63.75
Mastkalandar: folds
papadickkies: folds
Lucifer999: folds
devi7: folds
movetome: folds
Uncalled bet ($38.75) returned to RaghSaiAyy
RaghSaiAyy: doesn't show hand
RaghSaiAyy collected $60 from pot
*** SUMMARY ***
Total pot $60.00 | Rake $0
Board []
Seat 1: movetome (big blind) folded before Flop
Seat 2: RaghSaiAyy collected ($60)
Seat 3: Mastkalandar folded before Flop (didn't bet)
Seat 4: papadickkies folded before Flop (didn't bet)
Seat 5: Lucifer999 (button) folded before Flop (didn't bet)
Seat 6: devi7 (small blind) folded before Flop



PokerStars Game #00327543775: Hold'em No Limit ($25/$50 USD) - 2022/04/30 11:09:46 ET
Table 'Hold'em (Min 1K Max 5K)   216' 6-max Seat #2 is the button
Seat 1: Lucifer999 ($9594.39 in chips) 
Seat 2: rahulh1 ($1313.82 in chips) 
Seat 3: Avaroni ($5000 in chips) 
Seat 4: No username ($6999.11 in chips) 
Seat 5: BIG DADDY__ ($1947.78 in chips) 
Seat 6: Millie ($5712 in chips) 
Avaroni: posts small blind $25
No username: posts big blind $50
*** HOLE CARDS ***
Dealt to Lucifer999 [Jh Qc]
BIG DADDY__: folds
Millie: folds
Lucifer999: raises $100.00 to $150
rahulh1: folds
Avaroni: folds
No username: calls $100
*** FLOP *** [2s Qd Qh]
No username: checks
Lucifer999: bets $150
No username: folds
Uncalled bet ($150) returned to Lucifer999
Lucifer999: doesn't show hand
Lucifer999 collected $308.75 from pot
*** SUMMARY ***
Total pot $325.00 | Rake $16.25
Board [2s Qd Qh]
Seat 1: Lucifer999 collected ($308.75)
Seat 2: rahulh1 (button) folded before Flop (didn't bet)
Seat 3: Avaroni (small blind) folded before Flop
Seat 4: No username (big blind) folded on the Flop
Seat 5: BIG DADDY__ folded before Flop (didn't bet)
Seat 6: Millie folded before Flop (didn't bet)



PokerStars Game #00327543826: Hold'em No Limit ($50/$100 USD) - 2022/04/30 11:10:07 ET
Table 'Hold'em (Min 25KMax 10K)    69' 6-max Seat #6 is the button
Seat 1: Lucifer999 ($20263.81 in chips) 
Seat 3: Mpr@59  ($2226.8 in chips) 
Seat 4: vinuth ($10152 in chips) 
Seat 5: tabby20 ($29134.58 in chips) 
Seat 6: manny007 ($3751.37 in chips) 
Lucifer999: posts small blind $50
Mpr@59 : posts big blind $100
*** HOLE CARDS ***
Dealt to Lucifer999 [2c Kc]
tabby20: folds
manny007: folds
Lucifer999: folds
Uncalled bet ($50) returned to Mpr@59 
Mpr@59 : doesn't show hand
Mpr@59  collected $100 from pot
*** SUMMARY ***
Total pot $100.00 | Rake $0
Board []
Seat 1: Lucifer999 (small blind) folded before Flop
Seat 3: Mpr@59  (big blind) collected ($100)
Seat 5: tabby20 folded before Flop (didn't bet)
Seat 6: manny007 (button) folded before Flop (didn't bet)



PokerStars Game #00327543829: Hold'em No Limit ($10/$25 USD) - 2022/04/30 11:10:08 ET
Table 'Hold'em (Min 500Max 2500)  1282' 6-max Seat #6 is the button
Seat 1: movetome ($475 in chips) 
Seat 2: RaghSaiAyy ($1980.02 in chips) 
Seat 3: Mastkalandar ($2804.61 in chips) 
Seat 4: papadickkies ($805.2 in chips) 
Seat 5: Lucifer999 ($10303.37 in chips) 
Seat 6: devi7 ($4348.25 in chips) 
movetome: posts small blind $10
RaghSaiAyy: posts big blind $25
*** HOLE CARDS ***
Dealt to Lucifer999 [Kh 7h]
Mastkalandar: folds
papadickkies: folds
Lucifer999: folds
devi7: folds
movetome: folds
Uncalled bet ($15) returned to RaghSaiAyy
RaghSaiAyy: doesn't show hand
RaghSaiAyy collected $20 from pot
*** SUMMARY ***
Total pot $20.00 | Rake $0
Board []
Seat 1: movetome (small blind) folded before Flop
Seat 2: RaghSaiAyy (big blind) collected ($20)
Seat 3: Mastkalandar folded before Flop (didn't bet)
Seat 4: papadickkies folded before Flop (didn't bet)
Seat 5: Lucifer999 folded before Flop (didn't bet)
Seat 6: devi7 (button) folded before Flop (didn't bet)



PokerStars Game #00327543879: Hold'em No Limit ($25/$50 USD) - 2022/04/30 11:10:29 ET
Table 'Hold'em (Min 1K Max 5K)   216' 6-max Seat #3 is the button
Seat 1: Lucifer999 ($9753.14 in chips) 
Seat 2: rahulh1 ($1313.82 in chips) 
Seat 3: Avaroni ($5000 in chips) 
Seat 4: No username ($6849.11 in chips) 
Seat 5: BIG DADDY__ ($1947.78 in chips) 
Seat 6: Millie ($5712 in chips) 
No username: posts small blind $25
BIG DADDY__: posts big blind $50
*** HOLE CARDS ***
Dealt to Lucifer999 [7d 9h]
Millie: calls $50
Lucifer999: folds
rahulh1: folds
Avaroni: raises $100.00 to $150
No username: folds
BIG DADDY__: calls $100
Millie: raises $475.00 to $625
Avaroni: folds
BIG DADDY__: folds
Uncalled bet ($475) returned to Millie
Millie: doesn't show hand
Millie collected $475 from pot
*** SUMMARY ***
Total pot $475.00 | Rake $0
Board []
Seat 1: Lucifer999 folded before Flop (didn't bet)
Seat 2: rahulh1 folded before Flop (didn't bet)
Seat 3: Avaroni (button) folded before Flop
Seat 4: No username (small blind) folded before Flop
Seat 5: BIG DADDY__ (big blind) folded before Flop
Seat 6: Millie collected ($475)



PokerStars Game #00327543896: Hold'em No Limit ($10/$25 USD) - 2022/04/30 11:10:36 ET
Table 'Hold'em (Min 500Max 2500)  1282' 6-max Seat #1 is the button
Seat 1: movetome ($2025 in chips) 
Seat 2: RaghSaiAyy ($1990.02 in chips) 
Seat 3: Mastkalandar ($2804.61 in chips) 
Seat 4: papadickkies ($805.2 in chips) 
Seat 5: Lucifer999 ($10303.37 in chips) 
Seat 6: devi7 ($4348.25 in chips) 
RaghSaiAyy: posts small blind $10
Mastkalandar: posts big blind $25
*** HOLE CARDS ***
Dealt to Lucifer999 [5h 3c]
papadickkies: folds
Lucifer999: folds
devi7: folds
movetome: folds
RaghSaiAyy: raises $55.00 to $80
Mastkalandar: folds
Uncalled bet ($55) returned to RaghSaiAyy
RaghSaiAyy: doesn't show hand
RaghSaiAyy collected $50 from pot
*** SUMMARY ***
Total pot $50.00 | Rake $0
Board []
Seat 1: movetome (button) folded before Flop (didn't bet)
Seat 2: RaghSaiAyy (small blind) collected ($50)
Seat 3: Mastkalandar (big blind) folded before Flop
Seat 4: papadickkies folded before Flop (didn't bet)
Seat 5: Lucifer999 folded before Flop (didn't bet)
Seat 6: devi7 folded before Flop (didn't bet)



PokerStars Game #00327543881: Hold'em No Limit ($50/$100 USD) - 2022/04/30 11:10:29 ET
Table 'Hold'em (Min 25KMax 10K)    69' 6-max Seat #1 is the button
Seat 1: Lucifer999 ($20213.81 in chips) 
Seat 3: Mpr@59  ($2276.8 in chips) 
Seat 4: vinuth ($10152 in chips) 
Seat 5: tabby20 ($29134.58 in chips) 
Seat 6: manny007 ($3751.37 in chips) 
Mpr@59 : posts small blind $50
tabby20: posts big blind $100
*** HOLE CARDS ***
Dealt to Lucifer999 [6d Qh]
manny007: calls $100
Lucifer999: folds
Mpr@59 : raises $100.00 to $200
tabby20: calls $100
manny007: calls $100
*** FLOP *** [7s 2h 5s]
Mpr@59 : checks
tabby20: checks
manny007: checks
*** TURN *** [7s 2h 5s] [Ts]
Mpr@59 : checks
tabby20: bets $500
manny007: calls $500
Mpr@59 : folds
*** RIVER *** [7s 2h 5s Ts] [7c]
tabby20: checks
manny007: bets $1147.2
tabby20: folds
Uncalled bet ($1147.2) returned to manny007
manny007: doesn't show hand
manny007 collected $1529.6 from pot
*** SUMMARY ***
Total pot $1600.00 | Rake $70.4
Board [7s 2h 5s Ts 7c]
Seat 1: Lucifer999 (button) folded before Flop (didn't bet)
Seat 3: Mpr@59  (small blind) folded on the Turn
Seat 5: tabby20 (big blind) folded on the River
Seat 6: manny007 collected ($1529.6)



PokerStars Game #00327543825: Hold'em No Limit ($10/$25 USD) - 2022/04/30 11:10:06 ET
Table 'Hold'em (Min 500Max 2500) 1001' 6-max Seat #1 is the button
Seat 1: JaspritBumrah786 ($2125 in chips) 
Seat 2: fishfry123 ($2100.49 in chips) 
Seat 3: movetome ($500 in chips) 
Seat 4: devi7 ($3475.09 in chips) 
Seat 5: Lucifer999 ($4080.45 in chips) 
Seat 6: spidy02 ($3334.66 in chips) 
fishfry123: posts small blind $10
movetome: posts big blind $25
*** HOLE CARDS ***
Dealt to Lucifer999 [Td 3c]
devi7: folds
Lucifer999: folds
spidy02: raises $60.00 to $85
JaspritBumrah786: folds
fishfry123: folds
movetome: raises $415.00 to $500
spidy02: calls $415
*** FLOP *** [4s 8d 2h]
*** TURN *** [4s 8d 2h] [5s]
*** RIVER *** [4s 8d 2h 5s] [Qs]
*** SHOW DOWN ***
movetome: shows [9c 9h] (Pair, 99)
spidy02: shows [8h 8c] (Three of a kind, 888)
spidy02 collected $951.98 from pot
*** SUMMARY ***
Total pot $1010.00 | Rake $58.02
Board [4s 8d 2h 5s Qs]
Seat 1: JaspritBumrah786 (button) folded before Flop (didn't bet)
Seat 2: fishfry123 (small blind) folded before Flop
Seat 3: movetome (big blind) showed [9c 9h] and lost with Pair, 99
Seat 4: devi7 folded before Flop (didn't bet)
Seat 5: Lucifer999 folded before Flop (didn't bet)
Seat 6: spidy02  showed [8h 8c] and won ($951.98) with Three of a kind, 888



PokerStars Game #00327543945: Hold'em No Limit ($25/$50 USD) - 2022/04/30 11:10:59 ET
Table 'Hold'em (Min 1K Max 5K)   216' 6-max Seat #4 is the button
Seat 1: Lucifer999 ($9753.14 in chips) 
Seat 2: rahulh1 ($1313.82 in chips) 
Seat 3: Avaroni ($5000 in chips) 
Seat 4: No username ($6824.11 in chips) 
Seat 5: BIG DADDY__ ($1797.78 in chips) 
Seat 6: Millie ($6037 in chips) 
BIG DADDY__: posts small blind $25
Millie: posts big blind $50
*** HOLE CARDS ***
Dealt to Lucifer999 [6s 4h]
Lucifer999: folds
rahulh1: calls $50
Avaroni: folds
No username: raises $118.75 to $168.75
BIG DADDY__: folds
Millie: folds
rahulh1: calls $118.75
*** FLOP *** [8s Kc 3c]
rahulh1: checks
No username: bets $121.49
rahulh1: folds
Uncalled bet ($121.49) returned to No username
No username: doesn't show hand
No username collected $391.9 from pot
*** SUMMARY ***
Total pot $412.50 | Rake $20.6
Board [8s Kc 3c]
Seat 1: Lucifer999 folded before Flop (didn't bet)
Seat 2: rahulh1 folded on the Flop
Seat 3: Avaroni folded before Flop (didn't bet)
Seat 4: No username (button) collected ($391.9)
Seat 5: BIG DADDY__ (small blind) folded before Flop
Seat 6: Millie (big blind) folded before Flop



PokerStars Game #00327543996: Hold'em No Limit ($50/$100 USD) - 2022/04/30 11:11:23 ET
Table 'Hold'em (Min 25KMax 10K)    69' 6-max Seat #3 is the button
Seat 1: Lucifer999 ($20213.81 in chips) 
Seat 3: Mpr@59  ($2076.8 in chips) 
Seat 4: vinuth ($10152 in chips) 
Seat 5: tabby20 ($28434.58 in chips) 
Seat 6: manny007 ($4580.97 in chips) 
tabby20: posts small blind $50
manny007: posts big blind $100
*** HOLE CARDS ***
Dealt to Lucifer999 [3d 6s]
Lucifer999: folds
Mpr@59 : raises $250.00 to $350
tabby20: folds
manny007: folds
Uncalled bet ($250) returned to Mpr@59 
Mpr@59 : doesn't show hand
Mpr@59  collected $250 from pot
*** SUMMARY ***
Total pot $250.00 | Rake $0
Board []
Seat 1: Lucifer999 folded before Flop (didn't bet)
Seat 3: Mpr@59  (button) collected ($250)
Seat 5: tabby20 (small blind) folded before Flop
Seat 6: manny007 (big blind) folded before Flop



PokerStars Game #00327544024: Hold'em No Limit ($10/$25 USD) - 2022/04/30 11:11:35 ET
Table 'Hold'em (Min 500Max 2500) 1001' 6-max Seat #2 is the button
Seat 1: JaspritBumrah786 ($2125 in chips) 
Seat 2: fishfry123 ($2090.49 in chips) 
Seat 4: devi7 ($3475.09 in chips) 
Seat 5: Lucifer999 ($4080.45 in chips) 
Seat 6: spidy02 ($3786.64 in chips) 
devi7: posts small blind $10
Lucifer999: posts big blind $25
*** HOLE CARDS ***
Dealt to Lucifer999 [2d Ac]
spidy02: folds
JaspritBumrah786: raises $50.00 to $75
fishfry123: folds
devi7: folds
Lucifer999: folds
Uncalled bet ($50) returned to JaspritBumrah786
JaspritBumrah786: doesn't show hand
JaspritBumrah786 collected $60 from pot
*** SUMMARY ***
Total pot $60.00 | Rake $0
Board []
Seat 1: JaspritBumrah786 collected ($60)
Seat 2: fishfry123 (button) folded before Flop (didn't bet)
Seat 4: devi7 (small blind) folded before Flop
Seat 5: Lucifer999 (big blind) folded before Flop
Seat 6: spidy02 folded before Flop (didn't bet)



PokerStars Game #00327543969: Hold'em No Limit ($10/$25 USD) - 2022/04/30 11:11:10 ET
Table 'Hold'em (Min 500Max 2500)  1282' 6-max Seat #2 is the button
Seat 1: movetome ($2025 in chips) 
Seat 2: RaghSaiAyy ($2015.02 in chips) 
Seat 3: Mastkalandar ($2779.61 in chips) 
Seat 4: papadickkies ($805.2 in chips) 
Seat 5: Lucifer999 ($10303.37 in chips) 
Seat 6: devi7 ($4348.25 in chips) 
Mastkalandar: posts small blind $10
papadickkies: posts big blind $25
*** HOLE CARDS ***
Dealt to Lucifer999 [2s 8c]
Lucifer999: folds
devi7: folds
movetome: folds
RaghSaiAyy: folds
Mastkalandar: raises $50.00 to $75
papadickkies: calls $50
*** FLOP *** [Jc Td 6c]
Mastkalandar: checks
papadickkies: checks
*** TURN *** [Jc Td 6c] [Kc]
Mastkalandar: bets $125
papadickkies: folds
Uncalled bet ($125) returned to Mastkalandar
Mastkalandar: doesn't show hand
Mastkalandar collected $141.13 from pot
*** SUMMARY ***
Total pot $150.00 | Rake $8.87
Board [Jc Td 6c Kc]
Seat 1: movetome folded before Flop (didn't bet)
Seat 2: RaghSaiAyy (button) folded before Flop (didn't bet)
Seat 3: Mastkalandar (small blind) collected ($141.13)
Seat 4: papadickkies (big blind) folded on the Turn
Seat 5: Lucifer999 folded before Flop (didn't bet)
Seat 6: devi7 folded before Flop (didn't bet)



PokerStars Game #00327544090: Hold'em No Limit ($10/$25 USD) - 2022/04/30 11:12:01 ET
Table 'Hold'em (Min 500Max 2500) 1001' 6-max Seat #4 is the button
Seat 1: JaspritBumrah786 ($2160 in chips) 
Seat 2: fishfry123 ($2090.49 in chips) 
Seat 4: devi7 ($3465.09 in chips) 
Seat 5: Lucifer999 ($4055.45 in chips) 
Seat 6: spidy02 ($3786.64 in chips) 
Lucifer999: posts small blind $10
spidy02: posts big blind $25
*** HOLE CARDS ***
Dealt to Lucifer999 [2h 5s]
JaspritBumrah786: folds
fishfry123: folds
devi7: folds
Lucifer999: folds
Uncalled bet ($15) returned to spidy02
spidy02: doesn't show hand
spidy02 collected $20 from pot
*** SUMMARY ***
Total pot $20.00 | Rake $0
Board []
Seat 1: JaspritBumrah786 folded before Flop (didn't bet)
Seat 2: fishfry123 folded before Flop (didn't bet)
Seat 4: devi7 (button) folded before Flop (didn't bet)
Seat 5: Lucifer999 (small blind) folded before Flop
Seat 6: spidy02 (big blind) collected ($20)



PokerStars Game #00327544050: Hold'em No Limit ($50/$100 USD) - 2022/04/30 11:11:47 ET
Table 'Hold'em (Min 25KMax 10K)    69' 6-max Seat #5 is the button
Seat 1: Lucifer999 ($20213.81 in chips) 
Seat 3: Mpr@59  ($2226.8 in chips) 
Seat 4: vinuth ($10152 in chips) 
Seat 5: tabby20 ($28384.58 in chips) 
Seat 6: manny007 ($4480.97 in chips) 
manny007: posts small blind $50
Lucifer999: posts big blind $100
*** HOLE CARDS ***
Dealt to Lucifer999 [6h 7c]
Mpr@59 : raises $100.00 to $200
tabby20: raises $500.00 to $700
manny007: folds
Lucifer999: folds
Mpr@59 : raises $1526.80 to $2226.8
tabby20: calls $1526.8
*** FLOP *** [Qh Ad 2c]
*** FLOP *** [6s 8c 7d]
*** TURN *** [Qh Ad 2c] [3d]
*** TURN *** [Qh Ad 2c] [Ah]
*** RIVER *** [Qh Ad 2c 3d] [9h]
*** RIVER *** [Qh Ad 2c 3d] [8d]
*** SHOW DOWN ***
Mpr@59 : shows [Th Td] (Two pairs, TT88)
tabby20: shows [Kh Kd] (Two pairs, KK88)
tabby20 collected $2200.54 from pot
tabby20 collected $2200.53 from pot
*** SUMMARY ***
Total pot $4603.60 | Rake $202.53
Board [Qh Ad 2c 3d 9h]
Seat 1: Lucifer999 (big blind) folded before Flop
Seat 3: Mpr@59  showed [Th Td] and lost with Two pairs, TT88
Seat 5: tabby20  (button) showed [Kh Kd] and won ($2200.53) with Two pairs, KK88
Seat 6: manny007 (small blind) folded before Flop



PokerStars Game #00327544092: Hold'em No Limit ($10/$25 USD) - 2022/04/30 11:12:02 ET
Table 'Hold'em (Min 500Max 2500)  1282' 6-max Seat #3 is the button
Seat 1: movetome ($2025 in chips) 
Seat 2: RaghSaiAyy ($2015.02 in chips) 
Seat 3: Mastkalandar ($2845.74 in chips) 
Seat 4: papadickkies ($730.2 in chips) 
Seat 5: Lucifer999 ($10303.37 in chips) 
Seat 6: devi7 ($4348.25 in chips) 
papadickkies: posts small blind $10
Lucifer999: posts big blind $25
*** HOLE CARDS ***
Dealt to Lucifer999 [5c Td]
devi7: folds
movetome: folds
RaghSaiAyy: folds
Mastkalandar: raises $50.00 to $75
papadickkies: folds
Lucifer999: folds
Uncalled bet ($50) returned to Mastkalandar
Mastkalandar: doesn't show hand
Mastkalandar collected $60 from pot
*** SUMMARY ***
Total pot $60.00 | Rake $0
Board []
Seat 1: movetome folded before Flop (didn't bet)
Seat 2: RaghSaiAyy folded before Flop (didn't bet)
Seat 3: Mastkalandar (button) collected ($60)
Seat 4: papadickkies (small blind) folded before Flop
Seat 5: Lucifer999 (big blind) folded before Flop
Seat 6: devi7 folded before Flop (didn't bet)



PokerStars Game #00327544046: Hold'em No Limit ($25/$50 USD) - 2022/04/30 11:11:46 ET
Table 'Hold'em (Min 1K Max 5K)   216' 6-max Seat #5 is the button
Seat 1: Lucifer999 ($9753.14 in chips) 
Seat 2: rahulh1 ($1145.07 in chips) 
Seat 3: Avaroni ($5000 in chips) 
Seat 4: No username ($7047.26 in chips) 
Seat 5: BIG DADDY__ ($1772.78 in chips) 
Seat 6: Millie ($5987 in chips) 
Millie: posts small blind $25
Lucifer999: posts big blind $50
*** HOLE CARDS ***
Dealt to Lucifer999 [2d 3d]
rahulh1: folds
Avaroni: raises $100.00 to $150
No username: calls $150
BIG DADDY__: folds
Millie: raises $650.00 to $800
Lucifer999: folds
Avaroni: folds
No username: calls $650
*** FLOP *** [8d Jd 3s]
Millie: bets $1100
No username: folds
Uncalled bet ($1100) returned to Millie
Millie: doesn't show hand
Millie collected $1710 from pot
*** SUMMARY ***
Total pot $1800.00 | Rake $90
Board [8d Jd 3s]
Seat 1: Lucifer999 (big blind) folded before Flop
Seat 2: rahulh1 folded before Flop (didn't bet)
Seat 3: Avaroni folded before Flop
Seat 4: No username folded on the Flop
Seat 5: BIG DADDY__ (button) folded before Flop (didn't bet)
Seat 6: Millie (small blind) collected ($1710)



PokerStars Game #00327544135: Hold'em No Limit ($10/$25 USD) - 2022/04/30 11:12:24 ET
Table 'Hold'em (Min 500Max 2500) 1001' 6-max Seat #5 is the button
Seat 1: JaspritBumrah786 ($2160 in chips) 
Seat 2: fishfry123 ($2090.49 in chips) 
Seat 4: devi7 ($3465.09 in chips) 
Seat 5: Lucifer999 ($4045.45 in chips) 
Seat 6: spidy02 ($3796.64 in chips) 
spidy02: posts small blind $10
JaspritBumrah786: posts big blind $25
*** HOLE CARDS ***
Dealt to Lucifer999 [Kc 6c]
fishfry123: folds
devi7: raises $50.00 to $75
Lucifer999: calls $75
spidy02: folds
JaspritBumrah786: folds
*** FLOP *** [Ts 5h 9s]
devi7: checks
Lucifer999: checks
*** TURN *** [Ts 5h 9s] [4d]
devi7: bets $125
Lucifer999: folds
Uncalled bet ($125) returned to devi7
devi7: doesn't show hand
devi7 collected $174.29 from pot
*** SUMMARY ***
Total pot $185.00 | Rake $10.71
Board [Ts 5h 9s 4d]
Seat 1: JaspritBumrah786 (big blind) folded before Flop
Seat 2: fishfry123 folded before Flop (didn't bet)
Seat 4: devi7 collected ($174.29)
Seat 5: Lucifer999 (button) folded on the Turn
Seat 6: spidy02 (small blind) folded before Flop



PokerStars Game #00327544141: Hold'em No Limit ($50/$100 USD) - 2022/04/30 11:12:28 ET
Table 'Hold'em (Min 25KMax 10K)    69' 6-max Seat #6 is the button
Seat 1: Lucifer999 ($20113.81 in chips) 
Seat 3: Mpr@59  ($10000 in chips) 
Seat 4: vinuth ($10152 in chips) 
Seat 5: tabby20 ($30558.85 in chips) 
Seat 6: manny007 ($4430.97 in chips) 
Lucifer999: posts small blind $50
tabby20: posts big blind $100
*** HOLE CARDS ***
Dealt to Lucifer999 [9s 3s]
manny007: calls $100
Lucifer999: calls $50
tabby20: raises $350.00 to $450
manny007: calls $350
Lucifer999: folds
*** FLOP *** [5h As 5d]
tabby20: bets $478
manny007: calls $478
*** TURN *** [5h As 5d] [7c]
tabby20: bets $934.97
manny007: raises $2568.00 to $3502.97
tabby20: calls $2568
*** RIVER *** [5h As 5d 7c] [Tc]
*** RIVER *** [5h As 5d 7c] [6c]
*** SHOW DOWN ***
tabby20: shows [Ah 5s] (Full house, 555AA)
manny007: shows [Ac Qh] (Two pairs, AA55)
tabby20 collected $4283.83 from pot
tabby20 collected $4283.83 from pot
*** SUMMARY ***
Total pot $8961.94 | Rake $394.28
Board [5h As 5d 7c Tc]
Seat 1: Lucifer999 (small blind) folded before Flop
Seat 5: tabby20  (big blind) showed [Ah 5s] and won ($4283.83) with Full house, 555AA
Seat 6: manny007 (button) showed [Ac Qh] and lost with Two pairs, AA55



PokerStars Game #00327544241: Hold'em No Limit ($50/$100 USD) - 2022/04/30 11:13:11 ET
Table 'Hold'em (Min 25KMax 10K)    69' 6-max Seat #1 is the button
Seat 1: Lucifer999 ($20013.81 in chips) 
Seat 3: Mpr@59  ($10000 in chips) 
Seat 4: vinuth ($10152 in chips) 
Seat 5: tabby20 ($34695.54 in chips) 
Lucifer999: posts small blind $50
tabby20: posts big blind $100
*** HOLE CARDS ***
Dealt to Lucifer999 [4s Qd]
Lucifer999: raises $100.00 to $200
tabby20: folds
Uncalled bet ($100) returned to Lucifer999
Lucifer999: doesn't show hand
Lucifer999 collected $200 from pot
*** SUMMARY ***
Total pot $200.00 | Rake $0
Board []
Seat 1: Lucifer999 (button) (small blind) collected ($200)
Seat 5: tabby20 (big blind) folded before Flop



PokerStars Game #00327544182: Hold'em No Limit ($10/$25 USD) - 2022/04/30 11:12:48 ET
Table 'Hold'em (Min 500Max 2500)  1282' 6-max Seat #4 is the button
Seat 1: movetome ($2025 in chips) 
Seat 2: RaghSaiAyy ($2015.02 in chips) 
Seat 3: Mastkalandar ($2880.74 in chips) 
Seat 4: papadickkies ($720.2 in chips) 
Seat 5: Lucifer999 ($10278.37 in chips) 
Seat 6: devi7 ($4348.25 in chips) 
Lucifer999: posts small blind $10
devi7: posts big blind $25
*** HOLE CARDS ***
Dealt to Lucifer999 [7c 2c]
movetome: folds
RaghSaiAyy: folds
Mastkalandar: folds
papadickkies: raises $50.00 to $75
Lucifer999: folds
devi7: folds
Uncalled bet ($50) returned to papadickkies
papadickkies: doesn't show hand
papadickkies collected $60 from pot
*** SUMMARY ***
Total pot $60.00 | Rake $0
Board []
Seat 1: movetome folded before Flop (didn't bet)
Seat 2: RaghSaiAyy folded before Flop (didn't bet)
Seat 3: Mastkalandar folded before Flop (didn't bet)
Seat 4: papadickkies (button) collected ($60)
Seat 5: Lucifer999 (small blind) folded before Flop
Seat 6: devi7 (big blind) folded before Flop



PokerStars Game #00327544268: Hold'em No Limit ($50/$100 USD) - 2022/04/30 11:13:23 ET
Table 'Hold'em (Min 25KMax 10K)    69' 6-max Seat #5 is the button
Seat 1: Lucifer999 ($20113.81 in chips) 
Seat 2: theplaya1 ($5000 in chips) 
Seat 3: Mpr@59  ($10000 in chips) 
Seat 4: vinuth ($10152 in chips) 
Seat 5: tabby20 ($34595.54 in chips) 
Lucifer999: posts small blind $50
theplaya1: posts big blind $100
*** HOLE CARDS ***
Dealt to Lucifer999 [Jd 7d]
Mpr@59 : raises $200.00 to $300
tabby20: folds
Lucifer999: folds
theplaya1: folds
Uncalled bet ($300) returned to Mpr@59 
Mpr@59 : doesn't show hand
Mpr@59  collected $300 from pot
*** SUMMARY ***
Total pot $300.00 | Rake $0
Board []
Seat 1: Lucifer999 (small blind) folded before Flop
Seat 2: theplaya1 (big blind) folded before Flop
Seat 3: Mpr@59  collected ($300)
Seat 5: tabby20 (button) folded before Flop (didn't bet)



PokerStars Game #00327544220: Hold'em No Limit ($10/$25 USD) - 2022/04/30 11:13:02 ET
Table 'Hold'em (Min 500Max 2500) 1001' 6-max Seat #6 is the button
Seat 1: JaspritBumrah786 ($2135 in chips) 
Seat 2: fishfry123 ($2090.49 in chips) 
Seat 4: devi7 ($3564.38 in chips) 
Seat 5: Lucifer999 ($3970.45 in chips) 
Seat 6: spidy02 ($3786.64 in chips) 
JaspritBumrah786: posts small blind $10
fishfry123: posts big blind $25
*** HOLE CARDS ***
Dealt to Lucifer999 [Jh Ks]
devi7: raises $50.00 to $75
Lucifer999: folds
spidy02: folds
JaspritBumrah786: folds
fishfry123: calls $50
*** FLOP *** [9c Kh 2h]
fishfry123: checks
devi7: bets $125
fishfry123: calls $125
*** TURN *** [9c Kh 2h] [5h]
fishfry123: checks
devi7: checks
*** RIVER *** [9c Kh 2h 5h] [Ac]
fishfry123: checks
devi7: bets $140
fishfry123: raises $140.00 to $280
devi7: calls $140
*** SHOW DOWN ***
fishfry123: shows [9s 9d] (Three of a kind, 999)
devi7: doesn't show hand
fishfry123 collected $914.08 from pot
*** SUMMARY ***
Total pot $970.00 | Rake $55.92
Board [9c Kh 2h 5h Ac]
Seat 1: JaspritBumrah786 (small blind) folded before Flop
Seat 2: fishfry123  (big blind) showed [9s 9d] and won ($914.08) with Three of a kind, 999
Seat 4: devi7 mucked
Seat 5: Lucifer999 folded before Flop (didn't bet)
Seat 6: spidy02 (button) folded before Flop (didn't bet)



PokerStars Game #00327544197: Hold'em No Limit ($25/$50 USD) - 2022/04/30 11:12:52 ET
Table 'Hold'em (Min 1K Max 5K)   216' 6-max Seat #6 is the button
Seat 1: Lucifer999 ($9703.14 in chips) 
Seat 2: rahulh1 ($1145.07 in chips) 
Seat 3: Avaroni ($5000 in chips) 
Seat 4: No username ($6247.26 in chips) 
Seat 5: BIG DADDY__ ($1772.78 in chips) 
Seat 6: Millie ($6897 in chips) 
Lucifer999: posts small blind $25
rahulh1: posts big blind $50
*** HOLE CARDS ***
Dealt to Lucifer999 [Qs Ks]
Avaroni: folds
No username: folds
Millie: raises $100.00 to $150
Lucifer999: calls $125
rahulh1: folds
*** FLOP *** [5h 8s Js]
Lucifer999: checks
Millie: bets $225
Lucifer999: raises $475.00 to $700
Millie: calls $475
*** TURN *** [5h 8s Js] [8h]
Lucifer999: bets $1400
Millie: calls $1400
*** RIVER *** [5h 8s Js 8h] [As]
Lucifer999: bets $7453.14
Millie: folds
Uncalled bet ($7453.14) returned to Lucifer999
Lucifer999: doesn't show hand
Lucifer999 collected $4322.5 from pot
*** SUMMARY ***
Total pot $4550.00 | Rake $227.5
Board [5h 8s Js 8h As]
Seat 1: Lucifer999 (small blind) collected ($4322.5)
Seat 2: rahulh1 (big blind) folded before Flop
Seat 3: Avaroni folded before Flop (didn't bet)
Seat 4: No username folded before Flop (didn't bet)
Seat 6: Millie (button) folded on the River



PokerStars Game #00327544328: Hold'em No Limit ($50/$100 USD) - 2022/04/30 11:13:53 ET
Table 'Hold'em (Min 25KMax 10K)    69' 6-max Seat #1 is the button
Seat 1: Lucifer999 ($20063.81 in chips) 
Seat 2: theplaya1 ($4900 in chips) 
Seat 3: Mpr@59  ($10150 in chips) 
Seat 4: vinuth ($10152 in chips) 
Seat 5: tabby20 ($34595.54 in chips) 
theplaya1: posts small blind $50
Mpr@59 : posts big blind $100
*** HOLE CARDS ***
Dealt to Lucifer999 [7h 4s]
tabby20: raises $200.00 to $300
Lucifer999: folds
theplaya1: calls $250
Mpr@59 : calls $200
*** FLOP *** [2h As Th]
theplaya1: checks
Mpr@59 : checks
tabby20: checks
*** TURN *** [2h As Th] [Ts]
theplaya1: bets $430.2
Mpr@59 : folds
tabby20: folds
Uncalled bet ($430.2) returned to theplaya1
theplaya1: doesn't show hand
theplaya1 collected $860.4 from pot
*** SUMMARY ***
Total pot $900.00 | Rake $39.6
Board [2h As Th Ts]
Seat 1: Lucifer999 (button) folded before Flop (didn't bet)
Seat 2: theplaya1 (small blind) collected ($860.4)
Seat 3: Mpr@59  (big blind) folded on the Turn
Seat 5: tabby20 folded on the Turn



PokerStars Game #00327544350: Hold'em No Limit ($25/$50 USD) - 2022/04/30 11:14:02 ET
Table 'Hold'em (Min 1K Max 5K)   216' 6-max Seat #1 is the button
Seat 1: Lucifer999 ($11775.64 in chips) 
Seat 2: rahulh1 ($1095.07 in chips) 
Seat 3: Avaroni ($5000 in chips) 
Seat 4: No username ($6247.26 in chips) 
Seat 5: BIG DADDY__ ($1772.78 in chips) 
Seat 6: Millie ($5000 in chips) 
rahulh1: posts small blind $25
Avaroni: posts big blind $50
*** HOLE CARDS ***
Dealt to Lucifer999 [Ah 7s]
No username: folds
BIG DADDY__: folds
Millie: folds
Lucifer999: raises $100.00 to $150
rahulh1: folds
Avaroni: folds
Uncalled bet ($100) returned to Lucifer999
Lucifer999: doesn't show hand
Lucifer999 collected $125 from pot
*** SUMMARY ***
Total pot $125.00 | Rake $0
Board []
Seat 1: Lucifer999 (button) collected ($125)
Seat 2: rahulh1 (small blind) folded before Flop
Seat 3: Avaroni (big blind) folded before Flop
Seat 4: No username folded before Flop (didn't bet)
Seat 5: BIG DADDY__ folded before Flop (didn't bet)
Seat 6: Millie folded before Flop (didn't bet)



PokerStars Game #00327544343: Hold'em No Limit ($10/$25 USD) - 2022/04/30 11:14:00 ET
Table 'Hold'em (Min 500Max 2500) 1001' 6-max Seat #1 is the button
Seat 1: JaspritBumrah786 ($2125 in chips) 
Seat 2: fishfry123 ($2524.57 in chips) 
Seat 3: Wolffy ($525 in chips) 
Seat 4: devi7 ($3084.38 in chips) 
Seat 5: Lucifer999 ($3970.45 in chips) 
Seat 6: spidy02 ($3786.64 in chips) 
fishfry123: posts small blind $10
Wolffy: posts big blind $25
*** HOLE CARDS ***
Dealt to Lucifer999 [Ks 4s]
devi7: folds
Lucifer999: folds
spidy02: folds
JaspritBumrah786: folds
fishfry123: raises $25.00 to $50
Wolffy: calls $25
*** FLOP *** [Ts 4d Jd]
fishfry123: checks
Wolffy: bets $46.88
fishfry123: folds
Uncalled bet ($46.88) returned to Wolffy
Wolffy: doesn't show hand
Wolffy collected $93.75 from pot
*** SUMMARY ***
Total pot $100.00 | Rake $6.25
Board [Ts 4d Jd]
Seat 1: JaspritBumrah786 (button) folded before Flop (didn't bet)
Seat 2: fishfry123 (small blind) folded on the Flop
Seat 3: Wolffy (big blind) collected ($93.75)
Seat 4: devi7 folded before Flop (didn't bet)
Seat 5: Lucifer999 folded before Flop (didn't bet)
Seat 6: spidy02 folded before Flop (didn't bet)



PokerStars Game #00327544416: Hold'em No Limit ($50/$100 USD) - 2022/04/30 11:14:37 ET
Table 'Hold'em (Min 25KMax 10K)    69' 6-max Seat #2 is the button
Seat 1: Lucifer999 ($20063.81 in chips) 
Seat 2: theplaya1 ($5460.4 in chips) 
Seat 3: Mpr@59  ($9850 in chips) 
Seat 4: vinuth ($10152 in chips) 
Seat 5: tabby20 ($34295.54 in chips) 
Mpr@59 : posts small blind $50
tabby20: posts big blind $100
*** HOLE CARDS ***
Dealt to Lucifer999 [8s 6c]
Lucifer999: folds
theplaya1: raises $131.00 to $231
Mpr@59 : raises $9619.00 to $9850
tabby20: folds
theplaya1: folds
Uncalled bet ($9619) returned to Mpr@59 
Mpr@59 : doesn't show hand
Mpr@59  collected $562 from pot
*** SUMMARY ***
Total pot $562.00 | Rake $0
Board []
Seat 1: Lucifer999 folded before Flop (didn't bet)
Seat 2: theplaya1 (button) folded before Flop
Seat 3: Mpr@59  (small blind) collected ($562)
Seat 5: tabby20 (big blind) folded before Flop



PokerStars Game #00327544281: Hold'em No Limit ($10/$25 USD) - 2022/04/30 11:13:29 ET
Table 'Hold'em (Min 500Max 2500)  1282' 6-max Seat #5 is the button
Seat 1: movetome ($2025 in chips) 
Seat 2: RaghSaiAyy ($2015.02 in chips) 
Seat 3: Mastkalandar ($2880.74 in chips) 
Seat 4: papadickkies ($755.2 in chips) 
Seat 5: Lucifer999 ($10268.37 in chips) 
Seat 6: devi7 ($4323.25 in chips) 
devi7: posts small blind $10
movetome: posts big blind $25
*** HOLE CARDS ***
Dealt to Lucifer999 [Kc 7d]
RaghSaiAyy: raises $35.00 to $60
Mastkalandar: folds
papadickkies: folds
Lucifer999: folds
devi7: folds
movetome: raises $140.00 to $200
RaghSaiAyy: calls $140
*** FLOP *** [2c 5c 6s]
movetome: checks
RaghSaiAyy: checks
*** TURN *** [2c 5c 6s] [Jd]
movetome: checks
RaghSaiAyy: bets $165
movetome: raises $485.00 to $650
RaghSaiAyy: folds
Uncalled bet ($485) returned to movetome
movetome: doesn't show hand
movetome collected $696.15 from pot
*** SUMMARY ***
Total pot $740.00 | Rake $43.85
Board [2c 5c 6s Jd]
Seat 1: movetome (big blind) collected ($696.15)
Seat 2: RaghSaiAyy folded on the Turn
Seat 3: Mastkalandar folded before Flop (didn't bet)
Seat 4: papadickkies folded before Flop (didn't bet)
Seat 5: Lucifer999 (button) folded before Flop (didn't bet)
Seat 6: devi7 (small blind) folded before Flop



PokerStars Game #00327544433: Hold'em No Limit ($25/$50 USD) - 2022/04/30 11:14:45 ET
Table 'Hold'em (Min 1K Max 5K)   216' 6-max Seat #2 is the button
Seat 1: Lucifer999 ($11850.64 in chips) 
Seat 2: rahulh1 ($1070.07 in chips) 
Seat 3: Avaroni ($5000 in chips) 
Seat 4: No username ($6247.26 in chips) 
Seat 5: BIG DADDY__ ($1772.78 in chips) 
Seat 6: Millie ($5000 in chips) 
Avaroni: posts small blind $25
No username: posts big blind $50
*** HOLE CARDS ***
Dealt to Lucifer999 [3c 2h]
BIG DADDY__: folds
Lucifer999: folds
rahulh1: folds
Avaroni: folds
Uncalled bet ($25) returned to No username
*** SHOW DOWN ***
No username: shows [5c 6h] ()
No username collected $50 from pot
*** SUMMARY ***
Total pot $50.00 | Rake $0
Board []
Seat 1: Lucifer999 folded before Flop (didn't bet)
Seat 2: rahulh1 (button) folded before Flop (didn't bet)
Seat 3: Avaroni (small blind) folded before Flop
Seat 4: No username (big blind) collected ($50)
Seat 5: BIG DADDY__ folded before Flop (didn't bet)



PokerStars Game #00327544442: Hold'em No Limit ($10/$25 USD) - 2022/04/30 11:14:49 ET
Table 'Hold'em (Min 500Max 2500) 1001' 6-max Seat #2 is the button
Seat 1: JaspritBumrah786 ($2125 in chips) 
Seat 2: fishfry123 ($2474.57 in chips) 
Seat 3: Wolffy ($568.75 in chips) 
Seat 4: devi7 ($3084.38 in chips) 
Seat 5: Lucifer999 ($3970.45 in chips) 
Seat 6: spidy02 ($3786.64 in chips) 
Wolffy: posts small blind $10
devi7: posts big blind $25
*** HOLE CARDS ***
Dealt to Lucifer999 [3d 9h]
Lucifer999: folds
spidy02: raises $60.00 to $85
JaspritBumrah786: folds
fishfry123: folds
Wolffy: folds
devi7: folds
Uncalled bet ($60) returned to spidy02
spidy02: doesn't show hand
spidy02 collected $60 from pot
*** SUMMARY ***
Total pot $60.00 | Rake $0
Board []
Seat 1: JaspritBumrah786 folded before Flop (didn't bet)
Seat 2: fishfry123 (button) folded before Flop (didn't bet)
Seat 3: Wolffy (small blind) folded before Flop
Seat 4: devi7 (big blind) folded before Flop
Seat 5: Lucifer999 folded before Flop (didn't bet)
Seat 6: spidy02 collected ($60)



PokerStars Game #00327544487: Hold'em No Limit ($10/$25 USD) - 2022/04/30 11:15:08 ET
Table 'Hold'em (Min 500Max 2500)  1282' 6-max Seat #6 is the button
Seat 1: movetome ($2500 in chips) 
Seat 2: RaghSaiAyy ($1650.02 in chips) 
Seat 3: Mastkalandar ($2880.74 in chips) 
Seat 4: papadickkies ($755.2 in chips) 
Seat 5: Lucifer999 ($10268.37 in chips) 
Seat 6: devi7 ($4313.25 in chips) 
movetome: posts small blind $10
RaghSaiAyy: posts big blind $25
*** HOLE CARDS ***
Dealt to Lucifer999 [3c Js]
Mastkalandar: folds
papadickkies: folds
Lucifer999: folds
devi7: folds
movetome: folds
Uncalled bet ($15) returned to RaghSaiAyy
RaghSaiAyy: doesn't show hand
RaghSaiAyy collected $20 from pot
*** SUMMARY ***
Total pot $20.00 | Rake $0
Board []
Seat 1: movetome (small blind) folded before Flop
Seat 2: RaghSaiAyy (big blind) collected ($20)
Seat 3: Mastkalandar folded before Flop (didn't bet)
Seat 4: papadickkies folded before Flop (didn't bet)
Seat 5: Lucifer999 folded before Flop (didn't bet)
Seat 6: devi7 (button) folded before Flop (didn't bet)



PokerStars Game #00327544491: Hold'em No Limit ($25/$50 USD) - 2022/04/30 11:15:09 ET
Table 'Hold'em (Min 1K Max 5K)   216' 6-max Seat #3 is the button
Seat 1: Lucifer999 ($11850.64 in chips) 
Seat 2: rahulh1 ($1070.07 in chips) 
Seat 3: Avaroni ($5000 in chips) 
Seat 4: No username ($6272.26 in chips) 
Seat 5: BIG DADDY__ ($1772.78 in chips) 
Seat 6: Millie ($5000 in chips) 
No username: posts small blind $25
BIG DADDY__: posts big blind $50
*** HOLE CARDS ***
Dealt to Lucifer999 [Jd 9s]
Lucifer999: folds
rahulh1: raises $1020.07 to $1070.07
Avaroni: folds
No username: folds
BIG DADDY__: folds
Uncalled bet ($1020.07) returned to rahulh1
rahulh1: doesn't show hand
rahulh1 collected $125 from pot
*** SUMMARY ***
Total pot $125.00 | Rake $0
Board []
Seat 1: Lucifer999 folded before Flop (didn't bet)
Seat 2: rahulh1 collected ($125)
Seat 3: Avaroni (button) folded before Flop (didn't bet)
Seat 4: No username (small blind) folded before Flop
Seat 5: BIG DADDY__ (big blind) folded before Flop



PokerStars Game #00327544481: Hold'em No Limit ($50/$100 USD) - 2022/04/30 11:15:05 ET
Table 'Hold'em (Min 25KMax 10K)    69' 6-max Seat #3 is the button
Seat 1: Lucifer999 ($20063.81 in chips) 
Seat 2: theplaya1 ($5229.4 in chips) 
Seat 3: Mpr@59  ($10181 in chips) 
Seat 4: vinuth ($10152 in chips) 
Seat 5: tabby20 ($34195.54 in chips) 
tabby20: posts small blind $50
Lucifer999: posts big blind $100
*** HOLE CARDS ***
Dealt to Lucifer999 [Ac Th]
theplaya1: folds
Mpr@59 : raises $100.00 to $200
tabby20: folds
Lucifer999: calls $100
*** FLOP *** [3h 3d 3s]
Lucifer999: checks
Mpr@59 : checks
*** TURN *** [3h 3d 3s] [2d]
Lucifer999: bets $300
Mpr@59 : calls $300
*** RIVER *** [3h 3d 3s 2d] [Jc]
Lucifer999: checks
Mpr@59 : checks
*** SHOW DOWN ***
Lucifer999: shows [Ac Th] (Three of a kind, 333)
Mpr@59 : shows [Ah 8s] (Three of a kind, 333)
Lucifer999 collected $501.9 from pot
Mpr@59  collected $501.9 from pot
*** SUMMARY ***
Total pot $1050.00 | Rake $46.2
Board [3h 3d 3s 2d Jc]
Seat 1: Lucifer999  (big blind) showed [Ac Th] and won ($501.9) with Three of a kind, 333
Seat 2: theplaya1 folded before Flop (didn't bet)
Seat 3: Mpr@59   (button) showed [Ah 8s] and won ($501.9) with Three of a kind, 333
Seat 5: tabby20 (small blind) folded before Flop



PokerStars Game #00327544506: Hold'em No Limit ($10/$25 USD) - 2022/04/30 11:15:16 ET
Table 'Hold'em (Min 500Max 2500) 1001' 6-max Seat #3 is the button
Seat 1: JaspritBumrah786 ($2125 in chips) 
Seat 2: fishfry123 ($2474.57 in chips) 
Seat 3: Wolffy ($558.75 in chips) 
Seat 4: devi7 ($3059.38 in chips) 
Seat 5: Lucifer999 ($3970.45 in chips) 
Seat 6: spidy02 ($3821.64 in chips) 
devi7: posts small blind $10
Lucifer999: posts big blind $25
*** HOLE CARDS ***
Dealt to Lucifer999 [9s 4d]
spidy02: raises $35.00 to $60
JaspritBumrah786: folds
fishfry123: folds
Wolffy: folds
devi7: folds
Lucifer999: folds
Uncalled bet ($35) returned to spidy02
spidy02: doesn't show hand
spidy02 collected $60 from pot
*** SUMMARY ***
Total pot $60.00 | Rake $0
Board []
Seat 1: JaspritBumrah786 folded before Flop (didn't bet)
Seat 2: fishfry123 folded before Flop (didn't bet)
Seat 3: Wolffy (button) folded before Flop (didn't bet)
Seat 4: devi7 (small blind) folded before Flop
Seat 5: Lucifer999 (big blind) folded before Flop
Seat 6: spidy02 collected ($60)



PokerStars Game #00327544542: Hold'em No Limit ($10/$25 USD) - 2022/04/30 11:15:34 ET
Table 'Hold'em (Min 500Max 2500)  1282' 6-max Seat #1 is the button
Seat 1: movetome ($2490 in chips) 
Seat 2: RaghSaiAyy ($1660.02 in chips) 
Seat 3: Mastkalandar ($2880.74 in chips) 
Seat 4: papadickkies ($755.2 in chips) 
Seat 5: Lucifer999 ($10268.37 in chips) 
Seat 6: devi7 ($4313.25 in chips) 
RaghSaiAyy: posts small blind $10
Mastkalandar: posts big blind $25
*** HOLE CARDS ***
Dealt to Lucifer999 [7c 5h]
papadickkies: folds
Lucifer999: folds
devi7: folds
movetome: folds
RaghSaiAyy: raises $50.00 to $75
Mastkalandar: folds
Uncalled bet ($50) returned to RaghSaiAyy
RaghSaiAyy: doesn't show hand
RaghSaiAyy collected $50 from pot
*** SUMMARY ***
Total pot $50.00 | Rake $0
Board []
Seat 1: movetome (button) folded before Flop (didn't bet)
Seat 2: RaghSaiAyy (small blind) collected ($50)
Seat 3: Mastkalandar (big blind) folded before Flop
Seat 4: papadickkies folded before Flop (didn't bet)
Seat 5: Lucifer999 folded before Flop (didn't bet)
Seat 6: devi7 folded before Flop (didn't bet)



PokerStars Game #00327544579: Hold'em No Limit ($50/$100 USD) - 2022/04/30 11:15:51 ET
Table 'Hold'em (Min 25KMax 10K)    69' 6-max Seat #5 is the button
Seat 1: Lucifer999 ($20065.71 in chips) 
Seat 2: theplaya1 ($5229.4 in chips) 
Seat 3: Mpr@59  ($10182.9 in chips) 
Seat 4: vinuth ($10152 in chips) 
Seat 5: tabby20 ($34145.54 in chips) 
Lucifer999: posts small blind $50
theplaya1: posts big blind $100
*** HOLE CARDS ***
Dealt to Lucifer999 [7c 2c]
Mpr@59 : folds
tabby20: raises $200.00 to $300
Lucifer999: folds
theplaya1: folds
Uncalled bet ($200) returned to tabby20
tabby20: doesn't show hand
tabby20 collected $250 from pot
*** SUMMARY ***
Total pot $250.00 | Rake $0
Board []
Seat 1: Lucifer999 (small blind) folded before Flop
Seat 2: theplaya1 (big blind) folded before Flop
Seat 3: Mpr@59  folded before Flop (didn't bet)
Seat 5: tabby20 (button) collected ($250)



PokerStars Game #00327544625: Hold'em No Limit ($10/$25 USD) - 2022/04/30 11:16:13 ET
Table 'Hold'em (Min 500Max 2500)  1282' 6-max Seat #2 is the button
Seat 1: movetome ($2490 in chips) 
Seat 2: RaghSaiAyy ($1685.02 in chips) 
Seat 3: Mastkalandar ($2855.74 in chips) 
Seat 4: papadickkies ($755.2 in chips) 
Seat 5: Lucifer999 ($10268.37 in chips) 
Seat 6: devi7 ($4313.25 in chips) 
Mastkalandar: posts small blind $10
papadickkies: posts big blind $25
*** HOLE CARDS ***
Dealt to Lucifer999 [Ah 3s]
Lucifer999: folds
devi7: folds
movetome: folds
RaghSaiAyy: folds
Mastkalandar: folds
Uncalled bet ($15) returned to papadickkies
papadickkies: doesn't show hand
papadickkies collected $20 from pot
*** SUMMARY ***
Total pot $20.00 | Rake $0
Board []
Seat 1: movetome folded before Flop (didn't bet)
Seat 2: RaghSaiAyy (button) folded before Flop (didn't bet)
Seat 3: Mastkalandar (small blind) folded before Flop
Seat 4: papadickkies (big blind) collected ($20)
Seat 5: Lucifer999 folded before Flop (didn't bet)
Seat 6: devi7 folded before Flop (didn't bet)



PokerStars Game #00327544550: Hold'em No Limit ($25/$50 USD) - 2022/04/30 11:15:38 ET
Table 'Hold'em (Min 1K Max 5K)   216' 6-max Seat #4 is the button
Seat 1: Lucifer999 ($11850.64 in chips) 
Seat 2: rahulh1 ($1145.07 in chips) 
Seat 3: Avaroni ($5000 in chips) 
Seat 4: No username ($6247.26 in chips) 
Seat 5: BIG DADDY__ ($1722.78 in chips) 
BIG DADDY__: posts small blind $25
Lucifer999: posts big blind $50
*** HOLE CARDS ***
Dealt to Lucifer999 [9h Ad]
rahulh1: calls $50
Avaroni: folds
No username: raises $118.75 to $168.75
BIG DADDY__: folds
Lucifer999: calls $118.75
rahulh1: calls $118.75
*** FLOP *** [9c Qh 4h]
Lucifer999: checks
rahulh1: checks
No username: bets $252.35
Lucifer999: calls $252.35
rahulh1: folds
*** TURN *** [9c Qh 4h] [Ac]
Lucifer999: checks
No username: checks
*** RIVER *** [9c Qh 4h Ac] [9s]
Lucifer999: bets $950
No username: folds
Uncalled bet ($950) returned to Lucifer999
Lucifer999: doesn't show hand
Lucifer999 collected $984.2 from pot
*** SUMMARY ***
Total pot $1035.95 | Rake $51.75
Board [9c Qh 4h Ac 9s]
Seat 1: Lucifer999 (big blind) collected ($984.2)
Seat 2: rahulh1 folded on the Flop
Seat 3: Avaroni folded before Flop (didn't bet)
Seat 4: No username (button) folded on the River
Seat 5: BIG DADDY__ (small blind) folded before Flop



PokerStars Game #00327544638: Hold'em No Limit ($50/$100 USD) - 2022/04/30 11:16:18 ET
Table 'Hold'em (Min 25KMax 10K)    69' 6-max Seat #1 is the button
Seat 1: Lucifer999 ($20015.71 in chips) 
Seat 2: theplaya1 ($5129.4 in chips) 
Seat 3: Mpr@59  ($10182.9 in chips) 
Seat 4: vinuth ($10152 in chips) 
Seat 5: tabby20 ($34295.54 in chips) 
theplaya1: posts small blind $50
Mpr@59 : posts big blind $100
*** HOLE CARDS ***
Dealt to Lucifer999 [Jc 9c]
tabby20: folds
Lucifer999: folds
theplaya1: folds
Uncalled bet ($50) returned to Mpr@59 
Mpr@59 : doesn't show hand
Mpr@59  collected $100 from pot
*** SUMMARY ***
Total pot $100.00 | Rake $0
Board []
Seat 1: Lucifer999 (button) folded before Flop (didn't bet)
Seat 2: theplaya1 (small blind) folded before Flop
Seat 3: Mpr@59  (big blind) collected ($100)
Seat 5: tabby20 folded before Flop (didn't bet)



PokerStars Game #00327544598: Hold'em No Limit ($10/$25 USD) - 2022/04/30 11:16:01 ET
Table 'Hold'em (Min 500Max 2500) 1001' 6-max Seat #4 is the button
Seat 1: JaspritBumrah786 ($2125 in chips) 
Seat 2: fishfry123 ($2474.57 in chips) 
Seat 3: Wolffy ($558.75 in chips) 
Seat 4: devi7 ($3049.38 in chips) 
Seat 5: Lucifer999 ($3945.45 in chips) 
Seat 6: spidy02 ($3856.64 in chips) 
Lucifer999: posts small blind $10
spidy02: posts big blind $25
*** HOLE CARDS ***
Dealt to Lucifer999 [4s 8h]
JaspritBumrah786: folds
fishfry123: folds
Wolffy: folds
devi7: folds
Lucifer999: folds
Uncalled bet ($15) returned to spidy02
spidy02: doesn't show hand
spidy02 collected $20 from pot
*** SUMMARY ***
Total pot $20.00 | Rake $0
Board []
Seat 1: JaspritBumrah786 folded before Flop (didn't bet)
Seat 2: fishfry123 folded before Flop (didn't bet)
Seat 3: Wolffy folded before Flop (didn't bet)
Seat 4: devi7 (button) folded before Flop (didn't bet)
Seat 5: Lucifer999 (small blind) folded before Flop
Seat 6: spidy02 (big blind) collected ($20)



PokerStars Game #00327544687: Hold'em No Limit ($25/$50 USD) - 2022/04/30 11:16:44 ET
Table 'Hold'em (Min 1K Max 5K)   216' 6-max Seat #5 is the button
Seat 1: Lucifer999 ($12413.74 in chips) 
Seat 2: rahulh1 ($976.32 in chips) 
Seat 3: Avaroni ($5000 in chips) 
Seat 4: No username ($5826.16 in chips) 
Seat 5: BIG DADDY__ ($1697.78 in chips) 
Lucifer999: posts small blind $25
rahulh1: posts big blind $50
*** HOLE CARDS ***
Dealt to Lucifer999 [Th Ac]
Avaroni: folds
No username: folds
BIG DADDY__: folds
Lucifer999: raises $100.00 to $150
rahulh1: calls $100
*** FLOP *** [6c 8c Ad]
Lucifer999: bets $150
rahulh1: folds
Uncalled bet ($150) returned to Lucifer999
Lucifer999: doesn't show hand
Lucifer999 collected $285 from pot
*** SUMMARY ***
Total pot $300.00 | Rake $15
Board [6c 8c Ad]
Seat 1: Lucifer999 (small blind) collected ($285)
Seat 2: rahulh1 (big blind) folded on the Flop
Seat 3: Avaroni folded before Flop (didn't bet)
Seat 4: No username folded before Flop (didn't bet)
Seat 5: BIG DADDY__ (button) folded before Flop (didn't bet)



PokerStars Game #00327544673: Hold'em No Limit ($10/$25 USD) - 2022/04/30 11:16:40 ET
Table 'Hold'em (Min 500Max 2500)  1282' 6-max Seat #3 is the button
Seat 1: movetome ($2490 in chips) 
Seat 2: RaghSaiAyy ($1685.02 in chips) 
Seat 3: Mastkalandar ($2845.74 in chips) 
Seat 4: papadickkies ($765.2 in chips) 
Seat 5: Lucifer999 ($10268.37 in chips) 
Seat 6: devi7 ($4313.25 in chips) 
papadickkies: posts small blind $10
Lucifer999: posts big blind $25
*** HOLE CARDS ***
Dealt to Lucifer999 [7d 5d]
devi7: folds
movetome: folds
RaghSaiAyy: folds
Mastkalandar: folds
papadickkies: raises $35.00 to $60
Lucifer999: calls $35
*** FLOP *** [3h Jd Qc]
papadickkies: checks
Lucifer999: bets $90
papadickkies: folds
Uncalled bet ($90) returned to Lucifer999
Lucifer999: doesn't show hand
Lucifer999 collected $112.7 from pot
*** SUMMARY ***
Total pot $120.00 | Rake $7.3
Board [3h Jd Qc]
Seat 1: movetome folded before Flop (didn't bet)
Seat 2: RaghSaiAyy folded before Flop (didn't bet)
Seat 3: Mastkalandar (button) folded before Flop (didn't bet)
Seat 4: papadickkies (small blind) folded on the Flop
Seat 5: Lucifer999 (big blind) collected ($112.7)
Seat 6: devi7 folded before Flop (didn't bet)



PokerStars Game #00327544685: Hold'em No Limit ($50/$100 USD) - 2022/04/30 11:16:44 ET
Table 'Hold'em (Min 25KMax 10K)    69' 6-max Seat #2 is the button
Seat 1: Lucifer999 ($20015.71 in chips) 
Seat 2: theplaya1 ($5079.4 in chips) 
Seat 3: Mpr@59  ($10232.9 in chips) 
Seat 5: tabby20 ($34295.54 in chips) 
Mpr@59 : posts small blind $50
tabby20: posts big blind $100
*** HOLE CARDS ***
Dealt to Lucifer999 [As 8d]
Lucifer999: folds
theplaya1: raises $131.00 to $231
Mpr@59 : calls $181
tabby20: folds
*** FLOP *** [2h Kd Jc]
Mpr@59 : checks
theplaya1: checks
*** TURN *** [2h Kd Jc] [5s]
Mpr@59 : checks
theplaya1: checks
*** RIVER *** [2h Kd Jc 5s] [3d]
Mpr@59 : bets $537.28
theplaya1: calls $537.28
*** SHOW DOWN ***
Mpr@59 : shows [5c Kh] (Two pairs, KK55)
theplaya1: doesn't show hand
Mpr@59  collected $1564.58 from pot
*** SUMMARY ***
Total pot $1636.56 | Rake $71.98
Board [2h Kd Jc 5s 3d]
Seat 1: Lucifer999 folded before Flop (didn't bet)
Seat 2: theplaya1 (button) mucked
Seat 3: Mpr@59   (small blind) showed [5c Kh] and won ($1564.58) with Two pairs, KK55
Seat 5: tabby20 (big blind) folded before Flop



PokerStars Game #00327544759: Hold'em No Limit ($25/$50 USD) - 2022/04/30 11:17:19 ET
Table 'Hold'em (Min 1K Max 5K)   216' 6-max Seat #1 is the button
Seat 1: Lucifer999 ($12548.74 in chips) 
Seat 2: rahulh1 ($826.32 in chips) 
Seat 3: Avaroni ($5000 in chips) 
Seat 4: No username ($5826.16 in chips) 
Seat 5: BIG DADDY__ ($1697.78 in chips) 
rahulh1: posts small blind $25
Avaroni: posts big blind $50
*** HOLE CARDS ***
Dealt to Lucifer999 [Kc 7s]
No username: folds
BIG DADDY__: raises $125.00 to $175
Lucifer999: folds
rahulh1: folds
Avaroni: folds
Uncalled bet ($125) returned to BIG DADDY__
BIG DADDY__: doesn't show hand
BIG DADDY__ collected $125 from pot
*** SUMMARY ***
Total pot $125.00 | Rake $0
Board []
Seat 1: Lucifer999 (button) folded before Flop (didn't bet)
Seat 2: rahulh1 (small blind) folded before Flop
Seat 3: Avaroni (big blind) folded before Flop
Seat 4: No username folded before Flop (didn't bet)
Seat 5: BIG DADDY__ collected ($125)



PokerStars Game #00327544697: Hold'em No Limit ($10/$25 USD) - 2022/04/30 11:16:49 ET
Table 'Hold'em (Min 500Max 2500) 1001' 6-max Seat #5 is the button
Seat 1: JaspritBumrah786 ($2125 in chips) 
Seat 2: fishfry123 ($2474.57 in chips) 
Seat 3: Wolffy ($558.75 in chips) 
Seat 4: devi7 ($3049.38 in chips) 
Seat 5: Lucifer999 ($3935.45 in chips) 
Seat 6: spidy02 ($3866.64 in chips) 
spidy02: posts small blind $10
JaspritBumrah786: posts big blind $25
*** HOLE CARDS ***
Dealt to Lucifer999 [Qc 2c]
fishfry123: folds
devi7: folds
Lucifer999: folds
spidy02: folds
Uncalled bet ($15) returned to JaspritBumrah786
JaspritBumrah786: doesn't show hand
JaspritBumrah786 collected $20 from pot
*** SUMMARY ***
Total pot $20.00 | Rake $0
Board []
Seat 1: JaspritBumrah786 (big blind) collected ($20)
Seat 2: fishfry123 folded before Flop (didn't bet)
Seat 4: devi7 folded before Flop (didn't bet)
Seat 5: Lucifer999 (button) folded before Flop (didn't bet)
Seat 6: spidy02 (small blind) folded before Flop



PokerStars Game #00327544783: Hold'em No Limit ($50/$100 USD) - 2022/04/30 11:17:31 ET
Table 'Hold'em (Min 25KMax 10K)    69' 6-max Seat #3 is the button
Seat 1: Lucifer999 ($20015.71 in chips) 
Seat 2: theplaya1 ($4311.12 in chips) 
Seat 3: Mpr@59  ($11029.2 in chips) 
Seat 5: tabby20 ($34195.54 in chips) 
tabby20: posts small blind $50
Lucifer999: posts big blind $100
*** HOLE CARDS ***
Dealt to Lucifer999 [2s 3c]
theplaya1: raises $131.00 to $231
Mpr@59 : folds
tabby20: folds
Lucifer999: folds
Uncalled bet ($131) returned to theplaya1
theplaya1: doesn't show hand
theplaya1 collected $250 from pot
*** SUMMARY ***
Total pot $250.00 | Rake $0
Board []
Seat 1: Lucifer999 (big blind) folded before Flop
Seat 2: theplaya1 collected ($250)
Seat 3: Mpr@59  (button) folded before Flop (didn't bet)
Seat 5: tabby20 (small blind) folded before Flop



PokerStars Game #00327544778: Hold'em No Limit ($10/$25 USD) - 2022/04/30 11:17:29 ET
Table 'Hold'em (Min 500Max 2500)  1282' 6-max Seat #4 is the button
Seat 1: movetome ($2490 in chips) 
Seat 2: RaghSaiAyy ($1685.02 in chips) 
Seat 3: Mastkalandar ($2845.74 in chips) 
Seat 4: papadickkies ($705.2 in chips) 
Seat 5: Lucifer999 ($10321.07 in chips) 
Seat 6: devi7 ($4313.25 in chips) 
Lucifer999: posts small blind $10
devi7: posts big blind $25
*** HOLE CARDS ***
Dealt to Lucifer999 [4s Ah]
movetome: raises $50.00 to $75
RaghSaiAyy: folds
Mastkalandar: folds
papadickkies: folds
Lucifer999: folds
devi7: folds
Uncalled bet ($50) returned to movetome
movetome: doesn't show hand
movetome collected $60 from pot
*** SUMMARY ***
Total pot $60.00 | Rake $0
Board []
Seat 1: movetome collected ($60)
Seat 2: RaghSaiAyy folded before Flop (didn't bet)
Seat 3: Mastkalandar folded before Flop (didn't bet)
Seat 4: papadickkies (button) folded before Flop (didn't bet)
Seat 5: Lucifer999 (small blind) folded before Flop
Seat 6: devi7 (big blind) folded before Flop



PokerStars Game #00327544822: Hold'em No Limit ($25/$50 USD) - 2022/04/30 11:17:47 ET
Table 'Hold'em (Min 1K Max 5K)   216' 6-max Seat #2 is the button
Seat 1: Lucifer999 ($12548.74 in chips) 
Seat 2: rahulh1 ($801.32 in chips) 
Seat 3: Avaroni ($5000 in chips) 
Seat 4: No username ($5826.16 in chips) 
Seat 5: BIG DADDY__ ($1772.78 in chips) 
Avaroni: posts small blind $25
No username: posts big blind $50
*** HOLE CARDS ***
Dealt to Lucifer999 [9c 3h]
BIG DADDY__: folds
Lucifer999: folds
rahulh1: folds
Avaroni: folds
Uncalled bet ($25) returned to No username
No username: doesn't show hand
No username collected $50 from pot
*** SUMMARY ***
Total pot $50.00 | Rake $0
Board []
Seat 1: Lucifer999 folded before Flop (didn't bet)
Seat 2: rahulh1 (button) folded before Flop (didn't bet)
Seat 3: Avaroni (small blind) folded before Flop
Seat 4: No username (big blind) collected ($50)
Seat 5: BIG DADDY__ folded before Flop (didn't bet)



PokerStars Game #00327544839: Hold'em No Limit ($10/$25 USD) - 2022/04/30 11:17:53 ET
Table 'Hold'em (Min 500Max 2500) 1001' 6-max Seat #6 is the button
Seat 1: JaspritBumrah786 ($2135 in chips) 
Seat 2: fishfry123 ($2474.57 in chips) 
Seat 3: Wolffy ($558.75 in chips) 
Seat 4: devi7 ($3049.38 in chips) 
Seat 5: Lucifer999 ($3935.45 in chips) 
Seat 6: spidy02 ($3856.64 in chips) 
JaspritBumrah786: posts small blind $10
Wolffy: posts big blind $25
*** HOLE CARDS ***
Dealt to Lucifer999 [Js Kd]
devi7: folds
Lucifer999: raises $55.00 to $80
spidy02: folds
JaspritBumrah786: folds
Wolffy: folds
Uncalled bet ($55) returned to Lucifer999
Lucifer999: doesn't show hand
Lucifer999 collected $60 from pot
*** SUMMARY ***
Total pot $60.00 | Rake $0
Board []
Seat 1: JaspritBumrah786 (small blind) folded before Flop
Seat 3: Wolffy (big blind) folded before Flop
Seat 4: devi7 folded before Flop (didn't bet)
Seat 5: Lucifer999 collected ($60)
Seat 6: spidy02 (button) folded before Flop (didn't bet)



PokerStars Game #00327544845: Hold'em No Limit ($50/$100 USD) - 2022/04/30 11:17:57 ET
Table 'Hold'em (Min 25KMax 10K)    69' 6-max Seat #5 is the button
Seat 1: Lucifer999 ($19915.71 in chips) 
Seat 2: theplaya1 ($4461.12 in chips) 
Seat 3: Mpr@59  ($11029.2 in chips) 
Seat 5: tabby20 ($34145.54 in chips) 
Seat 6: manny007 ($2500 in chips) 
Lucifer999: posts small blind $50
theplaya1: posts big blind $100
*** HOLE CARDS ***
Dealt to Lucifer999 [As 5h]
Mpr@59 : calls $100
tabby20: raises $350.00 to $450
Lucifer999: folds
theplaya1: folds
Mpr@59 : folds
Uncalled bet ($350) returned to tabby20
tabby20: doesn't show hand
tabby20 collected $350 from pot
*** SUMMARY ***
Total pot $350.00 | Rake $0
Board []
Seat 1: Lucifer999 (small blind) folded before Flop
Seat 2: theplaya1 (big blind) folded before Flop
Seat 3: Mpr@59  folded before Flop
Seat 5: tabby20 (button) collected ($350)



PokerStars Game #00327544878: Hold'em No Limit ($25/$50 USD) - 2022/04/30 11:18:11 ET
Table 'Hold'em (Min 1K Max 5K)   216' 6-max Seat #3 is the button
Seat 1: Lucifer999 ($12548.74 in chips) 
Seat 2: rahulh1 ($801.32 in chips) 
Seat 3: Avaroni ($5000 in chips) 
Seat 4: No username ($5851.16 in chips) 
Seat 5: BIG DADDY__ ($1772.78 in chips) 
No username: posts small blind $25
BIG DADDY__: posts big blind $50
*** HOLE CARDS ***
Dealt to Lucifer999 [8h Qh]
Lucifer999: raises $100.00 to $150
rahulh1: raises $651.32 to $801.32
Avaroni: folds
No username: folds
BIG DADDY__: folds
Lucifer999: folds
Uncalled bet ($651.32) returned to rahulh1
rahulh1: doesn't show hand
rahulh1 collected $375 from pot
*** SUMMARY ***
Total pot $375.00 | Rake $0
Board []
Seat 1: Lucifer999 folded before Flop
Seat 2: rahulh1 collected ($375)
Seat 3: Avaroni (button) folded before Flop (didn't bet)
Seat 4: No username (small blind) folded before Flop
Seat 5: BIG DADDY__ (big blind) folded before Flop



PokerStars Game #00327544857: Hold'em No Limit ($10/$25 USD) - 2022/04/30 11:18:03 ET
Table 'Hold'em (Min 500Max 2500)  1282' 6-max Seat #5 is the button
Seat 1: movetome ($2525 in chips) 
Seat 2: RaghSaiAyy ($1685.02 in chips) 
Seat 3: Mastkalandar ($2845.74 in chips) 
Seat 4: papadickkies ($705.2 in chips) 
Seat 5: Lucifer999 ($10311.07 in chips) 
Seat 6: devi7 ($4288.25 in chips) 
devi7: posts small blind $10
movetome: posts big blind $25
*** HOLE CARDS ***
Dealt to Lucifer999 [Ac Qd]
RaghSaiAyy: raises $45.00 to $70
Mastkalandar: folds
papadickkies: folds
Lucifer999: folds
devi7: folds
movetome: folds
Uncalled bet ($45) returned to RaghSaiAyy
RaghSaiAyy: doesn't show hand
RaghSaiAyy collected $60 from pot
*** SUMMARY ***
Total pot $60.00 | Rake $0
Board []
Seat 1: movetome (big blind) folded before Flop
Seat 2: RaghSaiAyy collected ($60)
Seat 3: Mastkalandar folded before Flop (didn't bet)
Seat 4: papadickkies folded before Flop (didn't bet)
Seat 5: Lucifer999 (button) folded before Flop (didn't bet)
Seat 6: devi7 (small blind) folded before Flop



PokerStars Game #00327544929: Hold'em No Limit ($50/$100 USD) - 2022/04/30 11:18:27 ET
Table 'Hold'em (Min 25KMax 10K)    69' 6-max Seat #1 is the button
Seat 1: Lucifer999 ($19865.71 in chips) 
Seat 2: theplaya1 ($4361.12 in chips) 
Seat 3: Mpr@59  ($10929.2 in chips) 
Seat 5: tabby20 ($34395.54 in chips) 
Seat 6: manny007 ($2500 in chips) 
theplaya1: posts small blind $50
Mpr@59 : posts big blind $100
manny007: posts small blind $50
*** HOLE CARDS ***
Dealt to Lucifer999 [5c 2h]
tabby20: raises $300.00 to $400
manny007: folds
Lucifer999: folds
theplaya1: folds
Mpr@59 : calls $300
*** FLOP *** [4d 9h 2s]
Mpr@59 : checks
tabby20: bets $600
Mpr@59 : folds
Uncalled bet ($600) returned to tabby20
tabby20: doesn't show hand
tabby20 collected $860.4 from pot
*** SUMMARY ***
Total pot $900.00 | Rake $39.6
Board [4d 9h 2s]
Seat 1: Lucifer999 (button) folded before Flop (didn't bet)
Seat 2: theplaya1 (small blind) folded before Flop
Seat 3: Mpr@59  (big blind) folded on the Flop
Seat 5: tabby20 collected ($860.4)
Seat 6: manny007 folded before Flop



PokerStars Game #00327544910: Hold'em No Limit ($10/$25 USD) - 2022/04/30 11:18:20 ET
Table 'Hold'em (Min 500Max 2500) 1001' 6-max Seat #1 is the button
Seat 1: JaspritBumrah786 ($2125 in chips) 
Seat 2: fishfry123 ($2474.57 in chips) 
Seat 3: Wolffy ($533.75 in chips) 
Seat 4: devi7 ($3049.38 in chips) 
Seat 5: Lucifer999 ($3970.45 in chips) 
Seat 6: spidy02 ($3856.64 in chips) 
Wolffy: posts small blind $10
devi7: posts big blind $25
*** HOLE CARDS ***
Dealt to Lucifer999 [Qh 5c]
Lucifer999: folds
spidy02: folds
JaspritBumrah786: folds
Wolffy: calls $15
devi7: raises $60.45 to $85.45
Wolffy: calls $60.45
*** FLOP *** [Tc Js Ks]
Wolffy: checks
devi7: bets $75
Wolffy: folds
Uncalled bet ($75) returned to devi7
devi7: doesn't show hand
devi7 collected $160.98 from pot
*** SUMMARY ***
Total pot $170.90 | Rake $9.92
Board [Tc Js Ks]
Seat 1: JaspritBumrah786 (button) folded before Flop (didn't bet)
Seat 3: Wolffy (small blind) folded on the Flop
Seat 4: devi7 (big blind) collected ($160.98)
Seat 5: Lucifer999 folded before Flop (didn't bet)
Seat 6: spidy02 folded before Flop (didn't bet)



PokerStars Game #00327544952: Hold'em No Limit ($25/$50 USD) - 2022/04/30 11:18:38 ET
Table 'Hold'em (Min 1K Max 5K)   216' 6-max Seat #4 is the button
Seat 1: Lucifer999 ($12398.74 in chips) 
Seat 2: rahulh1 ($1026.32 in chips) 
Seat 3: Avaroni ($5000 in chips) 
Seat 4: No username ($5826.16 in chips) 
Seat 5: BIG DADDY__ ($1722.78 in chips) 
BIG DADDY__: posts small blind $25
Lucifer999: posts big blind $50
*** HOLE CARDS ***
Dealt to Lucifer999 [9s 4s]
rahulh1: raises $102.59 to $152.59
Avaroni: folds
No username: raises $271.99 to $424.58
BIG DADDY__: folds
Lucifer999: folds
rahulh1: raises $601.74 to $1026.32
No username: raises $601.74 to $1628.06
Uncalled bet ($601.74) returned to No username
*** FLOP *** [2s 8h 7d]
*** FLOP *** [8s Qs 8c]
*** TURN *** [2s 8h 7d] [6d]
*** TURN *** [2s 8h 7d] [2h]
*** RIVER *** [2s 8h 7d 6d] [As]
*** RIVER *** [2s 8h 7d 6d] [5d]
*** SHOW DOWN ***
rahulh1: shows [Th Ts] (Two pairs, TT88)
No username: shows [Ac Ks] (Pair, 88)
No username collected $1010.65 from pot
rahulh1 collected $1010.64 from pot
*** SUMMARY ***
Total pot $2127.64 | Rake $106.35
Board [2s 8h 7d 6d As]
Seat 1: Lucifer999 (big blind) folded before Flop
Seat 2: rahulh1  showed [Th Ts] and won ($1010.64) with Two pairs, TT88
Seat 3: Avaroni folded before Flop (didn't bet)
Seat 4: No username  (button) showed [Ac Ks] and won ($1010.65) with Pair, 88
Seat 5: BIG DADDY__ (small blind) folded before Flop



PokerStars Game #00327544954: Hold'em No Limit ($10/$25 USD) - 2022/04/30 11:18:39 ET
Table 'Hold'em (Min 500Max 2500)  1282' 6-max Seat #6 is the button
Seat 1: movetome ($2500 in chips) 
Seat 2: RaghSaiAyy ($1720.02 in chips) 
Seat 3: Mastkalandar ($2845.74 in chips) 
Seat 4: papadickkies ($705.2 in chips) 
Seat 5: Lucifer999 ($10311.07 in chips) 
Seat 6: devi7 ($4278.25 in chips) 
movetome: posts small blind $10
RaghSaiAyy: posts big blind $25
*** HOLE CARDS ***
Dealt to Lucifer999 [9c 8s]
Mastkalandar: folds
papadickkies: raises $50.00 to $75
Lucifer999: folds
devi7: folds
movetome: folds
RaghSaiAyy: folds
Uncalled bet ($50) returned to papadickkies
papadickkies: doesn't show hand
papadickkies collected $60 from pot
*** SUMMARY ***
Total pot $60.00 | Rake $0
Board []
Seat 1: movetome (small blind) folded before Flop
Seat 2: RaghSaiAyy (big blind) folded before Flop
Seat 3: Mastkalandar folded before Flop (didn't bet)
Seat 4: papadickkies collected ($60)
Seat 5: Lucifer999 folded before Flop (didn't bet)
Seat 6: devi7 (button) folded before Flop (didn't bet)



PokerStars Game #00327545013: Hold'em No Limit ($50/$100 USD) - 2022/04/30 11:19:05 ET
Table 'Hold'em (Min 25KMax 10K)    69' 6-max Seat #2 is the button
Seat 1: Lucifer999 ($19865.71 in chips) 
Seat 2: theplaya1 ($4311.12 in chips) 
Seat 3: Mpr@59  ($10529.2 in chips) 
Seat 5: tabby20 ($34855.94 in chips) 
Seat 6: manny007 ($2450 in chips) 
Mpr@59 : posts small blind $50
tabby20: posts big blind $100
*** HOLE CARDS ***
Dealt to Lucifer999 [Kd 8s]
manny007: checks
Lucifer999: folds
theplaya1: raises $230.00 to $330
Mpr@59 : raises $910.00 to $1240
tabby20: folds
manny007: folds
theplaya1: calls $910
*** FLOP *** [9d 7h 3c]
Mpr@59 : bets $9289.2
theplaya1: calls $3071.12
Uncalled bet ($6218.08) returned to Mpr@59 
*** TURN *** [9d 7h 3c] [3d]
*** TURN *** [9d 7h 3c] [2s]
*** RIVER *** [9d 7h 3c 3d] [Qs]
*** RIVER *** [9d 7h 3c 3d] [9s]
*** SHOW DOWN ***
theplaya1: shows [9h Th] (Three of a kind, 999)
Mpr@59 : shows [4h 4d] (Two pairs, 9944)
theplaya1 collected $4240.94 from pot
theplaya1 collected $4240.94 from pot
*** SUMMARY ***
Total pot $8872.24 | Rake $390.36
Board [9d 7h 3c 3d Qs]
Seat 1: Lucifer999 folded before Flop (didn't bet)
Seat 2: theplaya1  (button) showed [9h Th] and won ($4240.94) with Three of a kind, 999
Seat 3: Mpr@59  (small blind) showed [4h 4d] and lost with Two pairs, 9944
Seat 5: tabby20 (big blind) folded before Flop
Seat 6: manny007 folded before Flop (didn't bet)



PokerStars Game #00327545041: Hold'em No Limit ($25/$50 USD) - 2022/04/30 11:19:19 ET
Table 'Hold'em (Min 1K Max 5K)   216' 6-max Seat #5 is the button
Seat 1: Lucifer999 ($12348.74 in chips) 
Seat 2: rahulh1 ($1010.64 in chips) 
Seat 3: Avaroni ($5000 in chips) 
Seat 4: No username ($5810.49 in chips) 
Seat 5: BIG DADDY__ ($1697.78 in chips) 
Lucifer999: posts small blind $25
rahulh1: posts big blind $50
*** HOLE CARDS ***
Dealt to Lucifer999 [Tc Kd]
Avaroni: folds
No username: folds
BIG DADDY__: folds
Lucifer999: raises $100.00 to $150
rahulh1: raises $860.64 to $1010.64
Lucifer999: folds
Uncalled bet ($860.64) returned to rahulh1
rahulh1: doesn't show hand
rahulh1 collected $300 from pot
*** SUMMARY ***
Total pot $300.00 | Rake $0
Board []
Seat 1: Lucifer999 (small blind) folded before Flop
Seat 2: rahulh1 (big blind) collected ($300)
Seat 3: Avaroni folded before Flop (didn't bet)
Seat 4: No username folded before Flop (didn't bet)
Seat 5: BIG DADDY__ (button) folded before Flop (didn't bet)



PokerStars Game #00327545028: Hold'em No Limit ($10/$25 USD) - 2022/04/30 11:19:14 ET
Table 'Hold'em (Min 500Max 2500) 1001' 6-max Seat #3 is the button
Seat 1: JaspritBumrah786 ($2125 in chips) 
Seat 2: fishfry123 ($2474.57 in chips) 
Seat 3: Wolffy ($448.3 in chips) 
Seat 4: devi7 ($3124.91 in chips) 
Seat 5: Lucifer999 ($3970.45 in chips) 
Seat 6: spidy02 ($3856.64 in chips) 
devi7: posts small blind $10
Lucifer999: posts big blind $25
fishfry123: posts small & big blinds $35
*** HOLE CARDS ***
Dealt to Lucifer999 [7c 6c]
spidy02: folds
JaspritBumrah786: folds
fishfry123: checks
Wolffy: folds
devi7: raises $75.00 to $110
Lucifer999: raises $390.00 to $500
fishfry123: folds
devi7: folds
Uncalled bet ($390) returned to Lucifer999
Lucifer999: doesn't show hand
Lucifer999 collected $255 from pot
*** SUMMARY ***
Total pot $255.00 | Rake $0
Board []
Seat 1: JaspritBumrah786 folded before Flop (didn't bet)
Seat 2: fishfry123 folded before Flop
Seat 3: Wolffy (button) folded before Flop (didn't bet)
Seat 4: devi7 (small blind) folded before Flop
Seat 5: Lucifer999 (big blind) collected ($255)
Seat 6: spidy02 folded before Flop (didn't bet)



PokerStars Game #00327545085: Hold'em No Limit ($50/$100 USD) - 2022/04/30 11:19:40 ET
Table 'Hold'em (Min 25KMax 10K)    69' 6-max Seat #3 is the button
Seat 1: Lucifer999 ($19865.71 in chips) 
Seat 2: theplaya1 ($8481.88 in chips) 
Seat 3: Mpr@59  ($6218.08 in chips) 
Seat 5: tabby20 ($34755.94 in chips) 
Seat 6: manny007 ($2300 in chips) 
tabby20: posts small blind $50
manny007: posts big blind $100
*** HOLE CARDS ***
Dealt to Lucifer999 [7s 4h]
Lucifer999: folds
theplaya1: folds
Mpr@59 : raises $6118.08 to $6218.08
tabby20: folds
manny007: folds
Uncalled bet ($6118.08) returned to Mpr@59 
Mpr@59 : doesn't show hand
Mpr@59  collected $250 from pot
*** SUMMARY ***
Total pot $250.00 | Rake $0
Board []
Seat 1: Lucifer999 folded before Flop (didn't bet)
Seat 2: theplaya1 folded before Flop (didn't bet)
Seat 3: Mpr@59  (button) collected ($250)
Seat 5: tabby20 (small blind) folded before Flop
Seat 6: manny007 (big blind) folded before Flop



PokerStars Game #00327545113: Hold'em No Limit ($25/$50 USD) - 2022/04/30 11:19:52 ET
Table 'Hold'em (Min 1K Max 5K)   216' 6-max Seat #1 is the button
Seat 1: Lucifer999 ($12198.74 in chips) 
Seat 2: rahulh1 ($1160.64 in chips) 
Seat 3: Avaroni ($5000 in chips) 
Seat 4: No username ($5810.49 in chips) 
Seat 5: BIG DADDY__ ($1697.78 in chips) 
rahulh1: posts small blind $25
Avaroni: posts big blind $50
*** HOLE CARDS ***
Dealt to Lucifer999 [Tc 8d]
No username: folds
BIG DADDY__: raises $100.00 to $150
Lucifer999: folds
rahulh1: folds
Avaroni: folds
Uncalled bet ($100) returned to BIG DADDY__
BIG DADDY__: doesn't show hand
BIG DADDY__ collected $125 from pot
*** SUMMARY ***
Total pot $125.00 | Rake $0
Board []
Seat 1: Lucifer999 (button) folded before Flop (didn't bet)
Seat 2: rahulh1 (small blind) folded before Flop
Seat 3: Avaroni (big blind) folded before Flop
Seat 4: No username folded before Flop (didn't bet)
Seat 5: BIG DADDY__ collected ($125)



PokerStars Game #00327545154: Hold'em No Limit ($50/$100 USD) - 2022/04/30 11:20:10 ET
Table 'Hold'em (Min 25KMax 10K)    69' 6-max Seat #5 is the button
Seat 1: Lucifer999 ($19865.71 in chips) 
Seat 2: theplaya1 ($8481.88 in chips) 
Seat 3: Mpr@59  ($6368.08 in chips) 
Seat 5: tabby20 ($34705.94 in chips) 
Seat 6: manny007 ($2200 in chips) 
manny007: posts small blind $50
Lucifer999: posts big blind $100
*** HOLE CARDS ***
Dealt to Lucifer999 [3c 5h]
theplaya1: folds
Mpr@59 : raises $250.00 to $350
tabby20: folds
manny007: folds
Lucifer999: folds
Uncalled bet ($250) returned to Mpr@59 
Mpr@59 : doesn't show hand
Mpr@59  collected $250 from pot
*** SUMMARY ***
Total pot $250.00 | Rake $0
Board []
Seat 1: Lucifer999 (big blind) folded before Flop
Seat 2: theplaya1 folded before Flop (didn't bet)
Seat 3: Mpr@59  collected ($250)
Seat 5: tabby20 (button) folded before Flop (didn't bet)
Seat 6: manny007 (small blind) folded before Flop



PokerStars Game #00327545121: Hold'em No Limit ($10/$25 USD) - 2022/04/30 11:19:54 ET
Table 'Hold'em (Min 500Max 2500) 1001' 6-max Seat #4 is the button
Seat 1: JaspritBumrah786 ($2125 in chips) 
Seat 2: fishfry123 ($2439.57 in chips) 
Seat 3: Wolffy ($448.3 in chips) 
Seat 4: devi7 ($3014.91 in chips) 
Seat 5: Lucifer999 ($4115.45 in chips) 
Seat 6: spidy02 ($3856.64 in chips) 
Lucifer999: posts small blind $10
spidy02: posts big blind $25
*** HOLE CARDS ***
Dealt to Lucifer999 [3d 4h]
JaspritBumrah786: folds
fishfry123: calls $25
Wolffy: folds
devi7: folds
Lucifer999: folds
spidy02: checks
*** FLOP *** [7h 4s Ah]
spidy02: checks
fishfry123: checks
*** TURN *** [7h 4s Ah] [Jd]
spidy02: checks
fishfry123: checks
*** RIVER *** [7h 4s Ah Jd] [3h]
spidy02: checks
fishfry123: bets $25
spidy02: folds
Uncalled bet ($25) returned to fishfry123
fishfry123: doesn't show hand
fishfry123 collected $56.85 from pot
*** SUMMARY ***
Total pot $60.00 | Rake $3.15
Board [7h 4s Ah Jd 3h]
Seat 1: JaspritBumrah786 folded before Flop (didn't bet)
Seat 2: fishfry123 collected ($56.85)
Seat 3: Wolffy folded before Flop (didn't bet)
Seat 4: devi7 (button) folded before Flop (didn't bet)
Seat 5: Lucifer999 (small blind) folded before Flop
Seat 6: spidy02 (big blind) folded on the River



PokerStars Game #00327545043: Hold'em No Limit ($10/$25 USD) - 2022/04/30 11:19:20 ET
Table 'Hold'em (Min 500Max 2500)  1282' 6-max Seat #1 is the button
Seat 1: movetome ($2490 in chips) 
Seat 2: RaghSaiAyy ($1695.02 in chips) 
Seat 3: Mastkalandar ($2845.74 in chips) 
Seat 4: papadickkies ($740.2 in chips) 
Seat 5: Lucifer999 ($10311.07 in chips) 
Seat 6: devi7 ($4278.25 in chips) 
RaghSaiAyy: posts small blind $10
Mastkalandar: posts big blind $25
*** HOLE CARDS ***
Dealt to Lucifer999 [Ts 2s]
papadickkies: folds
Lucifer999: folds
devi7: folds
movetome: raises $50.00 to $75
RaghSaiAyy: raises $165.00 to $240
Mastkalandar: folds
movetome: calls $165
*** FLOP *** [4s Qc 8c]
RaghSaiAyy: checks
movetome: checks
*** TURN *** [4s Qc 8c] [Qd]
RaghSaiAyy: bets $155
movetome: calls $155
*** RIVER *** [4s Qc 8c Qd] [Qs]
RaghSaiAyy: bets $383.61
movetome: calls $383.61
*** SHOW DOWN ***
RaghSaiAyy: shows [5h As] (Three of a kind, QQQ)
movetome: shows [4c 4d] (Full house, QQQ44)
movetome collected $1494.17 from pot
*** SUMMARY ***
Total pot $1582.22 | Rake $88.05
Board [4s Qc 8c Qd Qs]
Seat 1: movetome  (button) showed [4c 4d] and won ($1494.17) with Full house, QQQ44
Seat 2: RaghSaiAyy (small blind) showed [5h As] and lost with Three of a kind, QQQ
Seat 3: Mastkalandar (big blind) folded before Flop
Seat 4: papadickkies folded before Flop (didn't bet)
Seat 5: Lucifer999 folded before Flop (didn't bet)
Seat 6: devi7 folded before Flop (didn't bet)



PokerStars Game #00327545178: Hold'em No Limit ($25/$50 USD) - 2022/04/30 11:20:19 ET
Table 'Hold'em (Min 1K Max 5K)   216' 6-max Seat #2 is the button
Seat 1: Lucifer999 ($12198.74 in chips) 
Seat 2: rahulh1 ($1135.64 in chips) 
Seat 3: Avaroni ($5000 in chips) 
Seat 4: No username ($5810.49 in chips) 
Seat 5: BIG DADDY__ ($1772.78 in chips) 
Avaroni: posts small blind $25
No username: posts big blind $50
*** HOLE CARDS ***
Dealt to Lucifer999 [Ah 6d]
BIG DADDY__: folds
Lucifer999: folds
rahulh1: raises $125.00 to $175
Avaroni: folds
No username: folds
Uncalled bet ($125) returned to rahulh1
rahulh1: doesn't show hand
rahulh1 collected $125 from pot
*** SUMMARY ***
Total pot $125.00 | Rake $0
Board []
Seat 1: Lucifer999 folded before Flop (didn't bet)
Seat 2: rahulh1 (button) collected ($125)
Seat 3: Avaroni (small blind) folded before Flop
Seat 4: No username (big blind) folded before Flop
Seat 5: BIG DADDY__ folded before Flop (didn't bet)



PokerStars Game #00327545212: Hold'em No Limit ($50/$100 USD) - 2022/04/30 11:20:37 ET
Table 'Hold'em (Min 25KMax 10K)    69' 6-max Seat #6 is the button
Seat 1: Lucifer999 ($19765.71 in chips) 
Seat 2: theplaya1 ($8481.88 in chips) 
Seat 3: Mpr@59  ($6518.08 in chips) 
Seat 5: tabby20 ($34705.94 in chips) 
Seat 6: manny007 ($2150 in chips) 
Lucifer999: posts small blind $50
theplaya1: posts big blind $100
*** HOLE CARDS ***
Dealt to Lucifer999 [4c Ah]
Mpr@59 : raises $100.00 to $200
tabby20: folds
manny007: folds
Lucifer999: folds
theplaya1: calls $100
*** FLOP *** [Th Kh 6d]
theplaya1: checks
Mpr@59 : checks
*** TURN *** [Th Kh 6d] [6s]
theplaya1: checks
Mpr@59 : checks
*** RIVER *** [Th Kh 6d 6s] [2c]
theplaya1: checks
Mpr@59 : checks
*** SHOW DOWN ***
Mpr@59 : shows [4d 5h] (Pair, 66)
theplaya1: shows [8c 9d] (Pair, 66)
theplaya1 collected $430.2 from pot
*** SUMMARY ***
Total pot $450.00 | Rake $19.8
Board [Th Kh 6d 6s 2c]
Seat 1: Lucifer999 (small blind) folded before Flop
Seat 2: theplaya1  (big blind) showed [8c 9d] and won ($430.2) with Pair, 66
Seat 3: Mpr@59  showed [4d 5h] and lost with Pair, 66
Seat 5: tabby20 folded before Flop (didn't bet)
Seat 6: manny007 (button) folded before Flop (didn't bet)



PokerStars Game #00327545232: Hold'em No Limit ($10/$25 USD) - 2022/04/30 11:20:42 ET
Table 'Hold'em (Min 500Max 2500)  1282' 6-max Seat #2 is the button
Seat 1: movetome ($3205.56 in chips) 
Seat 2: RaghSaiAyy ($916.41 in chips) 
Seat 3: Mastkalandar ($2820.74 in chips) 
Seat 4: papadickkies ($740.2 in chips) 
Seat 5: Lucifer999 ($10311.07 in chips) 
Seat 6: devi7 ($4278.25 in chips) 
Mastkalandar: posts small blind $10
papadickkies: posts big blind $25
*** HOLE CARDS ***
Dealt to Lucifer999 [Kh 7c]
Lucifer999: folds
devi7: raises $50.00 to $75
movetome: raises $150.00 to $225
RaghSaiAyy: folds
Mastkalandar: raises $375.00 to $600
papadickkies: folds
devi7: folds
movetome: folds
Uncalled bet ($375) returned to Mastkalandar
Mastkalandar: doesn't show hand
Mastkalandar collected $550 from pot
*** SUMMARY ***
Total pot $550.00 | Rake $0
Board []
Seat 1: movetome folded before Flop
Seat 2: RaghSaiAyy (button) folded before Flop (didn't bet)
Seat 3: Mastkalandar (small blind) collected ($550)
Seat 4: papadickkies (big blind) folded before Flop
Seat 5: Lucifer999 folded before Flop (didn't bet)
Seat 6: devi7 folded before Flop



PokerStars Game #00327545310: Hold'em No Limit ($50/$100 USD) - 2022/04/30 11:21:20 ET
Table 'Hold'em (Min 25KMax 10K)    69' 6-max Seat #1 is the button
Seat 1: Lucifer999 ($19715.71 in chips) 
Seat 2: theplaya1 ($8712.08 in chips) 
Seat 3: Mpr@59  ($6318.08 in chips) 
Seat 5: tabby20 ($34705.94 in chips) 
Seat 6: manny007 ($2150 in chips) 
theplaya1: posts small blind $50
Mpr@59 : posts big blind $100
*** HOLE CARDS ***
Dealt to Lucifer999 [4c Jc]
tabby20: raises $250.00 to $350
manny007: calls $350
Lucifer999: folds
theplaya1: folds
Mpr@59 : folds
*** FLOP *** [Qh 2s 6s]
tabby20: checks
manny007: bets $528.26
tabby20: folds
Uncalled bet ($528.26) returned to manny007
manny007: doesn't show hand
manny007 collected $812.6 from pot
*** SUMMARY ***
Total pot $850.00 | Rake $37.4
Board [Qh 2s 6s]
Seat 1: Lucifer999 (button) folded before Flop (didn't bet)
Seat 2: theplaya1 (small blind) folded before Flop
Seat 3: Mpr@59  (big blind) folded before Flop
Seat 5: tabby20 folded on the Flop
Seat 6: manny007 collected ($812.6)



PokerStars Game #00327545228: Hold'em No Limit ($10/$25 USD) - 2022/04/30 11:20:41 ET
Table 'Hold'em (Min 500Max 2500) 1001' 6-max Seat #5 is the button
Seat 1: JaspritBumrah786 ($2125 in chips) 
Seat 2: fishfry123 ($2471.42 in chips) 
Seat 3: Wolffy ($448.3 in chips) 
Seat 4: devi7 ($3014.91 in chips) 
Seat 5: Lucifer999 ($4105.45 in chips) 
Seat 6: spidy02 ($3831.64 in chips) 
spidy02: posts small blind $10
JaspritBumrah786: posts big blind $25
*** HOLE CARDS ***
Dealt to Lucifer999 [7h Ad]
fishfry123: folds
Wolffy: folds
devi7: raises $50.00 to $75
Lucifer999: calls $75
spidy02: folds
JaspritBumrah786: calls $50
*** FLOP *** [8c 7d 4c]
JaspritBumrah786: checks
devi7: checks
Lucifer999: checks
*** TURN *** [8c 7d 4c] [7c]
JaspritBumrah786: checks
devi7: checks
Lucifer999: bets $180
JaspritBumrah786: folds
devi7: calls $180
*** RIVER *** [8c 7d 4c 7c] [Ts]
devi7: checks
Lucifer999: bets $300
devi7: calls $300
*** SHOW DOWN ***
Lucifer999: shows [7h Ad] (Three of a kind, 777)
devi7: doesn't show hand
Lucifer999 collected $1127.27 from pot
*** SUMMARY ***
Total pot $1195.00 | Rake $67.73
Board [8c 7d 4c 7c Ts]
Seat 1: JaspritBumrah786 (big blind) folded on the Turn
Seat 2: fishfry123 folded before Flop (didn't bet)
Seat 3: Wolffy folded before Flop (didn't bet)
Seat 4: devi7 mucked
Seat 5: Lucifer999  (button) showed [7h Ad] and won ($1127.27) with Three of a kind, 777
Seat 6: spidy02 (small blind) folded before Flop



PokerStars Game #00327545329: Hold'em No Limit ($10/$25 USD) - 2022/04/30 11:21:27 ET
Table 'Hold'em (Min 500Max 2500)  1282' 6-max Seat #3 is the button
Seat 1: movetome ($2980.56 in chips) 
Seat 2: RaghSaiAyy ($916.41 in chips) 
Seat 3: Mastkalandar ($3145.74 in chips) 
Seat 4: papadickkies ($715.2 in chips) 
Seat 5: Lucifer999 ($10311.07 in chips) 
Seat 6: devi7 ($4203.25 in chips) 
papadickkies: posts small blind $10
Lucifer999: posts big blind $25
*** HOLE CARDS ***
Dealt to Lucifer999 [Js 3s]
devi7: folds
movetome: folds
RaghSaiAyy: raises $35.00 to $60
Mastkalandar: folds
papadickkies: calls $50
Lucifer999: folds
*** FLOP *** [3c 3h As]
papadickkies: checks
RaghSaiAyy: bets $119.13
papadickkies: folds
Uncalled bet ($119.13) returned to RaghSaiAyy
RaghSaiAyy: doesn't show hand
RaghSaiAyy collected $136.39 from pot
*** SUMMARY ***
Total pot $145.00 | Rake $8.61
Board [3c 3h As]
Seat 1: movetome folded before Flop (didn't bet)
Seat 2: RaghSaiAyy collected ($136.39)
Seat 3: Mastkalandar (button) folded before Flop (didn't bet)
Seat 4: papadickkies (small blind) folded on the Flop
Seat 5: Lucifer999 (big blind) folded before Flop
Seat 6: devi7 folded before Flop (didn't bet)



PokerStars Game #00327545239: Hold'em No Limit ($25/$50 USD) - 2022/04/30 11:20:47 ET
Table 'Hold'em (Min 1K Max 5K)   216' 6-max Seat #3 is the button
Seat 1: Lucifer999 ($12198.74 in chips) 
Seat 2: rahulh1 ($1210.64 in chips) 
Seat 3: Avaroni ($5000 in chips) 
Seat 4: No username ($5760.49 in chips) 
Seat 5: BIG DADDY__ ($1772.78 in chips) 
No username: posts small blind $25
BIG DADDY__: posts big blind $50
*** HOLE CARDS ***
Dealt to Lucifer999 [5h Qh]
Lucifer999: folds
rahulh1: folds
Avaroni: folds
No username: folds
Uncalled bet ($25) returned to BIG DADDY__
BIG DADDY__: doesn't show hand
BIG DADDY__ collected $50 from pot
*** SUMMARY ***
Total pot $50.00 | Rake $0
Board []
Seat 1: Lucifer999 folded before Flop (didn't bet)
Seat 2: rahulh1 folded before Flop (didn't bet)
Seat 3: Avaroni (button) folded before Flop (didn't bet)
Seat 4: No username (small blind) folded before Flop
Seat 5: BIG DADDY__ (big blind) collected ($50)



PokerStars Game #00327545384: Hold'em No Limit ($50/$100 USD) - 2022/04/30 11:21:55 ET
Table 'Hold'em (Min 25KMax 10K)    69' 6-max Seat #2 is the button
Seat 1: Lucifer999 ($19715.71 in chips) 
Seat 2: theplaya1 ($8662.08 in chips) 
Seat 3: Mpr@59  ($6218.08 in chips) 
Seat 5: tabby20 ($34355.94 in chips) 
Seat 6: manny007 ($2612.6 in chips) 
Mpr@59 : posts small blind $50
tabby20: posts big blind $100
*** HOLE CARDS ***
Dealt to Lucifer999 [4s 8d]
manny007: calls $100
Lucifer999: folds
theplaya1: raises $197.00 to $297
Mpr@59 : folds
tabby20: calls $197
manny007: calls $197
*** FLOP *** [2s 5h Tc]
tabby20: checks
manny007: checks
theplaya1: bets $593.74
tabby20: folds
manny007: folds
Uncalled bet ($593.74) returned to theplaya1
theplaya1: doesn't show hand
theplaya1 collected $899.6 from pot
*** SUMMARY ***
Total pot $941.00 | Rake $41.4
Board [2s 5h Tc]
Seat 1: Lucifer999 folded before Flop (didn't bet)
Seat 2: theplaya1 (button) collected ($899.6)
Seat 3: Mpr@59  (small blind) folded before Flop
Seat 5: tabby20 (big blind) folded on the Flop
Seat 6: manny007 folded on the Flop



PokerStars Game #00327545398: Hold'em No Limit ($10/$25 USD) - 2022/04/30 11:21:59 ET
Table 'Hold'em (Min 500Max 2500) 1001' 6-max Seat #6 is the button
Seat 1: JaspritBumrah786 ($2050 in chips) 
Seat 2: fishfry123 ($2471.42 in chips) 
Seat 3: Wolffy ($448.3 in chips) 
Seat 4: devi7 ($2459.91 in chips) 
Seat 5: Lucifer999 ($4677.72 in chips) 
Seat 6: spidy02 ($3821.64 in chips) 
JaspritBumrah786: posts small blind $10
fishfry123: posts big blind $25
*** HOLE CARDS ***
Dealt to Lucifer999 [3h Ts]
Wolffy: folds
devi7: folds
Lucifer999: folds
spidy02: raises $35.00 to $60
JaspritBumrah786: folds
fishfry123: calls $35
*** FLOP *** [4d Jc 6c]
fishfry123: checks
spidy02: checks
*** TURN *** [4d Jc 6c] [9s]
fishfry123: checks
spidy02: checks
*** RIVER *** [4d Jc 6c 9s] [Qd]
fishfry123: checks
spidy02: checks
*** SHOW DOWN ***
spidy02: shows [Kd 3d] (High card, K)
fishfry123: shows [Ad 6s] (Pair, 66)
fishfry123 collected $122.18 from pot
*** SUMMARY ***
Total pot $130.00 | Rake $7.82
Board [4d Jc 6c 9s Qd]
Seat 1: JaspritBumrah786 (small blind) folded before Flop
Seat 2: fishfry123  (big blind) showed [Ad 6s] and won ($122.18) with Pair, 66
Seat 3: Wolffy folded before Flop (didn't bet)
Seat 4: devi7 folded before Flop (didn't bet)
Seat 5: Lucifer999 folded before Flop (didn't bet)
Seat 6: spidy02 (button) showed [Kd 3d] and lost with High card, K



PokerStars Game #00327545465: Hold'em No Limit ($25/$50 USD) - 2022/04/30 11:22:31 ET
Table 'Hold'em (Min 1K Max 5K)   216' 6-max Seat #1 is the button
Seat 1: Lucifer999 ($12198.74 in chips) 
Seat 2: rahulh1 ($1210.64 in chips) 
Seat 3: Avaroni ($5000 in chips) 
Seat 4: No username ($5735.49 in chips) 
rahulh1: posts small blind $25
Avaroni: posts big blind $50
*** HOLE CARDS ***
Dealt to Lucifer999 [5d Ac]
Lucifer999: folds
rahulh1: raises $100.00 to $150
Avaroni: folds
Uncalled bet ($100) returned to rahulh1
rahulh1: doesn't show hand
rahulh1 collected $100 from pot
*** SUMMARY ***
Total pot $100.00 | Rake $0
Board []
Seat 1: Lucifer999 (button) folded before Flop (didn't bet)
Seat 2: rahulh1 (small blind) collected ($100)
Seat 3: Avaroni (big blind) folded before Flop



PokerStars Game #00327545462: Hold'em No Limit ($50/$100 USD) - 2022/04/30 11:22:30 ET
Table 'Hold'em (Min 25KMax 10K)    69' 6-max Seat #3 is the button
Seat 1: Lucifer999 ($19715.71 in chips) 
Seat 2: theplaya1 ($9264.68 in chips) 
Seat 3: Mpr@59  ($6168.08 in chips) 
Seat 5: tabby20 ($34058.94 in chips) 
Seat 6: manny007 ($2315.6 in chips) 
tabby20: posts small blind $50
manny007: posts big blind $100
*** HOLE CARDS ***
Dealt to Lucifer999 [Qh 3d]
Lucifer999: folds
theplaya1: folds
Mpr@59 : raises $250.00 to $350
tabby20: folds
manny007: folds
Uncalled bet ($250) returned to Mpr@59 
Mpr@59 : doesn't show hand
Mpr@59  collected $250 from pot
*** SUMMARY ***
Total pot $250.00 | Rake $0
Board []
Seat 1: Lucifer999 folded before Flop (didn't bet)
Seat 2: theplaya1 folded before Flop (didn't bet)
Seat 3: Mpr@59  (button) collected ($250)
Seat 5: tabby20 (small blind) folded before Flop
Seat 6: manny007 (big blind) folded before Flop



PokerStars Game #00327545463: Hold'em No Limit ($10/$25 USD) - 2022/04/30 11:22:30 ET
Table 'Hold'em (Min 500Max 2500)  1282' 6-max Seat #4 is the button
Seat 1: movetome ($2980.56 in chips) 
Seat 2: RaghSaiAyy ($992.8 in chips) 
Seat 3: Mastkalandar ($3145.74 in chips) 
Seat 4: papadickkies ($655.2 in chips) 
Seat 5: Lucifer999 ($10286.07 in chips) 
Seat 6: devi7 ($4203.25 in chips) 
Lucifer999: posts small blind $10
devi7: posts big blind $25
*** HOLE CARDS ***
Dealt to Lucifer999 [8h 5s]
movetome: raises $50.00 to $75
RaghSaiAyy: folds
Mastkalandar: calls $75
papadickkies: folds
Lucifer999: folds
devi7: folds
*** FLOP *** [4d Th Kh]
movetome: bets $125
Mastkalandar: folds
Uncalled bet ($125) returned to movetome
movetome: doesn't show hand
movetome collected $174.29 from pot
*** SUMMARY ***
Total pot $185.00 | Rake $10.71
Board [4d Th Kh]
Seat 1: movetome collected ($174.29)
Seat 2: RaghSaiAyy folded before Flop (didn't bet)
Seat 3: Mastkalandar folded on the Flop
Seat 4: papadickkies (button) folded before Flop (didn't bet)
Seat 5: Lucifer999 (small blind) folded before Flop
Seat 6: devi7 (big blind) folded before Flop



PokerStars Game #00327545513: Hold'em No Limit ($25/$50 USD) - 2022/04/30 11:22:54 ET
Table 'Hold'em (Min 1K Max 5K)   216' 6-max Seat #2 is the button
Seat 1: Lucifer999 ($12198.74 in chips) 
Seat 2: rahulh1 ($1260.64 in chips) 
Seat 3: Avaroni ($5000 in chips) 
Seat 4: No username ($5735.49 in chips) 
Avaroni: posts small blind $25
Lucifer999: posts big blind $50
*** HOLE CARDS ***
Dealt to Lucifer999 [8s 7d]
rahulh1: folds
Avaroni: raises $100.00 to $150
Lucifer999: calls $100
*** FLOP *** [5c Kd Kc]
Avaroni: bets $142.5
Lucifer999: folds
Uncalled bet ($142.5) returned to Avaroni
Avaroni: doesn't show hand
Avaroni collected $285 from pot
*** SUMMARY ***
Total pot $300.00 | Rake $15
Board [5c Kd Kc]
Seat 1: Lucifer999 (big blind) folded on the Flop
Seat 2: rahulh1 (button) folded before Flop (didn't bet)
Seat 3: Avaroni (small blind) collected ($285)



PokerStars Game #00327545518: Hold'em No Limit ($50/$100 USD) - 2022/04/30 11:22:56 ET
Table 'Hold'em (Min 25KMax 10K)    69' 6-max Seat #5 is the button
Seat 1: Lucifer999 ($19715.71 in chips) 
Seat 2: theplaya1 ($9264.68 in chips) 
Seat 3: Mpr@59  ($6318.08 in chips) 
Seat 4: Nucking Futs ($10000 in chips) 
Seat 5: tabby20 ($34008.94 in chips) 
Seat 6: manny007 ($2215.6 in chips) 
manny007: posts small blind $50
Lucifer999: posts big blind $100
Nucking Futs: posts big blind $100
*** HOLE CARDS ***
Dealt to Lucifer999 [6c Ks]
theplaya1: folds
Mpr@59 : raises $6218.08 to $6318.08
Nucking Futs: folds
tabby20: folds
manny007: folds
Lucifer999: folds
Uncalled bet ($6218.08) returned to Mpr@59 
Mpr@59 : doesn't show hand
Mpr@59  collected $350 from pot
*** SUMMARY ***
Total pot $350.00 | Rake $0
Board []
Seat 1: Lucifer999 (big blind) folded before Flop
Seat 2: theplaya1 folded before Flop (didn't bet)
Seat 3: Mpr@59  collected ($350)
Seat 4: Nucking Futs folded before Flop
Seat 5: tabby20 (button) folded before Flop (didn't bet)
Seat 6: manny007 (small blind) folded before Flop



PokerStars Game #00327545492: Hold'em No Limit ($10/$25 USD) - 2022/04/30 11:22:47 ET
Table 'Hold'em (Min 500Max 2500) 1001' 6-max Seat #1 is the button
Seat 1: JaspritBumrah786 ($2040 in chips) 
Seat 2: fishfry123 ($2533.6 in chips) 
Seat 3: Wolffy ($448.3 in chips) 
Seat 4: devi7 ($2459.91 in chips) 
Seat 5: Lucifer999 ($4677.72 in chips) 
Seat 6: spidy02 ($3761.64 in chips) 
fishfry123: posts small blind $10
Wolffy: posts big blind $25
*** HOLE CARDS ***
Dealt to Lucifer999 [Js Kd]
devi7: folds
Lucifer999: folds
spidy02: folds
JaspritBumrah786: raises $50.00 to $75
fishfry123: folds
Wolffy: folds
Uncalled bet ($50) returned to JaspritBumrah786
JaspritBumrah786: doesn't show hand
JaspritBumrah786 collected $60 from pot
*** SUMMARY ***
Total pot $60.00 | Rake $0
Board []
Seat 1: JaspritBumrah786 (button) collected ($60)
Seat 2: fishfry123 (small blind) folded before Flop
Seat 3: Wolffy (big blind) folded before Flop
Seat 4: devi7 folded before Flop (didn't bet)
Seat 5: Lucifer999 folded before Flop (didn't bet)
Seat 6: spidy02 folded before Flop (didn't bet)



PokerStars Game #00327545561: Hold'em No Limit ($25/$50 USD) - 2022/04/30 11:23:19 ET
Table 'Hold'em (Min 1K Max 5K)   216' 6-max Seat #3 is the button
Seat 1: Lucifer999 ($12048.74 in chips) 
Seat 2: rahulh1 ($1260.64 in chips) 
Seat 3: Avaroni ($5135 in chips) 
Seat 4: No username ($5735.49 in chips) 
Lucifer999: posts small blind $25
rahulh1: posts big blind $50
*** HOLE CARDS ***
Dealt to Lucifer999 [3d Qh]
Avaroni: folds
Lucifer999: folds
Uncalled bet ($25) returned to rahulh1
rahulh1: doesn't show hand
rahulh1 collected $50 from pot
*** SUMMARY ***
Total pot $50.00 | Rake $0
Board []
Seat 1: Lucifer999 (small blind) folded before Flop
Seat 2: rahulh1 (big blind) collected ($50)
Seat 3: Avaroni (button) folded before Flop (didn't bet)



PokerStars Game #00327545526: Hold'em No Limit ($10/$25 USD) - 2022/04/30 11:23:03 ET
Table 'Hold'em (Min 500Max 2500)  1282' 6-max Seat #5 is the button
Seat 1: movetome ($3079.85 in chips) 
Seat 2: RaghSaiAyy ($992.8 in chips) 
Seat 3: Mastkalandar ($3070.74 in chips) 
Seat 4: papadickkies ($655.2 in chips) 
Seat 5: Lucifer999 ($10276.07 in chips) 
Seat 6: devi7 ($4178.25 in chips) 
devi7: posts small blind $10
movetome: posts big blind $25
*** HOLE CARDS ***
Dealt to Lucifer999 [Td Qc]
RaghSaiAyy: raises $38.75 to $63.75
Mastkalandar: folds
papadickkies: folds
Lucifer999: folds
devi7: folds
movetome: raises $136.25 to $200
RaghSaiAyy: raises $792.80 to $992.8
movetome: folds
Uncalled bet ($792.8) returned to RaghSaiAyy
RaghSaiAyy: doesn't show hand
RaghSaiAyy collected $410 from pot
*** SUMMARY ***
Total pot $410.00 | Rake $0
Board []
Seat 1: movetome (big blind) folded before Flop
Seat 2: RaghSaiAyy collected ($410)
Seat 3: Mastkalandar folded before Flop (didn't bet)
Seat 4: papadickkies folded before Flop (didn't bet)
Seat 5: Lucifer999 (button) folded before Flop (didn't bet)
Seat 6: devi7 (small blind) folded before Flop



PokerStars Game #00327545575: Hold'em No Limit ($50/$100 USD) - 2022/04/30 11:23:26 ET
Table 'Hold'em (Min 25KMax 10K)    69' 6-max Seat #6 is the button
Seat 1: Lucifer999 ($19615.71 in chips) 
Seat 2: theplaya1 ($9264.68 in chips) 
Seat 3: Mpr@59  ($6568.08 in chips) 
Seat 4: Nucking Futs ($9900 in chips) 
Seat 5: tabby20 ($34008.94 in chips) 
Seat 6: manny007 ($2165.6 in chips) 
Lucifer999: posts small blind $50
theplaya1: posts big blind $100
*** HOLE CARDS ***
Dealt to Lucifer999 [6d Qs]
Mpr@59 : raises $100.00 to $200
Nucking Futs: folds
tabby20: folds
manny007: folds
Lucifer999: folds
theplaya1: calls $100
*** FLOP *** [Jd Ac 7c]
theplaya1: checks
Mpr@59 : bets $430.2
theplaya1: folds
Uncalled bet ($430.2) returned to Mpr@59 
Mpr@59 : doesn't show hand
Mpr@59  collected $430.2 from pot
*** SUMMARY ***
Total pot $450.00 | Rake $19.8
Board [Jd Ac 7c]
Seat 1: Lucifer999 (small blind) folded before Flop
Seat 2: theplaya1 (big blind) folded on the Flop
Seat 3: Mpr@59  collected ($430.2)
Seat 4: Nucking Futs folded before Flop (didn't bet)
Seat 5: tabby20 folded before Flop (didn't bet)
Seat 6: manny007 (button) folded before Flop (didn't bet)



PokerStars Game #00327545613: Hold'em No Limit ($25/$50 USD) - 2022/04/30 11:23:42 ET
Table 'Hold'em (Min 1K Max 5K)   216' 6-max Seat #1 is the button
Seat 1: Lucifer999 ($12023.74 in chips) 
Seat 2: rahulh1 ($1285.64 in chips) 
Seat 3: Avaroni ($5135 in chips) 
Seat 4: No username ($5735.49 in chips) 
rahulh1: posts small blind $25
Avaroni: posts big blind $50
*** HOLE CARDS ***
Dealt to Lucifer999 [Th Qd]
Lucifer999: folds
rahulh1: calls $25
Avaroni: raises $125.00 to $175
rahulh1: calls $125
*** FLOP *** [3d 9h 4s]
rahulh1: checks
Avaroni: bets $150
rahulh1: folds
Uncalled bet ($150) returned to Avaroni
Avaroni: doesn't show hand
Avaroni collected $332.5 from pot
*** SUMMARY ***
Total pot $350.00 | Rake $17.5
Board [3d 9h 4s]
Seat 1: Lucifer999 (button) folded before Flop (didn't bet)
Seat 2: rahulh1 (small blind) folded on the Flop
Seat 3: Avaroni (big blind) collected ($332.5)



PokerStars Game #00327545631: Hold'em No Limit ($10/$25 USD) - 2022/04/30 11:23:52 ET
Table 'Hold'em (Min 500Max 2500)  1282' 6-max Seat #6 is the button
Seat 1: movetome ($2879.85 in chips) 
Seat 2: RaghSaiAyy ($1202.8 in chips) 
Seat 3: Mastkalandar ($3070.74 in chips) 
Seat 4: papadickkies ($655.2 in chips) 
Seat 5: Lucifer999 ($10276.07 in chips) 
Seat 6: devi7 ($4168.25 in chips) 
movetome: posts small blind $10
RaghSaiAyy: posts big blind $25
*** HOLE CARDS ***
Dealt to Lucifer999 [3d Ad]
Mastkalandar: folds
papadickkies: folds
Lucifer999: folds
devi7: folds
movetome: folds
Uncalled bet ($15) returned to RaghSaiAyy
RaghSaiAyy: doesn't show hand
RaghSaiAyy collected $20 from pot
*** SUMMARY ***
Total pot $20.00 | Rake $0
Board []
Seat 1: movetome (small blind) folded before Flop
Seat 2: RaghSaiAyy (big blind) collected ($20)
Seat 3: Mastkalandar folded before Flop (didn't bet)
Seat 4: papadickkies folded before Flop (didn't bet)
Seat 5: Lucifer999 folded before Flop (didn't bet)
Seat 6: devi7 (button) folded before Flop (didn't bet)



PokerStars Game #00327545611: Hold'em No Limit ($10/$25 USD) - 2022/04/30 11:23:41 ET
Table 'Hold'em (Min 500Max 2500) 1001' 6-max Seat #2 is the button
Seat 1: JaspritBumrah786 ($2135 in chips) 
Seat 2: fishfry123 ($2523.6 in chips) 
Seat 3: Wolffy ($423.3 in chips) 
Seat 4: devi7 ($2459.91 in chips) 
Seat 5: Lucifer999 ($4677.72 in chips) 
Seat 6: spidy02 ($3761.64 in chips) 
Wolffy: posts small blind $10
devi7: posts big blind $25
*** HOLE CARDS ***
Dealt to Lucifer999 [8c 7d]
Lucifer999: folds
spidy02: folds
JaspritBumrah786: folds
fishfry123: calls $25
Wolffy: raises $75.00 to $100
devi7: folds
fishfry123: calls $75
*** FLOP *** [2d 3c 7s]
Wolffy: checks
fishfry123: checks
*** TURN *** [2d 3c 7s] [Jc]
Wolffy: checks
fishfry123: checks
*** RIVER *** [2d 3c 7s Jc] [3d]
Wolffy: checks
fishfry123: bets $105.6
Wolffy: calls $105.6
*** SHOW DOWN ***
fishfry123: shows [Jh 8h] (Two pairs, JJ33)
Wolffy: doesn't show hand
fishfry123 collected $409.31 from pot
*** SUMMARY ***
Total pot $436.20 | Rake $26.89
Board [2d 3c 7s Jc 3d]
Seat 1: JaspritBumrah786 folded before Flop (didn't bet)
Seat 2: fishfry123  (button) showed [Jh 8h] and won ($409.31) with Two pairs, JJ33
Seat 3: Wolffy (small blind) mucked
Seat 4: devi7 (big blind) folded before Flop
Seat 5: Lucifer999 folded before Flop (didn't bet)
Seat 6: spidy02 folded before Flop (didn't bet)



PokerStars Game #00327545651: Hold'em No Limit ($50/$100 USD) - 2022/04/30 11:24:02 ET
Table 'Hold'em (Min 25KMax 10K)    69' 6-max Seat #1 is the button
Seat 1: Lucifer999 ($19565.71 in chips) 
Seat 2: theplaya1 ($9064.68 in chips) 
Seat 3: Mpr@59  ($6798.28 in chips) 
Seat 4: Nucking Futs ($9900 in chips) 
Seat 5: tabby20 ($34008.94 in chips) 
Seat 6: manny007 ($2165.6 in chips) 
theplaya1: posts small blind $50
Mpr@59 : posts big blind $100
*** HOLE CARDS ***
Dealt to Lucifer999 [Ks Kh]
Nucking Futs: folds
tabby20: folds
manny007: calls $100
Lucifer999: raises $350.00 to $450
theplaya1: folds
Mpr@59 : calls $350
manny007: calls $350
*** FLOP *** [3h 4s 3s]
Mpr@59 : checks
manny007: checks
Lucifer999: bets $1050
Mpr@59 : folds
manny007: folds
Uncalled bet ($1050) returned to Lucifer999
Lucifer999: doesn't show hand
Lucifer999 collected $1338.4 from pot
*** SUMMARY ***
Total pot $1400.00 | Rake $61.6
Board [3h 4s 3s]
Seat 1: Lucifer999 (button) collected ($1338.4)
Seat 2: theplaya1 (small blind) folded before Flop
Seat 3: Mpr@59  (big blind) folded on the Flop
Seat 4: Nucking Futs folded before Flop (didn't bet)
Seat 5: tabby20 folded before Flop (didn't bet)
Seat 6: manny007 folded on the Flop



PokerStars Game #00327545687: Hold'em No Limit ($25/$50 USD) - 2022/04/30 11:24:19 ET
Table 'Hold'em (Min 1K Max 5K)   216' 6-max Seat #2 is the button
Seat 1: Lucifer999 ($12023.74 in chips) 
Seat 2: rahulh1 ($1110.64 in chips) 
Seat 3: Avaroni ($5292.5 in chips) 
Seat 4: No username ($5735.49 in chips) 
Avaroni: posts small blind $25
No username: posts big blind $50
*** HOLE CARDS ***
Dealt to Lucifer999 [9h Ks]
Lucifer999: raises $100.00 to $150
rahulh1: raises $960.64 to $1110.64
Avaroni: folds
No username: folds
Lucifer999: folds
Uncalled bet ($960.64) returned to rahulh1
rahulh1: doesn't show hand
rahulh1 collected $375 from pot
*** SUMMARY ***
Total pot $375.00 | Rake $0
Board []
Seat 1: Lucifer999 folded before Flop
Seat 2: rahulh1 (button) collected ($375)
Seat 3: Avaroni (small blind) folded before Flop
Seat 4: No username (big blind) folded before Flop



PokerStars Game #00327545697: Hold'em No Limit ($10/$25 USD) - 2022/04/30 11:24:26 ET
Table 'Hold'em (Min 500Max 2500)  1282' 6-max Seat #1 is the button
Seat 1: movetome ($2869.85 in chips) 
Seat 2: RaghSaiAyy ($1212.8 in chips) 
Seat 3: Mastkalandar ($3070.74 in chips) 
Seat 4: papadickkies ($655.2 in chips) 
Seat 5: Lucifer999 ($10276.07 in chips) 
Seat 6: devi7 ($4168.25 in chips) 
Mastkalandar: posts small blind $10
papadickkies: posts big blind $25
*** HOLE CARDS ***
Dealt to Lucifer999 [9c As]
Lucifer999: folds
devi7: folds
movetome: raises $50.00 to $75
Mastkalandar: folds
papadickkies: folds
Uncalled bet ($50) returned to movetome
movetome: doesn't show hand
movetome collected $60 from pot
*** SUMMARY ***
Total pot $60.00 | Rake $0
Board []
Seat 1: movetome (button) collected ($60)
Seat 3: Mastkalandar (small blind) folded before Flop
Seat 4: papadickkies (big blind) folded before Flop
Seat 5: Lucifer999 folded before Flop (didn't bet)
Seat 6: devi7 folded before Flop (didn't bet)



PokerStars Game #00327545741: Hold'em No Limit ($25/$50 USD) - 2022/04/30 11:24:48 ET
Table 'Hold'em (Min 1K Max 5K)   216' 6-max Seat #3 is the button
Seat 1: Lucifer999 ($11873.74 in chips) 
Seat 2: rahulh1 ($1402.14 in chips) 
Seat 3: Avaroni ($5267.5 in chips) 
Seat 4: No username ($5685.49 in chips) 
No username: posts small blind $25
Lucifer999: posts big blind $50
*** HOLE CARDS ***
Dealt to Lucifer999 [Qs Qh]
rahulh1: folds
Avaroni: raises $100.00 to $150
No username: calls $125
Lucifer999: raises $550.00 to $700
Avaroni: calls $550
No username: folds
*** FLOP *** [4d Qd 7s]
Lucifer999: bets $1200
Avaroni: folds
Uncalled bet ($1200) returned to Lucifer999
Lucifer999: doesn't show hand
Lucifer999 collected $1472.5 from pot
*** SUMMARY ***
Total pot $1550.00 | Rake $77.5
Board [4d Qd 7s]
Seat 1: Lucifer999 (big blind) collected ($1472.5)
Seat 2: rahulh1 folded before Flop (didn't bet)
Seat 3: Avaroni (button) folded on the Flop
Seat 4: No username (small blind) folded before Flop



PokerStars Game #00327545739: Hold'em No Limit ($50/$100 USD) - 2022/04/30 11:24:47 ET
Table 'Hold'em (Min 25KMax 10K)    69' 6-max Seat #2 is the button
Seat 1: Lucifer999 ($20454.11 in chips) 
Seat 2: theplaya1 ($9014.68 in chips) 
Seat 3: Mpr@59  ($6348.28 in chips) 
Seat 4: Nucking Futs ($9900 in chips) 
Seat 5: tabby20 ($34008.94 in chips) 
Seat 6: manny007 ($1715.6 in chips) 
Mpr@59 : posts small blind $50
Nucking Futs: posts big blind $100
*** HOLE CARDS ***
Dealt to Lucifer999 [2s Jd]
tabby20: folds
manny007: folds
Lucifer999: folds
theplaya1: folds
Mpr@59 : raises $200.00 to $300
Nucking Futs: calls $200
*** FLOP *** [Ts 3d As]
Mpr@59 : bets $573.6
Nucking Futs: folds
Uncalled bet ($573.6) returned to Mpr@59 
Mpr@59 : doesn't show hand
Mpr@59  collected $573.6 from pot
*** SUMMARY ***
Total pot $600.00 | Rake $26.4
Board [Ts 3d As]
Seat 1: Lucifer999 folded before Flop (didn't bet)
Seat 2: theplaya1 (button) folded before Flop (didn't bet)
Seat 3: Mpr@59  (small blind) collected ($573.6)
Seat 4: Nucking Futs (big blind) folded on the Flop
Seat 5: tabby20 folded before Flop (didn't bet)
Seat 6: manny007 folded before Flop (didn't bet)



PokerStars Game #00327545730: Hold'em No Limit ($10/$25 USD) - 2022/04/30 11:24:41 ET
Table 'Hold'em (Min 500Max 2500) 1001' 6-max Seat #3 is the button
Seat 1: JaspritBumrah786 ($2135 in chips) 
Seat 2: fishfry123 ($2727.31 in chips) 
Seat 3: Wolffy ($217.7 in chips) 
Seat 4: devi7 ($2434.91 in chips) 
Seat 5: Lucifer999 ($4677.72 in chips) 
Seat 6: spidy02 ($3761.64 in chips) 
devi7: posts small blind $10
Lucifer999: posts big blind $25
*** HOLE CARDS ***
Dealt to Lucifer999 [6h 6c]
spidy02: raises $60.00 to $85
JaspritBumrah786: folds
fishfry123: calls $85
Wolffy: calls $85
devi7: folds
Lucifer999: calls $60
*** FLOP *** [Ks 2c 4c]
Lucifer999: checks
spidy02: checks
fishfry123: bets $164.32
Wolffy: folds
Lucifer999: folds
spidy02: calls $164.32
*** TURN *** [Ks 2c 4c] [9s]
spidy02: checks
fishfry123: bets $478.54
spidy02: folds
Uncalled bet ($478.54) returned to fishfry123
fishfry123: doesn't show hand
fishfry123 collected $638.05 from pot
*** SUMMARY ***
Total pot $678.64 | Rake $40.59
Board [Ks 2c 4c 9s]
Seat 1: JaspritBumrah786 folded before Flop (didn't bet)
Seat 2: fishfry123 collected ($638.05)
Seat 3: Wolffy (button) folded on the Flop
Seat 4: devi7 (small blind) folded before Flop
Seat 5: Lucifer999 (big blind) folded on the Flop
Seat 6: spidy02 folded on the Turn



PokerStars Game #00327545778: Hold'em No Limit ($10/$25 USD) - 2022/04/30 11:25:03 ET
Table 'Hold'em (Min 500Max 2500)  1282' 6-max Seat #3 is the button
Seat 1: movetome ($2904.85 in chips) 
Seat 2: RaghSaiAyy ($1212.8 in chips) 
Seat 3: Mastkalandar ($3060.74 in chips) 
Seat 4: papadickkies ($630.2 in chips) 
Seat 5: Lucifer999 ($10276.07 in chips) 
Seat 6: devi7 ($4168.25 in chips) 
papadickkies: posts small blind $10
Lucifer999: posts big blind $25
*** HOLE CARDS ***
Dealt to Lucifer999 [4h Ks]
devi7: raises $50.00 to $75
movetome: raises $150.00 to $225
Mastkalandar: folds
papadickkies: folds
Lucifer999: folds
devi7: folds
Uncalled bet ($150) returned to movetome
movetome: doesn't show hand
movetome collected $185 from pot
*** SUMMARY ***
Total pot $185.00 | Rake $0
Board []
Seat 1: movetome collected ($185)
Seat 3: Mastkalandar (button) folded before Flop (didn't bet)
Seat 4: papadickkies (small blind) folded before Flop
Seat 5: Lucifer999 (big blind) folded before Flop
Seat 6: devi7 folded before Flop



PokerStars Game #00327545851: Hold'em No Limit ($25/$50 USD) - 2022/04/30 11:25:33 ET
Table 'Hold'em (Min 1K Max 5K)   216' 6-max Seat #4 is the button
Seat 1: Lucifer999 ($12646.24 in chips) 
Seat 2: rahulh1 ($1402.14 in chips) 
Seat 3: Avaroni ($5000 in chips) 
Seat 4: No username ($5535.49 in chips) 
Lucifer999: posts small blind $25
rahulh1: posts big blind $50
*** HOLE CARDS ***
Dealt to Lucifer999 [Tc Jh]
Avaroni: folds
No username: folds
Lucifer999: raises $100.00 to $150
rahulh1: folds
Uncalled bet ($100) returned to Lucifer999
Lucifer999: doesn't show hand
Lucifer999 collected $100 from pot
*** SUMMARY ***
Total pot $100.00 | Rake $0
Board []
Seat 1: Lucifer999 (small blind) collected ($100)
Seat 2: rahulh1 (big blind) folded before Flop
Seat 3: Avaroni folded before Flop (didn't bet)
Seat 4: No username (button) folded before Flop (didn't bet)



PokerStars Game #00327545871: Hold'em No Limit ($10/$25 USD) - 2022/04/30 11:25:47 ET
Table 'Hold'em (Min 500Max 2500) 1001' 6-max Seat #4 is the button
Seat 1: JaspritBumrah786 ($2135 in chips) 
Seat 2: fishfry123 ($3116.04 in chips) 
Seat 3: Wolffy ($132.7 in chips) 
Seat 4: devi7 ($2424.91 in chips) 
Seat 5: Lucifer999 ($4592.72 in chips) 
Seat 6: spidy02 ($3512.32 in chips) 
Lucifer999: posts small blind $10
spidy02: posts big blind $25
*** HOLE CARDS ***
Dealt to Lucifer999 [3d 2d]
JaspritBumrah786: folds
fishfry123: folds
Wolffy: raises $107.70 to $132.7
devi7: folds
Lucifer999: folds
spidy02: raises $275.40 to $408.1
Uncalled bet ($275.4) returned to spidy02
*** FLOP *** [4c 2c 6h]
*** TURN *** [4c 2c 6h] [Kh]
*** RIVER *** [4c 2c 6h Kh] [5s]
*** SHOW DOWN ***
Wolffy: shows [Ac 9c] (High card, A)
spidy02: shows [7h 8h] (Straight, 8-4)
spidy02 collected $258.97 from pot
*** SUMMARY ***
Total pot $275.40 | Rake $16.43
Board [4c 2c 6h Kh 5s]
Seat 1: JaspritBumrah786 folded before Flop (didn't bet)
Seat 2: fishfry123 folded before Flop (didn't bet)
Seat 3: Wolffy showed [Ac 9c] and lost with High card, A
Seat 4: devi7 (button) folded before Flop (didn't bet)
Seat 5: Lucifer999 (small blind) folded before Flop
Seat 6: spidy02  (big blind) showed [7h 8h] and won ($258.97) with Straight, 8-4



PokerStars Game #00327545882: Hold'em No Limit ($10/$25 USD) - 2022/04/30 11:25:52 ET
Table 'Hold'em (Min 500Max 2500)  1282' 6-max Seat #4 is the button
Seat 1: movetome ($3014.85 in chips) 
Seat 2: RaghSaiAyy ($1212.8 in chips) 
Seat 3: Mastkalandar ($3060.74 in chips) 
Seat 4: papadickkies ($620.2 in chips) 
Seat 5: Lucifer999 ($10251.07 in chips) 
Seat 6: devi7 ($4093.25 in chips) 
Lucifer999: posts small blind $10
devi7: posts big blind $25
*** HOLE CARDS ***
Dealt to Lucifer999 [4c Jc]
movetome: folds
Mastkalandar: folds
papadickkies: folds
Lucifer999: folds
Uncalled bet ($15) returned to devi7
devi7: doesn't show hand
devi7 collected $20 from pot
*** SUMMARY ***
Total pot $20.00 | Rake $0
Board []
Seat 1: movetome folded before Flop (didn't bet)
Seat 3: Mastkalandar folded before Flop (didn't bet)
Seat 4: papadickkies (button) folded before Flop (didn't bet)
Seat 5: Lucifer999 (small blind) folded before Flop
Seat 6: devi7 (big blind) collected ($20)



PokerStars Game #00327545857: Hold'em No Limit ($50/$100 USD) - 2022/04/30 11:25:35 ET
Table 'Hold'em (Min 25KMax 10K)    69' 6-max Seat #3 is the button
Seat 1: Lucifer999 ($20454.11 in chips) 
Seat 2: theplaya1 ($9014.68 in chips) 
Seat 3: Mpr@59  ($6621.88 in chips) 
Seat 4: Nucking Futs ($9600 in chips) 
Seat 5: tabby20 ($34008.94 in chips) 
Seat 6: manny007 ($1715.6 in chips) 
Nucking Futs: posts small blind $50
tabby20: posts big blind $100
*** HOLE CARDS ***
Dealt to Lucifer999 [Qh 5h]
manny007: folds
Lucifer999: folds
theplaya1: raises $131.00 to $231
Mpr@59 : calls $231
Nucking Futs: folds
tabby20: folds
*** FLOP *** [6d 3c 3h]
theplaya1: bets $292.54
Mpr@59 : folds
Uncalled bet ($292.54) returned to theplaya1
theplaya1: doesn't show hand
theplaya1 collected $585.08 from pot
*** SUMMARY ***
Total pot $612.00 | Rake $26.92
Board [6d 3c 3h]
Seat 1: Lucifer999 folded before Flop (didn't bet)
Seat 2: theplaya1 collected ($585.08)
Seat 3: Mpr@59  (button) folded on the Flop
Seat 4: Nucking Futs (small blind) folded before Flop
Seat 5: tabby20 (big blind) folded before Flop
Seat 6: manny007 folded before Flop (didn't bet)



PokerStars Game #00327545912: Hold'em No Limit ($25/$50 USD) - 2022/04/30 11:26:01 ET
Table 'Hold'em (Min 1K Max 5K)   216' 6-max Seat #1 is the button
Seat 1: Lucifer999 ($12696.24 in chips) 
Seat 2: rahulh1 ($1352.14 in chips) 
Seat 3: Avaroni ($5000 in chips) 
Seat 4: No username ($5535.49 in chips) 
rahulh1: posts small blind $25
No username: posts big blind $50
*** HOLE CARDS ***
Dealt to Lucifer999 [Ac 8d]
Lucifer999: folds
rahulh1: raises $68.75 to $118.75
No username: folds
Uncalled bet ($68.75) returned to rahulh1
rahulh1: doesn't show hand
rahulh1 collected $100 from pot
*** SUMMARY ***
Total pot $100.00 | Rake $0
Board []
Seat 1: Lucifer999 (button) folded before Flop (didn't bet)
Seat 2: rahulh1 (small blind) collected ($100)
Seat 4: No username (big blind) folded before Flop



PokerStars Game #00327545949: Hold'em No Limit ($10/$25 USD) - 2022/04/30 11:26:17 ET
Table 'Hold'em (Min 500Max 2500)  1282' 6-max Seat #5 is the button
Seat 1: movetome ($3014.85 in chips) 
Seat 2: RaghSaiAyy ($1212.8 in chips) 
Seat 3: Mastkalandar ($3060.74 in chips) 
Seat 4: papadickkies ($620.2 in chips) 
Seat 5: Lucifer999 ($10241.07 in chips) 
Seat 6: devi7 ($4103.25 in chips) 
devi7: posts small blind $10
movetome: posts big blind $25
*** HOLE CARDS ***
Dealt to Lucifer999 [5s Qd]
Mastkalandar: folds
papadickkies: folds
Lucifer999: folds
devi7: folds
Uncalled bet ($15) returned to movetome
movetome: doesn't show hand
movetome collected $20 from pot
*** SUMMARY ***
Total pot $20.00 | Rake $0
Board []
Seat 1: movetome (big blind) collected ($20)
Seat 3: Mastkalandar folded before Flop (didn't bet)
Seat 4: papadickkies folded before Flop (didn't bet)
Seat 5: Lucifer999 (button) folded before Flop (didn't bet)
Seat 6: devi7 (small blind) folded before Flop



PokerStars Game #00327545952: Hold'em No Limit ($50/$100 USD) - 2022/04/30 11:26:18 ET
Table 'Hold'em (Min 25KMax 10K)    69' 6-max Seat #4 is the button
Seat 1: Lucifer999 ($20454.11 in chips) 
Seat 2: theplaya1 ($9368.76 in chips) 
Seat 3: Mpr@59  ($6390.88 in chips) 
Seat 4: Nucking Futs ($9550 in chips) 
Seat 5: tabby20 ($33908.94 in chips) 
Seat 6: manny007 ($1715.6 in chips) 
tabby20: posts small blind $50
manny007: posts big blind $100
*** HOLE CARDS ***
Dealt to Lucifer999 [3s 7d]
Lucifer999: folds
theplaya1: raises $100.00 to $200
Mpr@59 : calls $200
Nucking Futs: folds
tabby20: calls $150
manny007: calls $100
*** FLOP *** [6d 9s Jh]
tabby20: checks
manny007: checks
theplaya1: checks
Mpr@59 : bets $764.8
tabby20: folds
manny007: folds
theplaya1: folds
Uncalled bet ($764.8) returned to Mpr@59 
Mpr@59 : doesn't show hand
Mpr@59  collected $764.8 from pot
*** SUMMARY ***
Total pot $800.00 | Rake $35.2
Board [6d 9s Jh]
Seat 1: Lucifer999 folded before Flop (didn't bet)
Seat 2: theplaya1 folded on the Flop
Seat 3: Mpr@59  collected ($764.8)
Seat 4: Nucking Futs (button) folded before Flop (didn't bet)
Seat 5: tabby20 (small blind) folded on the Flop
Seat 6: manny007 (big blind) folded on the Flop



PokerStars Game #00327545947: Hold'em No Limit ($10/$25 USD) - 2022/04/30 11:26:17 ET
Table 'Hold'em (Min 500Max 2500) 1001' 6-max Seat #5 is the button
Seat 1: JaspritBumrah786 ($2135 in chips) 
Seat 2: fishfry123 ($3116.04 in chips) 
Seat 4: devi7 ($2424.91 in chips) 
Seat 5: Lucifer999 ($4582.72 in chips) 
Seat 6: spidy02 ($3638.59 in chips) 
spidy02: posts small blind $10
JaspritBumrah786: posts big blind $25
*** HOLE CARDS ***
Dealt to Lucifer999 [As 3s]
fishfry123: calls $25
devi7: folds
Lucifer999: raises $65.00 to $90
spidy02: calls $80
JaspritBumrah786: folds
fishfry123: calls $65
*** FLOP *** [9d Th 2c]
spidy02: checks
fishfry123: checks
Lucifer999: checks
*** TURN *** [9d Th 2c] [Td]
spidy02: checks
fishfry123: checks
Lucifer999: checks
*** RIVER *** [9d Th 2c Td] [6c]
spidy02: checks
fishfry123: checks
Lucifer999: checks
*** SHOW DOWN ***
Lucifer999: shows [As 3s] (Pair, TT)
spidy02: shows [6d 7d] (Two pairs, TT66)
fishfry123: doesn't show hand
spidy02 collected $277.52 from pot
*** SUMMARY ***
Total pot $295.00 | Rake $17.48
Board [9d Th 2c Td 6c]
Seat 1: JaspritBumrah786 (big blind) folded before Flop
Seat 2: fishfry123 mucked
Seat 4: devi7 folded before Flop (didn't bet)
Seat 5: Lucifer999 (button) showed [As 3s] and lost with Pair, TT
Seat 6: spidy02  (small blind) showed [6d 7d] and won ($277.52) with Two pairs, TT66



PokerStars Game #00327546006: Hold'em No Limit ($10/$25 USD) - 2022/04/30 11:26:42 ET
Table 'Hold'em (Min 500Max 2500)  1282' 6-max Seat #6 is the button
Seat 1: movetome ($3024.85 in chips) 
Seat 2: RaghSaiAyy ($1212.8 in chips) 
Seat 3: Mastkalandar ($3060.74 in chips) 
Seat 4: papadickkies ($620.2 in chips) 
Seat 5: Lucifer999 ($10241.07 in chips) 
Seat 6: devi7 ($4093.25 in chips) 
movetome: posts small blind $10
Mastkalandar: posts big blind $25
*** HOLE CARDS ***
Dealt to Lucifer999 [Js 3d]
papadickkies: folds
Lucifer999: folds
devi7: folds
movetome: folds
Uncalled bet ($15) returned to Mastkalandar
Mastkalandar: doesn't show hand
Mastkalandar collected $20 from pot
*** SUMMARY ***
Total pot $20.00 | Rake $0
Board []
Seat 1: movetome (small blind) folded before Flop
Seat 3: Mastkalandar (big blind) collected ($20)
Seat 4: papadickkies folded before Flop (didn't bet)
Seat 5: Lucifer999 folded before Flop (didn't bet)
Seat 6: devi7 (button) folded before Flop (didn't bet)



PokerStars Game #00327545973: Hold'em No Limit ($25/$50 USD) - 2022/04/30 11:26:27 ET
Table 'Hold'em (Min 1K Max 5K)   216' 6-max Seat #2 is the button
Seat 1: Lucifer999 ($12696.24 in chips) 
Seat 2: rahulh1 ($1402.14 in chips) 
Seat 4: No username ($5485.49 in chips) 
No username: posts small blind $25
Lucifer999: posts big blind $50
*** HOLE CARDS ***
Dealt to Lucifer999 [5h 8d]
rahulh1: folds
No username: calls $25
Lucifer999: raises $125.00 to $175
No username: calls $125
*** FLOP *** [8s 6d 4h]
No username: checks
Lucifer999: bets $200
No username: calls $200
*** TURN *** [8s 6d 4h] [6h]
No username: checks
Lucifer999: checks
*** RIVER *** [8s 6d 4h 6h] [Qd]
No username: bets $534.38
Lucifer999: calls $534.38
*** SHOW DOWN ***
No username: shows [Ts Jc] (Pair, 66)
Lucifer999: shows [5h 8d] (Two pairs, 8866)
Lucifer999 collected $1727.86 from pot
*** SUMMARY ***
Total pot $1818.76 | Rake $90.9
Board [8s 6d 4h 6h Qd]
Seat 1: Lucifer999  (big blind) showed [5h 8d] and won ($1727.86) with Two pairs, 8866
Seat 2: rahulh1 (button) folded before Flop (didn't bet)
Seat 4: No username (small blind) showed [Ts Jc] and lost with Pair, 66



PokerStars Game #00327546082: Hold'em No Limit ($10/$25 USD) - 2022/04/30 11:27:12 ET
Table 'Hold'em (Min 500Max 2500)  1282' 6-max Seat #1 is the button
Seat 1: movetome ($3014.85 in chips) 
Seat 2: RaghSaiAyy ($1212.8 in chips) 
Seat 3: Mastkalandar ($3070.74 in chips) 
Seat 4: papadickkies ($620.2 in chips) 
Seat 5: Lucifer999 ($10241.07 in chips) 
Seat 6: devi7 ($4093.25 in chips) 
Mastkalandar: posts small blind $10
papadickkies: posts big blind $25
*** HOLE CARDS ***
Dealt to Lucifer999 [6h Kc]
Lucifer999: folds
devi7: folds
movetome: folds
Mastkalandar: raises $50.00 to $75
papadickkies: folds
Uncalled bet ($50) returned to Mastkalandar
Mastkalandar: doesn't show hand
Mastkalandar collected $50 from pot
*** SUMMARY ***
Total pot $50.00 | Rake $0
Board []
Seat 1: movetome (button) folded before Flop (didn't bet)
Seat 3: Mastkalandar (small blind) collected ($50)
Seat 4: papadickkies (big blind) folded before Flop
Seat 5: Lucifer999 folded before Flop (didn't bet)
Seat 6: devi7 folded before Flop (didn't bet)



PokerStars Game #00327546058: Hold'em No Limit ($50/$100 USD) - 2022/04/30 11:27:01 ET
Table 'Hold'em (Min 25KMax 10K)    69' 6-max Seat #5 is the button
Seat 1: Lucifer999 ($20454.11 in chips) 
Seat 2: theplaya1 ($9168.76 in chips) 
Seat 3: Mpr@59  ($6955.68 in chips) 
Seat 4: Nucking Futs ($9550 in chips) 
Seat 5: tabby20 ($33708.94 in chips) 
Seat 6: manny007 ($1515.6 in chips) 
manny007: posts small blind $50
Lucifer999: posts big blind $100
*** HOLE CARDS ***
Dealt to Lucifer999 [3h 7d]
theplaya1: folds
Mpr@59 : folds
Nucking Futs: folds
tabby20: folds
manny007: calls $50
Lucifer999: checks
*** FLOP *** [6d 5d Jh]
manny007: checks
Lucifer999: bets $100
manny007: calls $100
*** TURN *** [6d 5d Jh] [9h]
manny007: checks
Lucifer999: bets $300
manny007: folds
Uncalled bet ($300) returned to Lucifer999
Lucifer999: doesn't show hand
Lucifer999 collected $382.4 from pot
*** SUMMARY ***
Total pot $400.00 | Rake $17.6
Board [6d 5d Jh 9h]
Seat 1: Lucifer999 (big blind) collected ($382.4)
Seat 2: theplaya1 folded before Flop (didn't bet)
Seat 3: Mpr@59  folded before Flop (didn't bet)
Seat 4: Nucking Futs folded before Flop (didn't bet)
Seat 5: tabby20 (button) folded before Flop (didn't bet)
Seat 6: manny007 (small blind) folded on the Turn



PokerStars Game #00327546142: Hold'em No Limit ($25/$50 USD) - 2022/04/30 11:27:40 ET
Table 'Hold'em (Min 1K Max 5K)   216' 6-max Seat #4 is the button
Seat 1: Lucifer999 ($13514.72 in chips) 
Seat 2: rahulh1 ($1402.14 in chips) 
Seat 4: No username ($4576.11 in chips) 
Seat 6: akshark108 ($1655.81 in chips) 
Lucifer999: posts small blind $25
rahulh1: posts big blind $50
*** HOLE CARDS ***
Dealt to Lucifer999 [2d 9d]
No username: folds
Lucifer999: folds
Uncalled bet ($25) returned to rahulh1
rahulh1: doesn't show hand
rahulh1 collected $50 from pot
*** SUMMARY ***
Total pot $50.00 | Rake $0
Board []
Seat 1: Lucifer999 (small blind) folded before Flop
Seat 2: rahulh1 (big blind) collected ($50)
Seat 4: No username (button) folded before Flop (didn't bet)



PokerStars Game #00327546061: Hold'em No Limit ($10/$25 USD) - 2022/04/30 11:27:04 ET
Table 'Hold'em (Min 500Max 2500) 1001' 6-max Seat #6 is the button
Seat 1: JaspritBumrah786 ($2110 in chips) 
Seat 2: fishfry123 ($3026.04 in chips) 
Seat 4: devi7 ($2424.91 in chips) 
Seat 5: Lucifer999 ($4492.72 in chips) 
Seat 6: spidy02 ($3826.11 in chips) 
JaspritBumrah786: posts small blind $10
fishfry123: posts big blind $25
*** HOLE CARDS ***
Dealt to Lucifer999 [Qd Ks]
devi7: raises $50.00 to $75
Lucifer999: calls $75
spidy02: folds
JaspritBumrah786: calls $65
fishfry123: calls $50
*** FLOP *** [4s 3c Js]
JaspritBumrah786: checks
fishfry123: checks
devi7: checks
Lucifer999: checks
*** TURN *** [4s 3c Js] [2c]
JaspritBumrah786: checks
fishfry123: checks
devi7: bets $280
Lucifer999: folds
JaspritBumrah786: calls $280
fishfry123: folds
*** RIVER *** [4s 3c Js 2c] [6s]
JaspritBumrah786: checks
devi7: checks
*** SHOW DOWN ***
devi7: shows [8s 8h] (Pair, 88)
JaspritBumrah786: doesn't show hand
devi7 collected $809.85 from pot
*** SUMMARY ***
Total pot $860.00 | Rake $50.15
Board [4s 3c Js 2c 6s]
Seat 1: JaspritBumrah786 (small blind) mucked
Seat 2: fishfry123 (big blind) folded on the Turn
Seat 4: devi7  showed [8s 8h] and won ($809.85) with Pair, 88
Seat 5: Lucifer999 folded on the Turn
Seat 6: spidy02 (button) folded before Flop (didn't bet)



PokerStars Game #00327546156: Hold'em No Limit ($10/$25 USD) - 2022/04/30 11:27:45 ET
Table 'Hold'em (Min 500Max 2500)  1282' 6-max Seat #3 is the button
Seat 1: movetome ($3014.85 in chips) 
Seat 2: RaghSaiAyy ($1212.8 in chips) 
Seat 3: Mastkalandar ($3095.74 in chips) 
Seat 4: papadickkies ($595.2 in chips) 
Seat 5: Lucifer999 ($10241.07 in chips) 
Seat 6: devi7 ($4093.25 in chips) 
papadickkies: posts small blind $10
Lucifer999: posts big blind $25
*** HOLE CARDS ***
Dealt to Lucifer999 [2d 6h]
devi7: raises $50.00 to $75
movetome: folds
Mastkalandar: folds
papadickkies: folds
Lucifer999: folds
Uncalled bet ($50) returned to devi7
devi7: doesn't show hand
devi7 collected $60 from pot
*** SUMMARY ***
Total pot $60.00 | Rake $0
Board []
Seat 1: movetome folded before Flop (didn't bet)
Seat 3: Mastkalandar (button) folded before Flop (didn't bet)
Seat 4: papadickkies (small blind) folded before Flop
Seat 5: Lucifer999 (big blind) folded before Flop
Seat 6: devi7 collected ($60)



PokerStars Game #00327546208: Hold'em No Limit ($25/$50 USD) - 2022/04/30 11:28:04 ET
Table 'Hold'em (Min 1K Max 5K)   216' 6-max Seat #1 is the button
Seat 1: Lucifer999 ($13489.72 in chips) 
Seat 2: rahulh1 ($1427.14 in chips) 
Seat 4: No username ($4576.11 in chips) 
Seat 6: akshark108 ($1655.81 in chips) 
rahulh1: posts small blind $25
akshark108: posts big blind $50
*** HOLE CARDS ***
Dealt to Lucifer999 [6s 9d]
Lucifer999: folds
rahulh1: folds
Uncalled bet ($25) returned to akshark108
akshark108: doesn't show hand
akshark108 collected $50 from pot
*** SUMMARY ***
Total pot $50.00 | Rake $0
Board []
Seat 1: Lucifer999 (button) folded before Flop (didn't bet)
Seat 2: rahulh1 (small blind) folded before Flop
Seat 6: akshark108 (big blind) collected ($50)



PokerStars Game #00327546173: Hold'em No Limit ($50/$100 USD) - 2022/04/30 11:27:53 ET
Table 'Hold'em (Min 25KMax 10K)    69' 6-max Seat #6 is the button
Seat 1: Lucifer999 ($20636.51 in chips) 
Seat 2: theplaya1 ($9168.76 in chips) 
Seat 3: Mpr@59  ($6955.68 in chips) 
Seat 4: Nucking Futs ($9550 in chips) 
Seat 5: tabby20 ($33708.94 in chips) 
Seat 6: manny007 ($1315.6 in chips) 
Lucifer999: posts small blind $50
theplaya1: posts big blind $100
*** HOLE CARDS ***
Dealt to Lucifer999 [Kh 2c]
Mpr@59 : calls $100
Nucking Futs: raises $350.00 to $450
tabby20: folds
manny007: folds
Lucifer999: folds
theplaya1: calls $350
Mpr@59 : calls $350
*** FLOP *** [6s 6c 2h]
theplaya1: checks
Mpr@59 : checks
Nucking Futs: bets $1338.4
theplaya1: folds
Mpr@59 : calls $1338.4
*** TURN *** [6s 6c 2h] [8d]
Mpr@59 : checks
Nucking Futs: bets $5351.66
Mpr@59 : folds
Uncalled bet ($5351.66) returned to Nucking Futs
Nucking Futs: doesn't show hand
Nucking Futs collected $3897.46 from pot
*** SUMMARY ***
Total pot $4076.80 | Rake $179.34
Board [6s 6c 2h 8d]
Seat 1: Lucifer999 (small blind) folded before Flop
Seat 2: theplaya1 (big blind) folded on the Flop
Seat 3: Mpr@59  folded on the Turn
Seat 4: Nucking Futs collected ($3897.46)
Seat 5: tabby20 folded before Flop (didn't bet)
Seat 6: manny007 (button) folded before Flop (didn't bet)



PokerStars Game #00327546247: Hold'em No Limit ($25/$50 USD) - 2022/04/30 11:28:23 ET
Table 'Hold'em (Min 1K Max 5K)   216' 6-max Seat #2 is the button
Seat 1: Lucifer999 ($13489.72 in chips) 
Seat 2: rahulh1 ($1402.14 in chips) 
Seat 4: No username ($4576.11 in chips) 
Seat 6: akshark108 ($1680.81 in chips) 
akshark108: posts small blind $25
Lucifer999: posts big blind $50
*** HOLE CARDS ***
Dealt to Lucifer999 [Kc 6c]
rahulh1: raises $81.25 to $131.25
akshark108: folds
Lucifer999: folds
Uncalled bet ($81.25) returned to rahulh1
rahulh1: doesn't show hand
rahulh1 collected $125 from pot
*** SUMMARY ***
Total pot $125.00 | Rake $0
Board []
Seat 1: Lucifer999 (big blind) folded before Flop
Seat 2: rahulh1 (button) collected ($125)
Seat 6: akshark108 (small blind) folded before Flop



PokerStars Game #00327546232: Hold'em No Limit ($10/$25 USD) - 2022/04/30 11:28:14 ET
Table 'Hold'em (Min 500Max 2500)  1282' 6-max Seat #4 is the button
Seat 1: movetome ($3014.85 in chips) 
Seat 2: RaghSaiAyy ($1212.8 in chips) 
Seat 3: Mastkalandar ($3095.74 in chips) 
Seat 4: papadickkies ($585.2 in chips) 
Seat 5: Lucifer999 ($10216.07 in chips) 
Seat 6: devi7 ($4128.25 in chips) 
Lucifer999: posts small blind $10
devi7: posts big blind $25
*** HOLE CARDS ***
Dealt to Lucifer999 [As 8c]
movetome: folds
Mastkalandar: folds
papadickkies: folds
Lucifer999: raises $55.00 to $80
devi7: calls $55
*** FLOP *** [6s 9s 4c]
Lucifer999: bets $120
devi7: folds
Uncalled bet ($120) returned to Lucifer999
Lucifer999: doesn't show hand
Lucifer999 collected $150.6 from pot
*** SUMMARY ***
Total pot $160.00 | Rake $9.4
Board [6s 9s 4c]
Seat 1: movetome folded before Flop (didn't bet)
Seat 3: Mastkalandar folded before Flop (didn't bet)
Seat 4: papadickkies (button) folded before Flop (didn't bet)
Seat 5: Lucifer999 (small blind) collected ($150.6)
Seat 6: devi7 (big blind) folded on the Flop



PokerStars Game #00327546217: Hold'em No Limit ($10/$25 USD) - 2022/04/30 11:28:08 ET
Table 'Hold'em (Min 500Max 2500) 1001' 6-max Seat #1 is the button
Seat 1: JaspritBumrah786 ($2025 in chips) 
Seat 2: fishfry123 ($2951.04 in chips) 
Seat 4: devi7 ($2879.76 in chips) 
Seat 5: Lucifer999 ($4417.72 in chips) 
Seat 6: spidy02 ($3826.11 in chips) 
fishfry123: posts small blind $10
devi7: posts big blind $25
*** HOLE CARDS ***
Dealt to Lucifer999 [5c 2d]
Lucifer999: folds
spidy02: calls $25
JaspritBumrah786: folds
fishfry123: calls $15
devi7: raises $90.00 to $115
spidy02: calls $90
fishfry123: calls $90
*** FLOP *** [9h Ks 8h]
fishfry123: checks
devi7: checks
spidy02: checks
*** TURN *** [9h Ks 8h] [5s]
fishfry123: checks
devi7: bets $323.89
spidy02: folds
fishfry123: folds
Uncalled bet ($323.89) returned to devi7
devi7: doesn't show hand
devi7 collected $323.89 from pot
*** SUMMARY ***
Total pot $345.00 | Rake $21.11
Board [9h Ks 8h 5s]
Seat 1: JaspritBumrah786 (button) folded before Flop (didn't bet)
Seat 2: fishfry123 (small blind) folded on the Turn
Seat 4: devi7 (big blind) collected ($323.89)
Seat 5: Lucifer999 folded before Flop (didn't bet)
Seat 6: spidy02 folded on the Turn



PokerStars Game #00327546296: Hold'em No Limit ($50/$100 USD) - 2022/04/30 11:28:43 ET
Table 'Hold'em (Min 25KMax 10K)    69' 6-max Seat #1 is the button
Seat 1: Lucifer999 ($20586.51 in chips) 
Seat 2: theplaya1 ($8718.76 in chips) 
Seat 3: Mpr@59  ($5167.28 in chips) 
Seat 4: Nucking Futs ($11659.06 in chips) 
Seat 5: tabby20 ($33708.94 in chips) 
Seat 6: manny007 ($1315.6 in chips) 
theplaya1: posts small blind $50
Mpr@59 : posts big blind $100
*** HOLE CARDS ***
Dealt to Lucifer999 [4s 3h]
Nucking Futs: calls $100
tabby20: folds
manny007: folds
Lucifer999: folds
theplaya1: raises $181.00 to $281
Mpr@59 : folds
Nucking Futs: calls $181
*** FLOP *** [6s 9s 7c]
theplaya1: bets $417.7
Nucking Futs: folds
Uncalled bet ($417.7) returned to theplaya1
theplaya1: doesn't show hand
theplaya1 collected $632.88 from pot
*** SUMMARY ***
Total pot $662.00 | Rake $29.12
Board [6s 9s 7c]
Seat 1: Lucifer999 (button) folded before Flop (didn't bet)
Seat 2: theplaya1 (small blind) collected ($632.88)
Seat 3: Mpr@59  (big blind) folded before Flop
Seat 4: Nucking Futs folded on the Flop
Seat 5: tabby20 folded before Flop (didn't bet)
Seat 6: manny007 folded before Flop (didn't bet)



PokerStars Game #00327546303: Hold'em No Limit ($25/$50 USD) - 2022/04/30 11:28:46 ET
Table 'Hold'em (Min 1K Max 5K)   216' 6-max Seat #6 is the button
Seat 1: Lucifer999 ($13439.72 in chips) 
Seat 2: rahulh1 ($1477.14 in chips) 
Seat 4: No username ($4576.11 in chips) 
Seat 6: akshark108 ($1655.81 in chips) 
Lucifer999: posts small blind $25
rahulh1: posts big blind $50
*** HOLE CARDS ***
Dealt to Lucifer999 [Th 6d]
No username: raises $100.00 to $150
akshark108: folds
Lucifer999: folds
rahulh1: folds
Uncalled bet ($150) returned to No username
No username: doesn't show hand
No username collected $150 from pot
*** SUMMARY ***
Total pot $150.00 | Rake $0
Board []
Seat 1: Lucifer999 (small blind) folded before Flop
Seat 2: rahulh1 (big blind) folded before Flop
Seat 4: No username collected ($150)
Seat 6: akshark108 (button) folded before Flop (didn't bet)



PokerStars Game #00327546338: Hold'em No Limit ($10/$25 USD) - 2022/04/30 11:29:03 ET
Table 'Hold'em (Min 500Max 2500)  1282' 6-max Seat #5 is the button
Seat 1: movetome ($3014.85 in chips) 
Seat 2: RaghSaiAyy ($1212.8 in chips) 
Seat 3: Mastkalandar ($3095.74 in chips) 
Seat 4: papadickkies ($585.2 in chips) 
Seat 5: Lucifer999 ($10286.67 in chips) 
Seat 6: devi7 ($4048.25 in chips) 
devi7: posts small blind $10
movetome: posts big blind $25
*** HOLE CARDS ***
Dealt to Lucifer999 [5s 6h]
Mastkalandar: folds
papadickkies: folds
Lucifer999: folds
devi7: folds
Uncalled bet ($15) returned to movetome
movetome: doesn't show hand
movetome collected $20 from pot
*** SUMMARY ***
Total pot $20.00 | Rake $0
Board []
Seat 1: movetome (big blind) collected ($20)
Seat 3: Mastkalandar folded before Flop (didn't bet)
Seat 4: papadickkies folded before Flop (didn't bet)
Seat 5: Lucifer999 (button) folded before Flop (didn't bet)
Seat 6: devi7 (small blind) folded before Flop



PokerStars Game #00327546372: Hold'em No Limit ($25/$50 USD) - 2022/04/30 11:29:18 ET
Table 'Hold'em (Min 1K Max 5K)   216' 6-max Seat #1 is the button
Seat 1: Lucifer999 ($13414.72 in chips) 
Seat 2: rahulh1 ($1427.14 in chips) 
Seat 4: No username ($4651.11 in chips) 
Seat 6: akshark108 ($1655.81 in chips) 
rahulh1: posts small blind $25
No username: posts big blind $50
*** HOLE CARDS ***
Dealt to Lucifer999 [5d 3c]
akshark108: calls $50
Lucifer999: folds
rahulh1: calls $25
No username: raises $4601.11 to $4651.11
akshark108: folds
rahulh1: folds
Uncalled bet ($4601.11) returned to No username
No username: doesn't show hand
No username collected $150 from pot
*** SUMMARY ***
Total pot $150.00 | Rake $0
Board []
Seat 1: Lucifer999 (button) folded before Flop (didn't bet)
Seat 2: rahulh1 (small blind) folded before Flop
Seat 4: No username (big blind) collected ($150)
Seat 6: akshark108 folded before Flop



PokerStars Game #00327546398: Hold'em No Limit ($10/$25 USD) - 2022/04/30 11:29:28 ET
Table 'Hold'em (Min 500Max 2500)  1282' 6-max Seat #6 is the button
Seat 1: movetome ($3024.85 in chips) 
Seat 2: RaghSaiAyy ($1212.8 in chips) 
Seat 3: Mastkalandar ($3095.74 in chips) 
Seat 4: papadickkies ($585.2 in chips) 
Seat 5: Lucifer999 ($10286.67 in chips) 
Seat 6: devi7 ($4038.25 in chips) 
movetome: posts small blind $10
Mastkalandar: posts big blind $25
*** HOLE CARDS ***
Dealt to Lucifer999 [3d 9h]
papadickkies: folds
Lucifer999: folds
devi7: folds
movetome: folds
Uncalled bet ($15) returned to Mastkalandar
Mastkalandar: doesn't show hand
Mastkalandar collected $20 from pot
*** SUMMARY ***
Total pot $20.00 | Rake $0
Board []
Seat 1: movetome (small blind) folded before Flop
Seat 3: Mastkalandar (big blind) collected ($20)
Seat 4: papadickkies folded before Flop (didn't bet)
Seat 5: Lucifer999 folded before Flop (didn't bet)
Seat 6: devi7 (button) folded before Flop (didn't bet)



PokerStars Game #00327546425: Hold'em No Limit ($25/$50 USD) - 2022/04/30 11:29:39 ET
Table 'Hold'em (Min 1K Max 5K)   216' 6-max Seat #2 is the button
Seat 1: Lucifer999 ($13414.72 in chips) 
Seat 2: rahulh1 ($1377.14 in chips) 
Seat 4: No username ($4751.11 in chips) 
Seat 6: akshark108 ($1605.81 in chips) 
No username: posts small blind $25
akshark108: posts big blind $50
*** HOLE CARDS ***
Dealt to Lucifer999 [Js 9h]
Lucifer999: folds
rahulh1: folds
No username: raises $125.00 to $175
akshark108: folds
Uncalled bet ($125) returned to No username
No username: doesn't show hand
No username collected $100 from pot
*** SUMMARY ***
Total pot $100.00 | Rake $0
Board []
Seat 1: Lucifer999 folded before Flop (didn't bet)
Seat 2: rahulh1 (button) folded before Flop (didn't bet)
Seat 4: No username (small blind) collected ($100)
Seat 6: akshark108 (big blind) folded before Flop



PokerStars Game #00327546365: Hold'em No Limit ($50/$100 USD) - 2022/04/30 11:29:14 ET
Table 'Hold'em (Min 25KMax 10K)    69' 6-max Seat #2 is the button
Seat 1: Lucifer999 ($20586.51 in chips) 
Seat 2: theplaya1 ($9070.64 in chips) 
Seat 3: Mpr@59  ($5067.28 in chips) 
Seat 4: Nucking Futs ($11378.06 in chips) 
Seat 5: tabby20 ($33708.94 in chips) 
Seat 6: manny007 ($1315.6 in chips) 
Mpr@59 : posts small blind $50
Nucking Futs: posts big blind $100
*** HOLE CARDS ***
Dealt to Lucifer999 [Ad 6h]
tabby20: folds
manny007: folds
Lucifer999: folds
theplaya1: raises $131.00 to $231
Mpr@59 : folds
Nucking Futs: calls $131
*** FLOP *** [Kd 8d 9c]
Nucking Futs: checks
theplaya1: bets $323.06
Nucking Futs: calls $323.06
*** TURN *** [Kd 8d 9c] [Qs]
Nucking Futs: checks
theplaya1: bets $1107.17
Nucking Futs: calls $1107.17
*** RIVER *** [Kd 8d 9c Qs] [5s]
Nucking Futs: checks
theplaya1: bets $3224.1
Nucking Futs: folds
Uncalled bet ($3224.1) returned to theplaya1
theplaya1: doesn't show hand
theplaya1 collected $3224.1 from pot
*** SUMMARY ***
Total pot $3372.46 | Rake $148.36
Board [Kd 8d 9c Qs 5s]
Seat 1: Lucifer999 folded before Flop (didn't bet)
Seat 2: theplaya1 (button) collected ($3224.1)
Seat 3: Mpr@59  (small blind) folded before Flop
Seat 4: Nucking Futs (big blind) folded on the River
Seat 5: tabby20 folded before Flop (didn't bet)
Seat 6: manny007 folded before Flop (didn't bet)



PokerStars Game #00327546354: Hold'em No Limit ($10/$25 USD) - 2022/04/30 11:29:09 ET
Table 'Hold'em (Min 500Max 2500) 1001' 6-max Seat #2 is the button
Seat 1: JaspritBumrah786 ($2025 in chips) 
Seat 2: fishfry123 ($2836.04 in chips) 
Seat 4: devi7 ($3088.65 in chips) 
Seat 5: Lucifer999 ($4417.72 in chips) 
Seat 6: spidy02 ($3711.11 in chips) 
devi7: posts small blind $10
Lucifer999: posts big blind $25
*** HOLE CARDS ***
Dealt to Lucifer999 [Kc Qc]
spidy02: folds
JaspritBumrah786: folds
fishfry123: folds
devi7: raises $55.00 to $80
Lucifer999: calls $55
*** FLOP *** [8h 6d 7c]
devi7: bets $75
Lucifer999: folds
Uncalled bet ($75) returned to devi7
devi7: doesn't show hand
devi7 collected $150.6 from pot
*** SUMMARY ***
Total pot $160.00 | Rake $9.4
Board [8h 6d 7c]
Seat 1: JaspritBumrah786 folded before Flop (didn't bet)
Seat 2: fishfry123 (button) folded before Flop (didn't bet)
Seat 4: devi7 (small blind) collected ($150.6)
Seat 5: Lucifer999 (big blind) folded on the Flop
Seat 6: spidy02 folded before Flop (didn't bet)



PokerStars Game #00327546470: Hold'em No Limit ($10/$25 USD) - 2022/04/30 11:29:59 ET
Table 'Hold'em (Min 500Max 2500)  1282' 6-max Seat #1 is the button
Seat 1: movetome ($3014.85 in chips) 
Seat 2: RaghSaiAyy ($1212.8 in chips) 
Seat 3: Mastkalandar ($3105.74 in chips) 
Seat 4: papadickkies ($585.2 in chips) 
Seat 5: Lucifer999 ($10286.67 in chips) 
Seat 6: devi7 ($4038.25 in chips) 
Mastkalandar: posts small blind $10
papadickkies: posts big blind $25
*** HOLE CARDS ***
Dealt to Lucifer999 [7h 3d]
Lucifer999: folds
devi7: folds
movetome: folds
Mastkalandar: raises $50.00 to $75
papadickkies: raises $150.00 to $225
Mastkalandar: calls $150
*** FLOP *** [6c 7c 4c]
Mastkalandar: checks
papadickkies: bets $360.2
Mastkalandar: calls $360.2
*** TURN *** [6c 7c 4c] [As]
*** RIVER *** [6c 7c 4c As] [5h]
*** SHOW DOWN ***
Mastkalandar: shows [8c Qc] (Flush, Q high)
papadickkies: shows [Ts Th] (Pair, TT)
Mastkalandar collected $1103.98 from pot
*** SUMMARY ***
Total pot $1170.40 | Rake $66.42
Board [6c 7c 4c As 5h]
Seat 1: movetome (button) folded before Flop (didn't bet)
Seat 3: Mastkalandar  (small blind) showed [8c Qc] and won ($1103.98) with Flush, Q high
Seat 4: papadickkies (big blind) showed [Ts Th] and lost with Pair, TT
Seat 5: Lucifer999 folded before Flop (didn't bet)
Seat 6: devi7 folded before Flop (didn't bet)



PokerStars Game #00327546573: Hold'em No Limit ($10/$25 USD) - 2022/04/30 11:30:26 ET
Table 'Hold'em (Min 500Max 2500) 1001' 6-max Seat #4 is the button
Seat 1: JaspritBumrah786 ($2025 in chips) 
Seat 2: fishfry123 ($2836.04 in chips) 
Seat 4: devi7 ($3159.25 in chips) 
Seat 5: Lucifer999 ($4337.72 in chips) 
Seat 6: spidy02 ($3711.11 in chips) 
Lucifer999: posts small blind $10
spidy02: posts big blind $25
*** HOLE CARDS ***
Dealt to Lucifer999 [Jc Ts]
JaspritBumrah786: folds
devi7: folds
Lucifer999: raises $55.00 to $80
spidy02: folds
Uncalled bet ($55) returned to Lucifer999
Lucifer999: doesn't show hand
Lucifer999 collected $50 from pot
*** SUMMARY ***
Total pot $50.00 | Rake $0
Board []
Seat 1: JaspritBumrah786 folded before Flop (didn't bet)
Seat 4: devi7 (button) folded before Flop (didn't bet)
Seat 5: Lucifer999 (small blind) collected ($50)
Seat 6: spidy02 (big blind) folded before Flop



PokerStars Game #00327546509: Hold'em No Limit ($25/$50 USD) - 2022/04/30 11:30:05 ET
Table 'Hold'em (Min 1K Max 5K)   216' 6-max Seat #4 is the button
Seat 1: Lucifer999 ($13414.72 in chips) 
Seat 2: rahulh1 ($1377.14 in chips) 
Seat 4: No username ($4801.11 in chips) 
Seat 6: akshark108 ($1555.81 in chips) 
akshark108: posts small blind $25
Lucifer999: posts big blind $50
*** HOLE CARDS ***
Dealt to Lucifer999 [Td 7s]
rahulh1: raises $125.00 to $175
No username: calls $175
akshark108: folds
Lucifer999: folds
*** FLOP *** [Kd 5h 3s]
rahulh1: bets $302.81
No username: calls $302.81
*** TURN *** [Kd 5h 3s] [Jh]
rahulh1: bets $652.75
No username: raises $652.75 to $1305.5
rahulh1: calls $246.58
Uncalled bet ($406.17) returned to No username
*** RIVER *** [Kd 5h 3s Jh] [Qc]
*** RIVER *** [Kd 5h 3s Jh] [6h]
*** SHOW DOWN ***
rahulh1: shows [Jc Kh] (Two pairs, KKJJ)
No username: shows [3c Kc] (Two pairs, KK33)
rahulh1 collected $1343.92 from pot
rahulh1 collected $1343.91 from pot
*** SUMMARY ***
Total pot $2829.28 | Rake $141.45
Board [Kd 5h 3s Jh Qc]
Seat 1: Lucifer999 (big blind) folded before Flop
Seat 2: rahulh1  showed [Jc Kh] and won ($1343.91) with Two pairs, KKJJ
Seat 4: No username (button) showed [3c Kc] and lost with Two pairs, KK33
Seat 6: akshark108 (small blind) folded before Flop



PokerStars Game #00327546556: Hold'em No Limit ($50/$100 USD) - 2022/04/30 11:30:21 ET
Table 'Hold'em (Min 25KMax 10K)    69' 6-max Seat #3 is the button
Seat 1: Lucifer999 ($20586.51 in chips) 
Seat 2: theplaya1 ($10633.51 in chips) 
Seat 3: Mpr@59  ($5017.28 in chips) 
Seat 4: Nucking Futs ($9716.83 in chips) 
Seat 5: tabby20 ($33708.94 in chips) 
Seat 6: manny007 ($1315.6 in chips) 
Nucking Futs: posts small blind $50
tabby20: posts big blind $100
*** HOLE CARDS ***
Dealt to Lucifer999 [2s 8c]
manny007: calls $100
Lucifer999: folds
theplaya1: raises $197.00 to $297
Mpr@59 : raises $844.00 to $1141
Nucking Futs: folds
tabby20: folds
manny007: folds
theplaya1: calls $844
*** FLOP *** [Th Ac 3d]
theplaya1: checks
Mpr@59 : bets $2420.6
theplaya1: folds
Uncalled bet ($2420.6) returned to Mpr@59 
Mpr@59 : doesn't show hand
Mpr@59  collected $2420.6 from pot
*** SUMMARY ***
Total pot $2532.00 | Rake $111.4
Board [Th Ac 3d]
Seat 1: Lucifer999 folded before Flop (didn't bet)
Seat 2: theplaya1 folded on the Flop
Seat 3: Mpr@59  (button) collected ($2420.6)
Seat 4: Nucking Futs (small blind) folded before Flop
Seat 5: tabby20 (big blind) folded before Flop
Seat 6: manny007 folded before Flop



PokerStars Game #00327546642: Hold'em No Limit ($10/$25 USD) - 2022/04/30 11:30:45 ET
Table 'Hold'em (Min 500Max 2500)  1282' 6-max Seat #3 is the button
Seat 1: movetome ($3014.85 in chips) 
Seat 2: RaghSaiAyy ($1212.8 in chips) 
Seat 3: Mastkalandar ($3624.52 in chips) 
Seat 5: Lucifer999 ($10286.67 in chips) 
Seat 6: devi7 ($4038.25 in chips) 
Lucifer999: posts small blind $10
devi7: posts big blind $25
*** HOLE CARDS ***
Dealt to Lucifer999 [Jd 3h]
movetome: folds
Mastkalandar: folds
Lucifer999: folds
Uncalled bet ($15) returned to devi7
devi7: doesn't show hand
devi7 collected $20 from pot
*** SUMMARY ***
Total pot $20.00 | Rake $0
Board []
Seat 1: movetome folded before Flop (didn't bet)
Seat 3: Mastkalandar (button) folded before Flop (didn't bet)
Seat 5: Lucifer999 (small blind) folded before Flop
Seat 6: devi7 (big blind) collected ($20)



PokerStars Game #00327546688: Hold'em No Limit ($10/$25 USD) - 2022/04/30 11:30:59 ET
Table 'Hold'em (Min 500Max 2500)  1282' 6-max Seat #5 is the button
Seat 1: movetome ($3014.85 in chips) 
Seat 2: RaghSaiAyy ($1212.8 in chips) 
Seat 3: Mastkalandar ($3624.52 in chips) 
Seat 5: Lucifer999 ($10276.67 in chips) 
Seat 6: devi7 ($4048.25 in chips) 
devi7: posts small blind $10
movetome: posts big blind $25
*** HOLE CARDS ***
Dealt to Lucifer999 [6h Qs]
Mastkalandar: folds
Lucifer999: raises $55.00 to $80
devi7: folds
movetome: folds
Uncalled bet ($55) returned to Lucifer999
Lucifer999: doesn't show hand
Lucifer999 collected $60 from pot
*** SUMMARY ***
Total pot $60.00 | Rake $0
Board []
Seat 1: movetome (big blind) folded before Flop
Seat 3: Mastkalandar folded before Flop (didn't bet)
Seat 5: Lucifer999 (button) collected ($60)
Seat 6: devi7 (small blind) folded before Flop



PokerStars Game #00327546666: Hold'em No Limit ($10/$25 USD) - 2022/04/30 11:30:55 ET
Table 'Hold'em (Min 500Max 2500) 1001' 6-max Seat #5 is the button
Seat 1: JaspritBumrah786 ($2025 in chips) 
Seat 2: fishfry123 ($2836.04 in chips) 
Seat 4: devi7 ($3159.25 in chips) 
Seat 5: Lucifer999 ($4362.72 in chips) 
Seat 6: spidy02 ($3686.11 in chips) 
spidy02: posts small blind $10
JaspritBumrah786: posts big blind $25
*** HOLE CARDS ***
Dealt to Lucifer999 [Td As]
fishfry123: calls $25
devi7: folds
Lucifer999: raises $85.00 to $110
spidy02: folds
JaspritBumrah786: calls $85
fishfry123: calls $85
*** FLOP *** [4c Ks Jd]
JaspritBumrah786: checks
fishfry123: checks
Lucifer999: checks
*** TURN *** [4c Ks Jd] [2h]
JaspritBumrah786: bets $225
fishfry123: folds
Lucifer999: folds
Uncalled bet ($225) returned to JaspritBumrah786
JaspritBumrah786: doesn't show hand
JaspritBumrah786 collected $319.15 from pot
*** SUMMARY ***
Total pot $340.00 | Rake $20.85
Board [4c Ks Jd 2h]
Seat 1: JaspritBumrah786 (big blind) collected ($319.15)
Seat 2: fishfry123 folded on the Turn
Seat 4: devi7 folded before Flop (didn't bet)
Seat 5: Lucifer999 (button) folded on the Turn
Seat 6: spidy02 (small blind) folded before Flop



PokerStars Game #00327546675: Hold'em No Limit ($25/$50 USD) - 2022/04/30 11:30:56 ET
Table 'Hold'em (Min 1K Max 5K)   216' 6-max Seat #6 is the button
Seat 1: Lucifer999 ($13364.72 in chips) 
Seat 2: rahulh1 ($2687.83 in chips) 
Seat 4: No username ($3423.97 in chips) 
Seat 6: akshark108 ($1530.81 in chips) 
Lucifer999: posts small blind $25
rahulh1: posts big blind $50
*** HOLE CARDS ***
Dealt to Lucifer999 [7c 9s]
No username: folds
akshark108: calls $50
Lucifer999: calls $25
rahulh1: checks
*** FLOP *** [2c Qd Ac]
Lucifer999: checks
rahulh1: checks
akshark108: checks
*** TURN *** [2c Qd Ac] [5d]
Lucifer999: checks
rahulh1: checks
akshark108: bets $71.25
Lucifer999: folds
rahulh1: calls $71.25
*** RIVER *** [2c Qd Ac 5d] [Ad]
rahulh1: checks
akshark108: checks
*** SHOW DOWN ***
akshark108: shows [Qh Ts] (Two pairs, AAQQ)
rahulh1: doesn't show hand
akshark108 collected $277.9 from pot
*** SUMMARY ***
Total pot $292.50 | Rake $14.6
Board [2c Qd Ac 5d Ad]
Seat 1: Lucifer999 (small blind) folded on the Turn
Seat 2: rahulh1 (big blind) mucked
Seat 4: No username folded before Flop (didn't bet)
Seat 6: akshark108  (button) showed [Qh Ts] and won ($277.9) with Two pairs, AAQQ



PokerStars Game #00327546683: Hold'em No Limit ($50/$100 USD) - 2022/04/30 11:30:58 ET
Table 'Hold'em (Min 25KMax 10K)    69' 6-max Seat #4 is the button
Seat 1: Lucifer999 ($20586.51 in chips) 
Seat 2: theplaya1 ($9492.51 in chips) 
Seat 3: Mpr@59  ($6296.88 in chips) 
Seat 4: Nucking Futs ($9666.83 in chips) 
Seat 5: tabby20 ($33608.94 in chips) 
Seat 6: manny007 ($1215.6 in chips) 
tabby20: posts small blind $50
manny007: posts big blind $100
*** HOLE CARDS ***
Dealt to Lucifer999 [3h 9h]
Lucifer999: folds
theplaya1: raises $100.00 to $200
Mpr@59 : raises $550.00 to $750
Nucking Futs: folds
tabby20: folds
manny007: folds
theplaya1: calls $550
*** FLOP *** [Th Ks Ad]
theplaya1: checks
Mpr@59 : bets $1577.4
theplaya1: calls $1577.4
*** TURN *** [Th Ks Ad] [Jc]
theplaya1: bets $4593.43
Mpr@59 : calls $3969.48
Uncalled bet ($623.95) returned to theplaya1
*** RIVER *** [Th Ks Ad Jc] [3c]
*** RIVER *** [Th Ks Ad Jc] [Kh]
*** SHOW DOWN ***
theplaya1: shows [6d Ac] (Two pairs, AAKK)
Mpr@59 : shows [Qc Kd] (Straight, A-T)
Mpr@59  collected $6151.88 from pot
Mpr@59  collected $6151.88 from pot
*** SUMMARY ***
Total pot $12743.76 | Rake $440
Board [Th Ks Ad Jc 3c]
Seat 1: Lucifer999 folded before Flop (didn't bet)
Seat 2: theplaya1 showed [6d Ac] and lost with Two pairs, AAKK
Seat 3: Mpr@59   showed [Qc Kd] and won ($6151.88) with Straight, A-T
Seat 4: Nucking Futs (button) folded before Flop (didn't bet)
Seat 5: tabby20 (small blind) folded before Flop
Seat 6: manny007 (big blind) folded before Flop



PokerStars Game #00327546850: Hold'em No Limit ($25/$50 USD) - 2022/04/30 11:31:44 ET
Table 'Hold'em (Min 1K Max 5K)   216' 6-max Seat #1 is the button
Seat 1: Lucifer999 ($13314.72 in chips) 
Seat 2: rahulh1 ($2566.58 in chips) 
Seat 4: No username ($3423.97 in chips) 
Seat 6: akshark108 ($1687.46 in chips) 
rahulh1: posts small blind $25
No username: posts big blind $50
*** HOLE CARDS ***
Dealt to Lucifer999 [Ad 3c]
akshark108: folds
Lucifer999: folds
rahulh1: calls $25
No username: raises $100.00 to $150
rahulh1: folds
Uncalled bet ($100) returned to No username
No username: doesn't show hand
No username collected $100 from pot
*** SUMMARY ***
Total pot $100.00 | Rake $0
Board []
Seat 1: Lucifer999 (button) folded before Flop (didn't bet)
Seat 2: rahulh1 (small blind) folded before Flop
Seat 4: No username (big blind) collected ($100)
Seat 6: akshark108 folded before Flop (didn't bet)



PokerStars Game #00327546819: Hold'em No Limit ($10/$25 USD) - 2022/04/30 11:31:36 ET
Table 'Hold'em (Min 500Max 2500) 1001' 6-max Seat #6 is the button
Seat 1: JaspritBumrah786 ($2344.15 in chips) 
Seat 2: fishfry123 ($2726.04 in chips) 
Seat 4: devi7 ($3159.25 in chips) 
Seat 5: Lucifer999 ($4252.72 in chips) 
Seat 6: spidy02 ($3676.11 in chips) 
JaspritBumrah786: posts small blind $10
fishfry123: posts big blind $25
*** HOLE CARDS ***
Dealt to Lucifer999 [8s 2d]
devi7: raises $50.00 to $75
Lucifer999: folds
spidy02: folds
JaspritBumrah786: folds
fishfry123: calls $50
*** FLOP *** [3c 7s 9h]
fishfry123: checks
devi7: bets $99.4
fishfry123: calls $99.4
*** TURN *** [3c 7s 9h] [Td]
fishfry123: checks
devi7: bets $168.51
fishfry123: folds
Uncalled bet ($168.51) returned to devi7
devi7: doesn't show hand
devi7 collected $337.01 from pot
*** SUMMARY ***
Total pot $358.80 | Rake $21.79
Board [3c 7s 9h Td]
Seat 1: JaspritBumrah786 (small blind) folded before Flop
Seat 2: fishfry123 (big blind) folded on the Turn
Seat 4: devi7 collected ($337.01)
Seat 5: Lucifer999 folded before Flop (didn't bet)
Seat 6: spidy02 (button) folded before Flop (didn't bet)



PokerStars Game #00327546772: Hold'em No Limit ($10/$25 USD) - 2022/04/30 11:31:26 ET
Table 'Hold'em (Min 500Max 2500)  1282' 6-max Seat #6 is the button
Seat 1: movetome ($2989.85 in chips) 
Seat 2: RaghSaiAyy ($1212.8 in chips) 
Seat 3: Mastkalandar ($3624.52 in chips) 
Seat 5: Lucifer999 ($10311.67 in chips) 
Seat 6: devi7 ($4038.25 in chips) 
movetome: posts small blind $10
Mastkalandar: posts big blind $25
*** HOLE CARDS ***
Dealt to Lucifer999 [As Ah]
Lucifer999: folds
devi7: raises $50.00 to $75
movetome: folds
Mastkalandar: raises $150.00 to $225
devi7: raises $252.60 to $477.6
Mastkalandar: calls $252.6
*** FLOP *** [Th 3s 6h]
Mastkalandar: checks
devi7: checks
*** TURN *** [Th 3s 6h] [9s]
Mastkalandar: checks
devi7: checks
*** RIVER *** [Th 3s 6h 9s] [2c]
Mastkalandar: bets $625
devi7: calls $625
*** SHOW DOWN ***
Mastkalandar: shows [8c 8d] (Pair, 88)
devi7: shows [Js Jc] (Pair, JJ)
devi7 collected $2093.92 from pot
*** SUMMARY ***
Total pot $2215.20 | Rake $121.28
Board [Th 3s 6h 9s 2c]
Seat 1: movetome (small blind) folded before Flop
Seat 3: Mastkalandar (big blind) showed [8c 8d] and lost with Pair, 88
Seat 5: Lucifer999 folded before Flop (didn't bet)
Seat 6: devi7  (button) showed [Js Jc] and won ($2093.92) with Pair, JJ



PokerStars Game #00327546958: Hold'em No Limit ($25/$50 USD) - 2022/04/30 11:32:20 ET
Table 'Hold'em (Min 1K Max 5K)   216' 6-max Seat #2 is the button
Seat 1: Lucifer999 ($13314.72 in chips) 
Seat 2: rahulh1 ($2516.58 in chips) 
Seat 4: No username ($3473.97 in chips) 
Seat 6: akshark108 ($1687.46 in chips) 
No username: posts small blind $25
akshark108: posts big blind $50
*** HOLE CARDS ***
Dealt to Lucifer999 [Ah 2d]
Lucifer999: folds
rahulh1: folds
No username: raises $100.00 to $150
akshark108: folds
Uncalled bet ($100) returned to No username
No username: doesn't show hand
No username collected $100 from pot
*** SUMMARY ***
Total pot $100.00 | Rake $0
Board []
Seat 1: Lucifer999 folded before Flop (didn't bet)
Seat 2: rahulh1 (button) folded before Flop (didn't bet)
Seat 4: No username (small blind) collected ($100)
Seat 6: akshark108 (big blind) folded before Flop



PokerStars Game #00327546981: Hold'em No Limit ($10/$25 USD) - 2022/04/30 11:32:27 ET
Table 'Hold'em (Min 500Max 2500)  1282' 6-max Seat #1 is the button
Seat 1: movetome ($2979.85 in chips) 
Seat 2: RaghSaiAyy ($1212.8 in chips) 
Seat 3: Mastkalandar ($2521.92 in chips) 
Seat 5: Lucifer999 ($10311.67 in chips) 
Seat 6: devi7 ($5029.57 in chips) 
Mastkalandar: posts small blind $10
Lucifer999: posts big blind $25
*** HOLE CARDS ***
Dealt to Lucifer999 [3h Tc]
devi7: folds
movetome: raises $50.00 to $75
Mastkalandar: folds
Lucifer999: folds
Uncalled bet ($50) returned to movetome
movetome: doesn't show hand
movetome collected $60 from pot
*** SUMMARY ***
Total pot $60.00 | Rake $0
Board []
Seat 1: movetome (button) collected ($60)
Seat 3: Mastkalandar (small blind) folded before Flop
Seat 5: Lucifer999 (big blind) folded before Flop
Seat 6: devi7 folded before Flop (didn't bet)



PokerStars Game #00327546877: Hold'em No Limit ($50/$100 USD) - 2022/04/30 11:31:51 ET
Table 'Hold'em (Min 25KMax 10K)    69' 6-max Seat #5 is the button
Seat 1: Lucifer999 ($20586.51 in chips) 
Seat 2: theplaya1 ($3195.63 in chips) 
Seat 3: Mpr@59  ($12303.76 in chips) 
Seat 4: Nucking Futs ($9666.83 in chips) 
Seat 5: tabby20 ($33558.94 in chips) 
Seat 6: manny007 ($1115.6 in chips) 
manny007: posts small blind $50
Lucifer999: posts big blind $100
*** HOLE CARDS ***
Dealt to Lucifer999 [Qd 9s]
theplaya1: calls $100
Mpr@59 : calls $100
Nucking Futs: folds
tabby20: folds
manny007: folds
Lucifer999: checks
*** FLOP *** [8s Qc Ad]
Lucifer999: checks
theplaya1: checks
Mpr@59 : checks
*** TURN *** [8s Qc Ad] [3h]
Lucifer999: checks
theplaya1: checks
Mpr@59 : checks
*** RIVER *** [8s Qc Ad 3h] [6s]
Lucifer999: checks
theplaya1: checks
Mpr@59 : checks
*** SHOW DOWN ***
Lucifer999: shows [Qd 9s] (Pair, QQ)
theplaya1: doesn't show hand
Mpr@59 : doesn't show hand
Lucifer999 collected $334.6 from pot
*** SUMMARY ***
Total pot $350.00 | Rake $15.4
Board [8s Qc Ad 3h 6s]
Seat 1: Lucifer999  (big blind) showed [Qd 9s] and won ($334.6) with Pair, QQ
Seat 2: theplaya1 mucked
Seat 3: Mpr@59  mucked
Seat 4: Nucking Futs folded before Flop (didn't bet)
Seat 5: tabby20 (button) folded before Flop (didn't bet)
Seat 6: manny007 (small blind) folded before Flop



PokerStars Game #00327547073: Hold'em No Limit ($10/$25 USD) - 2022/04/30 11:32:55 ET
Table 'Hold'em (Min 500Max 2500)  1282' 6-max Seat #3 is the button
Seat 1: movetome ($3014.85 in chips) 
Seat 2: RaghSaiAyy ($1212.8 in chips) 
Seat 3: Mastkalandar ($2511.92 in chips) 
Seat 5: Lucifer999 ($10286.67 in chips) 
Seat 6: devi7 ($5029.57 in chips) 
Lucifer999: posts small blind $10
devi7: posts big blind $25
*** HOLE CARDS ***
Dealt to Lucifer999 [3c Th]
movetome: folds
Mastkalandar: folds
Lucifer999: folds
Uncalled bet ($15) returned to devi7
devi7: doesn't show hand
devi7 collected $20 from pot
*** SUMMARY ***
Total pot $20.00 | Rake $0
Board []
Seat 1: movetome folded before Flop (didn't bet)
Seat 3: Mastkalandar (button) folded before Flop (didn't bet)
Seat 5: Lucifer999 (small blind) folded before Flop
Seat 6: devi7 (big blind) collected ($20)



PokerStars Game #00327546969: Hold'em No Limit ($10/$25 USD) - 2022/04/30 11:32:24 ET
Table 'Hold'em (Min 500Max 2500) 1001' 6-max Seat #1 is the button
Seat 1: JaspritBumrah786 ($2334.15 in chips) 
Seat 2: fishfry123 ($2551.64 in chips) 
Seat 4: devi7 ($3321.86 in chips) 
Seat 5: Lucifer999 ($4252.72 in chips) 
Seat 6: spidy02 ($3676.11 in chips) 
fishfry123: posts small blind $10
devi7: posts big blind $25
*** HOLE CARDS ***
Dealt to Lucifer999 [5s 4d]
Lucifer999: folds
spidy02: folds
JaspritBumrah786: raises $50.00 to $75
fishfry123: calls $65
devi7: folds
*** FLOP *** [6h 3d 8c]
fishfry123: checks
JaspritBumrah786: checks
*** TURN *** [6h 3d 8c] [9s]
fishfry123: checks
JaspritBumrah786: bets $125
fishfry123: calls $125
*** RIVER *** [6h 3d 8c 9s] [3c]
fishfry123: checks
JaspritBumrah786: checks
*** SHOW DOWN ***
JaspritBumrah786: shows [Qc As] (Pair, 33)
fishfry123: doesn't show hand
JaspritBumrah786 collected $398.69 from pot
*** SUMMARY ***
Total pot $425.00 | Rake $26.31
Board [6h 3d 8c 9s 3c]
Seat 1: JaspritBumrah786  (button) showed [Qc As] and won ($398.69) with Pair, 33
Seat 2: fishfry123 (small blind) mucked
Seat 4: devi7 (big blind) folded before Flop
Seat 5: Lucifer999 folded before Flop (didn't bet)
Seat 6: spidy02 folded before Flop (didn't bet)



PokerStars Game #00327547040: Hold'em No Limit ($25/$50 USD) - 2022/04/30 11:32:45 ET
Table 'Hold'em (Min 1K Max 5K)   216' 6-max Seat #4 is the button
Seat 1: Lucifer999 ($13314.72 in chips) 
Seat 2: rahulh1 ($2516.58 in chips) 
Seat 4: No username ($3523.97 in chips) 
Seat 6: akshark108 ($1637.46 in chips) 
akshark108: posts small blind $25
Lucifer999: posts big blind $50
*** HOLE CARDS ***
Dealt to Lucifer999 [5d Ah]
rahulh1: folds
No username: raises $66.67 to $116.67
akshark108: folds
Lucifer999: folds
Uncalled bet ($66.67) returned to No username
No username: doesn't show hand
No username collected $125 from pot
*** SUMMARY ***
Total pot $125.00 | Rake $0
Board []
Seat 1: Lucifer999 (big blind) folded before Flop
Seat 2: rahulh1 folded before Flop (didn't bet)
Seat 4: No username (button) collected ($125)
Seat 6: akshark108 (small blind) folded before Flop



PokerStars Game #00327547078: Hold'em No Limit ($50/$100 USD) - 2022/04/30 11:32:56 ET
Table 'Hold'em (Min 25KMax 10K)    69' 6-max Seat #6 is the button
Seat 1: Lucifer999 ($20821.11 in chips) 
Seat 2: theplaya1 ($3095.63 in chips) 
Seat 3: Mpr@59  ($12203.76 in chips) 
Seat 4: Nucking Futs ($9666.83 in chips) 
Seat 5: tabby20 ($33558.94 in chips) 
Seat 6: manny007 ($1065.6 in chips) 
Lucifer999: posts small blind $50
theplaya1: posts big blind $100
*** HOLE CARDS ***
Dealt to Lucifer999 [As Tc]
Mpr@59 : calls $100
Nucking Futs: folds
tabby20: folds
manny007: folds
Lucifer999: raises $350.00 to $450
theplaya1: raises $2645.63 to $3095.63
Mpr@59 : calls $2995.63
Lucifer999: folds
*** FLOP *** [5d Ts 6d]
*** FLOP *** [3c Js 8c]
*** TURN *** [5d Ts 6d] [8s]
*** TURN *** [5d Ts 6d] [9c]
*** RIVER *** [5d Ts 6d 8s] [5h]
*** RIVER *** [5d Ts 6d 8s] [6h]
*** SHOW DOWN ***
theplaya1: shows [Qc Ah] (High card, A)
Mpr@59 : shows [Ad Jd] (Pair, JJ)
theplaya1 collected $3174.53 from pot
Mpr@59  collected $3174.53 from pot
*** SUMMARY ***
Total pot $6641.26 | Rake $292.2
Board [5d Ts 6d 8s 5h]
Seat 1: Lucifer999 (small blind) folded before Flop
Seat 2: theplaya1  (big blind) showed [Qc Ah] and won ($3174.53) with High card, A
Seat 3: Mpr@59   showed [Ad Jd] and won ($3174.53) with Pair, JJ
Seat 4: Nucking Futs folded before Flop (didn't bet)
Seat 5: tabby20 folded before Flop (didn't bet)
Seat 6: manny007 (button) folded before Flop (didn't bet)



PokerStars Game #00327547133: Hold'em No Limit ($10/$25 USD) - 2022/04/30 11:33:09 ET
Table 'Hold'em (Min 500Max 2500)  1282' 6-max Seat #5 is the button
Seat 1: movetome ($3014.85 in chips) 
Seat 2: RaghSaiAyy ($1212.8 in chips) 
Seat 3: Mastkalandar ($2511.92 in chips) 
Seat 5: Lucifer999 ($10276.67 in chips) 
Seat 6: devi7 ($5039.57 in chips) 
devi7: posts small blind $10
movetome: posts big blind $25
*** HOLE CARDS ***
Dealt to Lucifer999 [Ah 4c]
Mastkalandar: folds
Lucifer999: raises $55.00 to $80
devi7: folds
movetome: folds
Uncalled bet ($55) returned to Lucifer999
Lucifer999: doesn't show hand
Lucifer999 collected $60 from pot
*** SUMMARY ***
Total pot $60.00 | Rake $0
Board []
Seat 1: movetome (big blind) folded before Flop
Seat 3: Mastkalandar folded before Flop (didn't bet)
Seat 5: Lucifer999 (button) collected ($60)
Seat 6: devi7 (small blind) folded before Flop



PokerStars Game #00327547139: Hold'em No Limit ($10/$25 USD) - 2022/04/30 11:33:12 ET
Table 'Hold'em (Min 500Max 2500) 1001' 6-max Seat #2 is the button
Seat 1: JaspritBumrah786 ($2532.84 in chips) 
Seat 2: fishfry123 ($2351.64 in chips) 
Seat 4: devi7 ($3296.86 in chips) 
Seat 5: Lucifer999 ($4252.72 in chips) 
Seat 6: spidy02 ($3676.11 in chips) 
devi7: posts small blind $10
Lucifer999: posts big blind $25
*** HOLE CARDS ***
Dealt to Lucifer999 [4c Th]
spidy02: raises $35.00 to $60
JaspritBumrah786: folds
fishfry123: folds
devi7: folds
Lucifer999: folds
Uncalled bet ($35) returned to spidy02
spidy02: doesn't show hand
spidy02 collected $60 from pot
*** SUMMARY ***
Total pot $60.00 | Rake $0
Board []
Seat 1: JaspritBumrah786 folded before Flop (didn't bet)
Seat 2: fishfry123 (button) folded before Flop (didn't bet)
Seat 4: devi7 (small blind) folded before Flop
Seat 5: Lucifer999 (big blind) folded before Flop
Seat 6: spidy02 collected ($60)



PokerStars Game #00327547164: Hold'em No Limit ($25/$50 USD) - 2022/04/30 11:33:21 ET
Table 'Hold'em (Min 1K Max 5K)   216' 6-max Seat #6 is the button
Seat 1: Lucifer999 ($13264.72 in chips) 
Seat 2: rahulh1 ($2516.58 in chips) 
Seat 4: No username ($3598.97 in chips) 
Seat 6: akshark108 ($1612.46 in chips) 
Lucifer999: posts small blind $25
rahulh1: posts big blind $50
*** HOLE CARDS ***
Dealt to Lucifer999 [5c Ad]
No username: raises $125.00 to $175
akshark108: folds
Lucifer999: folds
rahulh1: folds
Uncalled bet ($125) returned to No username
No username: doesn't show hand
No username collected $125 from pot
*** SUMMARY ***
Total pot $125.00 | Rake $0
Board []
Seat 1: Lucifer999 (small blind) folded before Flop
Seat 2: rahulh1 (big blind) folded before Flop
Seat 4: No username collected ($125)
Seat 6: akshark108 (button) folded before Flop (didn't bet)



PokerStars Game #00327547209: Hold'em No Limit ($10/$25 USD) - 2022/04/30 11:33:38 ET
Table 'Hold'em (Min 500Max 2500)  1282' 6-max Seat #6 is the button
Seat 1: movetome ($2989.85 in chips) 
Seat 3: Mastkalandar ($2511.92 in chips) 
Seat 5: Lucifer999 ($10311.67 in chips) 
Seat 6: devi7 ($5029.57 in chips) 
movetome: posts small blind $10
Mastkalandar: posts big blind $25
*** HOLE CARDS ***
Dealt to Lucifer999 [7h 8c]
Lucifer999: folds
devi7: folds
movetome: folds
Uncalled bet ($15) returned to Mastkalandar
Mastkalandar: doesn't show hand
Mastkalandar collected $20 from pot
*** SUMMARY ***
Total pot $20.00 | Rake $0
Board []
Seat 1: movetome (small blind) folded before Flop
Seat 3: Mastkalandar (big blind) collected ($20)
Seat 5: Lucifer999 folded before Flop (didn't bet)
Seat 6: devi7 (button) folded before Flop (didn't bet)



PokerStars Game #00327547235: Hold'em No Limit ($10/$25 USD) - 2022/04/30 11:33:46 ET
Table 'Hold'em (Min 500Max 2500) 1001' 6-max Seat #4 is the button
Seat 1: JaspritBumrah786 ($2532.84 in chips) 
Seat 2: Millie ($2500 in chips) 
Seat 4: devi7 ($3286.86 in chips) 
Seat 5: Lucifer999 ($4227.72 in chips) 
Seat 6: spidy02 ($3711.11 in chips) 
Lucifer999: posts small blind $10
spidy02: posts big blind $25
*** HOLE CARDS ***
Dealt to Lucifer999 [Qh 2s]
JaspritBumrah786: folds
Millie: raises $25.00 to $50
devi7: folds
Lucifer999: folds
spidy02: folds
Uncalled bet ($25) returned to Millie
Millie: doesn't show hand
Millie collected $60 from pot
*** SUMMARY ***
Total pot $60.00 | Rake $0
Board []
Seat 1: JaspritBumrah786 folded before Flop (didn't bet)
Seat 2: Millie collected ($60)
Seat 4: devi7 (button) folded before Flop (didn't bet)
Seat 5: Lucifer999 (small blind) folded before Flop
Seat 6: spidy02 (big blind) folded before Flop



PokerStars Game #00327547195: Hold'em No Limit ($50/$100 USD) - 2022/04/30 11:33:33 ET
Table 'Hold'em (Min 25KMax 10K)    69' 6-max Seat #1 is the button
Seat 1: Lucifer999 ($20371.11 in chips) 
Seat 2: theplaya1 ($3174.53 in chips) 
Seat 3: Mpr@59  ($12282.66 in chips) 
Seat 4: Nucking Futs ($9666.83 in chips) 
Seat 5: tabby20 ($33558.94 in chips) 
Seat 6: manny007 ($1065.6 in chips) 
theplaya1: posts small blind $50
Mpr@59 : posts big blind $100
*** HOLE CARDS ***
Dealt to Lucifer999 [9c 6s]
Nucking Futs: raises $100.00 to $200
tabby20: folds
manny007: folds
Lucifer999: folds
theplaya1: calls $150
Mpr@59 : calls $100
*** FLOP *** [Jc Jd 5s]
theplaya1: checks
Mpr@59 : checks
Nucking Futs: checks
*** TURN *** [Jc Jd 5s] [5h]
theplaya1: checks
Mpr@59 : checks
Nucking Futs: bets $286.8
theplaya1: folds
Mpr@59 : folds
Uncalled bet ($286.8) returned to Nucking Futs
Nucking Futs: doesn't show hand
Nucking Futs collected $573.6 from pot
*** SUMMARY ***
Total pot $600.00 | Rake $26.4
Board [Jc Jd 5s 5h]
Seat 1: Lucifer999 (button) folded before Flop (didn't bet)
Seat 2: theplaya1 (small blind) folded on the Turn
Seat 3: Mpr@59  (big blind) folded on the Turn
Seat 4: Nucking Futs collected ($573.6)
Seat 5: tabby20 folded before Flop (didn't bet)
Seat 6: manny007 folded before Flop (didn't bet)



PokerStars Game #00327547296: Hold'em No Limit ($10/$25 USD) - 2022/04/30 11:34:03 ET
Table 'Hold'em (Min 500Max 2500)  1282' 6-max Seat #1 is the button
Seat 1: movetome ($2979.85 in chips) 
Seat 3: Mastkalandar ($2521.92 in chips) 
Seat 5: Lucifer999 ($10311.67 in chips) 
Seat 6: devi7 ($5029.57 in chips) 
Mastkalandar: posts small blind $10
Lucifer999: posts big blind $25
*** HOLE CARDS ***
Dealt to Lucifer999 [6h As]
devi7: folds
movetome: folds
Mastkalandar: calls $15
Lucifer999: raises $55.00 to $80
Mastkalandar: raises $95.00 to $175
Lucifer999: folds
Uncalled bet ($95) returned to Mastkalandar
Mastkalandar: doesn't show hand
Mastkalandar collected $160 from pot
*** SUMMARY ***
Total pot $160.00 | Rake $0
Board []
Seat 1: movetome (button) folded before Flop (didn't bet)
Seat 3: Mastkalandar (small blind) collected ($160)
Seat 5: Lucifer999 (big blind) folded before Flop
Seat 6: devi7 folded before Flop (didn't bet)



PokerStars Game #00327547361: Hold'em No Limit ($50/$100 USD) - 2022/04/30 11:34:23 ET
Table 'Hold'em (Min 25KMax 10K)    69' 6-max Seat #2 is the button
Seat 1: Lucifer999 ($20371.11 in chips) 
Seat 2: theplaya1 ($2974.53 in chips) 
Seat 3: Mpr@59  ($12082.66 in chips) 
Seat 4: Nucking Futs ($10040.43 in chips) 
Seat 5: tabby20 ($33558.94 in chips) 
Seat 6: manny007 ($1065.6 in chips) 
Mpr@59 : posts small blind $50
Nucking Futs: posts big blind $100
*** HOLE CARDS ***
Dealt to Lucifer999 [7c 2h]
tabby20: folds
manny007: folds
Lucifer999: folds
theplaya1: folds
Mpr@59 : folds
Uncalled bet ($50) returned to Nucking Futs
Nucking Futs: doesn't show hand
Nucking Futs collected $100 from pot
*** SUMMARY ***
Total pot $100.00 | Rake $0
Board []
Seat 1: Lucifer999 folded before Flop (didn't bet)
Seat 2: theplaya1 (button) folded before Flop (didn't bet)
Seat 3: Mpr@59  (small blind) folded before Flop
Seat 4: Nucking Futs (big blind) collected ($100)
Seat 5: tabby20 folded before Flop (didn't bet)
Seat 6: manny007 folded before Flop (didn't bet)



PokerStars Game #00327547339: Hold'em No Limit ($10/$25 USD) - 2022/04/30 11:34:18 ET
Table 'Hold'em (Min 500Max 2500) 1001' 6-max Seat #5 is the button
Seat 1: JaspritBumrah786 ($2532.84 in chips) 
Seat 2: Millie ($2535 in chips) 
Seat 4: devi7 ($3286.86 in chips) 
Seat 5: Lucifer999 ($4217.72 in chips) 
Seat 6: spidy02 ($3686.11 in chips) 
spidy02: posts small blind $10
JaspritBumrah786: posts big blind $25
*** HOLE CARDS ***
Dealt to Lucifer999 [Qc Ks]
Millie: folds
devi7: folds
Lucifer999: folds
spidy02: raises $50.00 to $75
JaspritBumrah786: folds
Uncalled bet ($50) returned to spidy02
spidy02: doesn't show hand
spidy02 collected $50 from pot
*** SUMMARY ***
Total pot $50.00 | Rake $0
Board []
Seat 1: JaspritBumrah786 (big blind) folded before Flop
Seat 2: Millie folded before Flop (didn't bet)
Seat 4: devi7 folded before Flop (didn't bet)
Seat 5: Lucifer999 (button) folded before Flop (didn't bet)
Seat 6: spidy02 (small blind) collected ($50)



PokerStars Game #00327547239: Hold'em No Limit ($25/$50 USD) - 2022/04/30 11:33:47 ET
Table 'Hold'em (Min 1K Max 5K)   216' 6-max Seat #1 is the button
Seat 1: Lucifer999 ($13239.72 in chips) 
Seat 2: rahulh1 ($2466.58 in chips) 
Seat 4: No username ($3673.97 in chips) 
Seat 5: RaghSaiAyy ($5000 in chips) 
Seat 6: akshark108 ($1612.46 in chips) 
rahulh1: posts small blind $25
No username: posts big blind $50
*** HOLE CARDS ***
Dealt to Lucifer999 [Ts 8d]
RaghSaiAyy: raises $25.00 to $75
akshark108: folds
Lucifer999: folds
rahulh1: raises $250.00 to $325
No username: calls $275
RaghSaiAyy: calls $200
*** FLOP *** [4s 6c 9c]
rahulh1: checks
No username: bets $926.25
RaghSaiAyy: folds
rahulh1: folds
Uncalled bet ($926.25) returned to No username
No username: doesn't show hand
No username collected $926.25 from pot
*** SUMMARY ***
Total pot $975.00 | Rake $48.75
Board [4s 6c 9c]
Seat 1: Lucifer999 (button) folded before Flop (didn't bet)
Seat 2: rahulh1 (small blind) folded on the Flop
Seat 4: No username (big blind) collected ($926.25)
Seat 5: RaghSaiAyy folded on the Flop
Seat 6: akshark108 folded before Flop (didn't bet)



PokerStars Game #00327547406: Hold'em No Limit ($10/$25 USD) - 2022/04/30 11:34:37 ET
Table 'Hold'em (Min 500Max 2500)  1282' 6-max Seat #3 is the button
Seat 1: movetome ($2979.85 in chips) 
Seat 3: Mastkalandar ($2601.92 in chips) 
Seat 5: Lucifer999 ($10231.67 in chips) 
Seat 6: devi7 ($5029.57 in chips) 
Lucifer999: posts small blind $10
devi7: posts big blind $25
*** HOLE CARDS ***
Dealt to Lucifer999 [6d 9h]
movetome: raises $50.00 to $75
Mastkalandar: folds
Lucifer999: folds
devi7: folds
Uncalled bet ($50) returned to movetome
movetome: doesn't show hand
movetome collected $60 from pot
*** SUMMARY ***
Total pot $60.00 | Rake $0
Board []
Seat 1: movetome collected ($60)
Seat 3: Mastkalandar (button) folded before Flop (didn't bet)
Seat 5: Lucifer999 (small blind) folded before Flop
Seat 6: devi7 (big blind) folded before Flop



PokerStars Game #00327547450: Hold'em No Limit ($10/$25 USD) - 2022/04/30 11:34:51 ET
Table 'Hold'em (Min 500Max 2500) 1001' 6-max Seat #6 is the button
Seat 1: JaspritBumrah786 ($2507.84 in chips) 
Seat 2: Millie ($2535 in chips) 
Seat 4: devi7 ($3286.86 in chips) 
Seat 5: Lucifer999 ($4217.72 in chips) 
Seat 6: spidy02 ($3711.11 in chips) 
JaspritBumrah786: posts small blind $10
Millie: posts big blind $25
*** HOLE CARDS ***
Dealt to Lucifer999 [Jh 6h]
devi7: raises $50.00 to $75
Lucifer999: folds
spidy02: folds
JaspritBumrah786: folds
Millie: folds
Uncalled bet ($50) returned to devi7
devi7: doesn't show hand
devi7 collected $60 from pot
*** SUMMARY ***
Total pot $60.00 | Rake $0
Board []
Seat 1: JaspritBumrah786 (small blind) folded before Flop
Seat 2: Millie (big blind) folded before Flop
Seat 4: devi7 collected ($60)
Seat 5: Lucifer999 folded before Flop (didn't bet)
Seat 6: spidy02 (button) folded before Flop (didn't bet)



PokerStars Game #00327547474: Hold'em No Limit ($25/$50 USD) - 2022/04/30 11:35:00 ET
Table 'Hold'em (Min 1K Max 5K)   216' 6-max Seat #2 is the button
Seat 1: Lucifer999 ($13239.72 in chips) 
Seat 2: rahulh1 ($2141.58 in chips) 
Seat 3: rA-j891 ($5000 in chips) 
Seat 4: No username ($4275.22 in chips) 
Seat 5: RaghSaiAyy ($4675 in chips) 
Seat 6: akshark108 ($1612.46 in chips) 
No username: posts small blind $25
RaghSaiAyy: posts big blind $50
*** HOLE CARDS ***
Dealt to Lucifer999 [Jh 7c]
akshark108: folds
Lucifer999: folds
rahulh1: folds
No username: folds
Uncalled bet ($25) returned to RaghSaiAyy
RaghSaiAyy: doesn't show hand
RaghSaiAyy collected $50 from pot
*** SUMMARY ***
Total pot $50.00 | Rake $0
Board []
Seat 1: Lucifer999 folded before Flop (didn't bet)
Seat 2: rahulh1 (button) folded before Flop (didn't bet)
Seat 4: No username (small blind) folded before Flop
Seat 5: RaghSaiAyy (big blind) collected ($50)
Seat 6: akshark108 folded before Flop (didn't bet)



PokerStars Game #00327547484: Hold'em No Limit ($10/$25 USD) - 2022/04/30 11:35:02 ET
Table 'Hold'em (Min 500Max 2500)  1282' 6-max Seat #5 is the button
Seat 1: movetome ($3014.85 in chips) 
Seat 3: Mastkalandar ($2601.92 in chips) 
Seat 5: Lucifer999 ($10221.67 in chips) 
Seat 6: devi7 ($5004.57 in chips) 
devi7: posts small blind $10
movetome: posts big blind $25
*** HOLE CARDS ***
Dealt to Lucifer999 [2d 9s]
Mastkalandar: folds
Lucifer999: folds
devi7: raises $55.00 to $80
movetome: folds
Uncalled bet ($55) returned to devi7
devi7: doesn't show hand
devi7 collected $50 from pot
*** SUMMARY ***
Total pot $50.00 | Rake $0
Board []
Seat 1: movetome (big blind) folded before Flop
Seat 3: Mastkalandar folded before Flop (didn't bet)
Seat 5: Lucifer999 (button) folded before Flop (didn't bet)
Seat 6: devi7 (small blind) collected ($50)



PokerStars Game #00327547447: Hold'em No Limit ($50/$100 USD) - 2022/04/30 11:34:50 ET
Table 'Hold'em (Min 25KMax 10K)    69' 6-max Seat #3 is the button
Seat 1: Lucifer999 ($20371.11 in chips) 
Seat 2: theplaya1 ($2974.53 in chips) 
Seat 3: Mpr@59  ($12032.66 in chips) 
Seat 4: Nucking Futs ($10090.43 in chips) 
Seat 5: tabby20 ($33558.94 in chips) 
Seat 6: manny007 ($1065.6 in chips) 
Nucking Futs: posts small blind $50
tabby20: posts big blind $100
*** HOLE CARDS ***
Dealt to Lucifer999 [3c 9h]
manny007: folds
Lucifer999: folds
theplaya1: folds
Mpr@59 : folds
Nucking Futs: calls $50
tabby20: checks
*** FLOP *** [Jc 5d Js]
Nucking Futs: checks
tabby20: checks
*** TURN *** [Jc 5d Js] [5s]
Nucking Futs: checks
tabby20: checks
*** RIVER *** [Jc 5d Js 5s] [Td]
Nucking Futs: checks
tabby20: checks
*** SHOW DOWN ***
Nucking Futs: shows [9d Qh] (Two pairs, JJ55)
tabby20: doesn't show hand
Nucking Futs collected $191.2 from pot
*** SUMMARY ***
Total pot $200.00 | Rake $8.8
Board [Jc 5d Js 5s Td]
Seat 1: Lucifer999 folded before Flop (didn't bet)
Seat 2: theplaya1 folded before Flop (didn't bet)
Seat 3: Mpr@59  (button) folded before Flop (didn't bet)
Seat 4: Nucking Futs  (small blind) showed [9d Qh] and won ($191.2) with Two pairs, JJ55
Seat 5: tabby20 (big blind) mucked
Seat 6: manny007 folded before Flop (didn't bet)



PokerStars Game #00327547539: Hold'em No Limit ($10/$25 USD) - 2022/04/30 11:35:20 ET
Table 'Hold'em (Min 500Max 2500) 1001' 6-max Seat #1 is the button
Seat 1: JaspritBumrah786 ($2497.84 in chips) 
Seat 2: Millie ($2510 in chips) 
Seat 4: devi7 ($3321.86 in chips) 
Seat 5: Lucifer999 ($4217.72 in chips) 
Seat 6: spidy02 ($3711.11 in chips) 
Millie: posts small blind $10
devi7: posts big blind $25
*** HOLE CARDS ***
Dealt to Lucifer999 [Ks 2d]
Lucifer999: folds
spidy02: raises $60.00 to $85
JaspritBumrah786: folds
Millie: folds
devi7: folds
Uncalled bet ($60) returned to spidy02
spidy02: doesn't show hand
spidy02 collected $60 from pot
*** SUMMARY ***
Total pot $60.00 | Rake $0
Board []
Seat 1: JaspritBumrah786 (button) folded before Flop (didn't bet)
Seat 2: Millie (small blind) folded before Flop
Seat 4: devi7 (big blind) folded before Flop
Seat 5: Lucifer999 folded before Flop (didn't bet)
Seat 6: spidy02 collected ($60)



PokerStars Game #00327547576: Hold'em No Limit ($10/$25 USD) - 2022/04/30 11:35:30 ET
Table 'Hold'em (Min 500Max 2500)  1282' 6-max Seat #6 is the button
Seat 1: movetome ($2989.85 in chips) 
Seat 3: Mastkalandar ($2601.92 in chips) 
Seat 5: Lucifer999 ($10221.67 in chips) 
Seat 6: devi7 ($5029.57 in chips) 
movetome: posts small blind $10
Mastkalandar: posts big blind $25
*** HOLE CARDS ***
Dealt to Lucifer999 [7c 3h]
Lucifer999: folds
devi7: folds
movetome: folds
Uncalled bet ($15) returned to Mastkalandar
Mastkalandar: doesn't show hand
Mastkalandar collected $20 from pot
*** SUMMARY ***
Total pot $20.00 | Rake $0
Board []
Seat 1: movetome (small blind) folded before Flop
Seat 3: Mastkalandar (big blind) collected ($20)
Seat 5: Lucifer999 folded before Flop (didn't bet)
Seat 6: devi7 (button) folded before Flop (didn't bet)



PokerStars Game #00327547543: Hold'em No Limit ($25/$50 USD) - 2022/04/30 11:35:21 ET
Table 'Hold'em (Min 1K Max 5K)   216' 6-max Seat #4 is the button
Seat 1: Lucifer999 ($13239.72 in chips) 
Seat 2: rahulh1 ($2141.58 in chips) 
Seat 3: rA-j891 ($5000 in chips) 
Seat 4: No username ($4250.22 in chips) 
Seat 5: RaghSaiAyy ($4700 in chips) 
Seat 6: akshark108 ($1612.46 in chips) 
RaghSaiAyy: posts small blind $25
akshark108: posts big blind $50
*** HOLE CARDS ***
Dealt to Lucifer999 [5d Qd]
Lucifer999: folds
rahulh1: raises $125.00 to $175
No username: folds
RaghSaiAyy: folds
akshark108: folds
Uncalled bet ($125) returned to rahulh1
rahulh1: doesn't show hand
rahulh1 collected $125 from pot
*** SUMMARY ***
Total pot $125.00 | Rake $0
Board []
Seat 1: Lucifer999 folded before Flop (didn't bet)
Seat 2: rahulh1 collected ($125)
Seat 4: No username (button) folded before Flop (didn't bet)
Seat 5: RaghSaiAyy (small blind) folded before Flop
Seat 6: akshark108 (big blind) folded before Flop



PokerStars Game #00327547642: Hold'em No Limit ($10/$25 USD) - 2022/04/30 11:35:53 ET
Table 'Hold'em (Min 500Max 2500)  1282' 6-max Seat #1 is the button
Seat 1: movetome ($2979.85 in chips) 
Seat 3: Mastkalandar ($2611.92 in chips) 
Seat 5: Lucifer999 ($10221.67 in chips) 
Seat 6: devi7 ($5029.57 in chips) 
Mastkalandar: posts small blind $10
Lucifer999: posts big blind $25
*** HOLE CARDS ***
Dealt to Lucifer999 [Jc 6s]
devi7: folds
movetome: folds
Mastkalandar: folds
Uncalled bet ($15) returned to Lucifer999
Lucifer999: doesn't show hand
Lucifer999 collected $20 from pot
*** SUMMARY ***
Total pot $20.00 | Rake $0
Board []
Seat 1: movetome (button) folded before Flop (didn't bet)
Seat 3: Mastkalandar (small blind) folded before Flop
Seat 5: Lucifer999 (big blind) collected ($20)
Seat 6: devi7 folded before Flop (didn't bet)



PokerStars Game #00327547686: Hold'em No Limit ($10/$25 USD) - 2022/04/30 11:36:06 ET
Table 'Hold'em (Min 500Max 2500)  1282' 6-max Seat #3 is the button
Seat 1: movetome ($2979.85 in chips) 
Seat 3: Mastkalandar ($2601.92 in chips) 
Seat 5: Lucifer999 ($10231.67 in chips) 
Seat 6: devi7 ($5029.57 in chips) 
Lucifer999: posts small blind $10
devi7: posts big blind $25
*** HOLE CARDS ***
Dealt to Lucifer999 [7c 2s]
movetome: folds
Mastkalandar: raises $50.00 to $75
Lucifer999: folds
devi7: folds
Uncalled bet ($50) returned to Mastkalandar
Mastkalandar: doesn't show hand
Mastkalandar collected $60 from pot
*** SUMMARY ***
Total pot $60.00 | Rake $0
Board []
Seat 1: movetome folded before Flop (didn't bet)
Seat 3: Mastkalandar (button) collected ($60)
Seat 5: Lucifer999 (small blind) folded before Flop
Seat 6: devi7 (big blind) folded before Flop



PokerStars Game #00327547595: Hold'em No Limit ($50/$100 USD) - 2022/04/30 11:35:37 ET
Table 'Hold'em (Min 25KMax 10K)    69' 6-max Seat #4 is the button
Seat 1: Lucifer999 ($20371.11 in chips) 
Seat 2: theplaya1 ($2974.53 in chips) 
Seat 3: Mpr@59  ($12032.66 in chips) 
Seat 4: Nucking Futs ($10181.63 in chips) 
Seat 5: tabby20 ($33458.94 in chips) 
Seat 6: manny007 ($1065.6 in chips) 
tabby20: posts small blind $50
manny007: posts big blind $100
*** HOLE CARDS ***
Dealt to Lucifer999 [9d 6h]
Lucifer999: folds
theplaya1: calls $100
Mpr@59 : calls $100
Nucking Futs: folds
tabby20: folds
manny007: checks
*** FLOP *** [As 2d 9s]
manny007: checks
theplaya1: checks
Mpr@59 : checks
*** TURN *** [As 2d 9s] [8c]
manny007: checks
theplaya1: checks
Mpr@59 : checks
*** RIVER *** [As 2d 9s 8c] [Jh]
manny007: checks
theplaya1: checks
Mpr@59 : checks
*** SHOW DOWN ***
manny007: shows [5c 6s] (High card, A)
theplaya1: shows [Qh 5d] (High card, A)
Mpr@59 : shows [Kd Th] (High card, A)
Mpr@59  collected $334.6 from pot
*** SUMMARY ***
Total pot $350.00 | Rake $15.4
Board [As 2d 9s 8c Jh]
Seat 1: Lucifer999 folded before Flop (didn't bet)
Seat 2: theplaya1 showed [Qh 5d] and lost with High card, A
Seat 3: Mpr@59   showed [Kd Th] and won ($334.6) with High card, A
Seat 4: Nucking Futs (button) folded before Flop (didn't bet)
Seat 5: tabby20 (small blind) folded before Flop
Seat 6: manny007 (big blind) showed [5c 6s] and lost with High card, A



PokerStars Game #00327547631: Hold'em No Limit ($10/$25 USD) - 2022/04/30 11:35:49 ET
Table 'Hold'em (Min 500Max 2500) 1001' 6-max Seat #2 is the button
Seat 1: JaspritBumrah786 ($2497.84 in chips) 
Seat 2: Millie ($2500 in chips) 
Seat 4: devi7 ($3296.86 in chips) 
Seat 5: Lucifer999 ($4217.72 in chips) 
Seat 6: spidy02 ($3746.11 in chips) 
devi7: posts small blind $10
Lucifer999: posts big blind $25
*** HOLE CARDS ***
Dealt to Lucifer999 [Kd 2s]
spidy02: calls $25
JaspritBumrah786: calls $25
Millie: folds
devi7: raises $110.00 to $135
Lucifer999: folds
spidy02: folds
JaspritBumrah786: calls $110
*** FLOP *** [2c 3h 3c]
devi7: checks
JaspritBumrah786: checks
*** TURN *** [2c 3h 3c] [Kh]
devi7: bets $150.1
JaspritBumrah786: calls $150.1
*** RIVER *** [2c 3h 3c Kh] [Jd]
devi7: checks
JaspritBumrah786: checks
*** SHOW DOWN ***
devi7: shows [Ac 7c] (Pair, 33)
JaspritBumrah786: shows [Kc Tc] (Two pairs, KK33)
JaspritBumrah786 collected $582.65 from pot
*** SUMMARY ***
Total pot $620.20 | Rake $37.55
Board [2c 3h 3c Kh Jd]
Seat 1: JaspritBumrah786  showed [Kc Tc] and won ($582.65) with Two pairs, KK33
Seat 2: Millie (button) folded before Flop (didn't bet)
Seat 4: devi7 (small blind) showed [Ac 7c] and lost with Pair, 33
Seat 5: Lucifer999 (big blind) folded before Flop
Seat 6: spidy02 folded before Flop



PokerStars Game #00327547763: Hold'em No Limit ($10/$25 USD) - 2022/04/30 11:36:32 ET
Table 'Hold'em (Min 500Max 2500)  1282' 6-max Seat #5 is the button
Seat 1: movetome ($2979.85 in chips) 
Seat 3: Mastkalandar ($2636.92 in chips) 
Seat 5: Lucifer999 ($10221.67 in chips) 
Seat 6: devi7 ($5004.57 in chips) 
devi7: posts small blind $10
movetome: posts big blind $25
*** HOLE CARDS ***
Dealt to Lucifer999 [7h 7d]
Mastkalandar: folds
Lucifer999: folds
devi7: folds
Uncalled bet ($15) returned to movetome
movetome: doesn't show hand
movetome collected $20 from pot
*** SUMMARY ***
Total pot $20.00 | Rake $0
Board []
Seat 1: movetome (big blind) collected ($20)
Seat 3: Mastkalandar folded before Flop (didn't bet)
Seat 5: Lucifer999 (button) folded before Flop (didn't bet)
Seat 6: devi7 (small blind) folded before Flop



PokerStars Game #00327547678: Hold'em No Limit ($25/$50 USD) - 2022/04/30 11:36:04 ET
Table 'Hold'em (Min 1K Max 5K)   216' 6-max Seat #5 is the button
Seat 1: Lucifer999 ($13239.72 in chips) 
Seat 2: rahulh1 ($2216.58 in chips) 
Seat 3: rA-j891 ($5000 in chips) 
Seat 4: No username ($4250.22 in chips) 
Seat 5: RaghSaiAyy ($4675 in chips) 
Seat 6: akshark108 ($1562.46 in chips) 
akshark108: posts small blind $25
Lucifer999: posts big blind $50
*** HOLE CARDS ***
Dealt to Lucifer999 [Jh Ah]
rahulh1: folds
No username: folds
RaghSaiAyy: folds
akshark108: calls $25
Lucifer999: raises $125.00 to $175
akshark108: calls $125
*** FLOP *** [Ts Qs As]
akshark108: checks
Lucifer999: checks
*** TURN *** [Ts Qs As] [5c]
akshark108: checks
Lucifer999: bets $150
akshark108: calls $150
*** RIVER *** [Ts Qs As 5c] [9c]
akshark108: checks
Lucifer999: bets $325
akshark108: folds
Uncalled bet ($325) returned to Lucifer999
Lucifer999: doesn't show hand
Lucifer999 collected $617.5 from pot
*** SUMMARY ***
Total pot $650.00 | Rake $32.5
Board [Ts Qs As 5c 9c]
Seat 1: Lucifer999 (big blind) collected ($617.5)
Seat 2: rahulh1 folded before Flop (didn't bet)
Seat 4: No username folded before Flop (didn't bet)
Seat 5: RaghSaiAyy (button) folded before Flop (didn't bet)
Seat 6: akshark108 (small blind) folded on the River



PokerStars Game #00327547808: Hold'em No Limit ($10/$25 USD) - 2022/04/30 11:36:48 ET
Table 'Hold'em (Min 500Max 2500) 1001' 6-max Seat #4 is the button
Seat 1: JaspritBumrah786 ($2795.39 in chips) 
Seat 2: Millie ($2500 in chips) 
Seat 4: devi7 ($3011.76 in chips) 
Seat 5: Lucifer999 ($4192.72 in chips) 
Seat 6: spidy02 ($3721.11 in chips) 
Lucifer999: posts small blind $10
spidy02: posts big blind $25
*** HOLE CARDS ***
Dealt to Lucifer999 [4d Jh]
JaspritBumrah786: folds
Millie: folds
devi7: folds
Lucifer999: folds
Uncalled bet ($15) returned to spidy02
spidy02: doesn't show hand
spidy02 collected $20 from pot
*** SUMMARY ***
Total pot $20.00 | Rake $0
Board []
Seat 1: JaspritBumrah786 folded before Flop (didn't bet)
Seat 2: Millie folded before Flop (didn't bet)
Seat 4: devi7 (button) folded before Flop (didn't bet)
Seat 5: Lucifer999 (small blind) folded before Flop
Seat 6: spidy02 (big blind) collected ($20)



PokerStars Game #00327547803: Hold'em No Limit ($50/$100 USD) - 2022/04/30 11:36:46 ET
Table 'Hold'em (Min 25KMax 10K)    69' 6-max Seat #5 is the button
Seat 1: Lucifer999 ($20371.11 in chips) 
Seat 2: theplaya1 ($2874.53 in chips) 
Seat 3: Mpr@59  ($12267.26 in chips) 
Seat 4: Nucking Futs ($10181.63 in chips) 
Seat 5: tabby20 ($33408.94 in chips) 
Seat 6: manny007 ($965.6 in chips) 
manny007: posts small blind $50
Lucifer999: posts big blind $100
*** HOLE CARDS ***
Dealt to Lucifer999 [3s 7d]
theplaya1: folds
Mpr@59 : calls $100
Nucking Futs: folds
tabby20: raises $250.00 to $350
manny007: calls $300
Lucifer999: folds
Mpr@59 : folds
*** FLOP *** [Js 4d Ad]
manny007: bets $615.6
tabby20: calls $615.6
*** TURN *** [Js 4d Ad] [Ts]
*** TURN *** [Js 4d Ad] [Kd]
*** RIVER *** [Js 4d Ad Ts] [7s]
*** RIVER *** [Js 4d Ad Ts] [Td]
*** SHOW DOWN ***
tabby20: shows [6d 6h] (Flush, A high)
manny007: shows [Jd Tc] (Flush, A high)
manny007 collected $1018.72 from pot
manny007 collected $1018.72 from pot
*** SUMMARY ***
Total pot $2131.20 | Rake $93.76
Board [Js 4d Ad Ts 7s]
Seat 1: Lucifer999 (big blind) folded before Flop
Seat 2: theplaya1 folded before Flop (didn't bet)
Seat 3: Mpr@59  folded before Flop
Seat 4: Nucking Futs folded before Flop (didn't bet)
Seat 5: tabby20 (button) showed [6d 6h] and lost with Flush, A high
Seat 6: manny007  (small blind) showed [Jd Tc] and won ($1018.72) with Flush, A high



PokerStars Game #00327547872: Hold'em No Limit ($25/$50 USD) - 2022/04/30 11:37:06 ET
Table 'Hold'em (Min 1K Max 5K)   216' 6-max Seat #6 is the button
Seat 1: Lucifer999 ($13532.22 in chips) 
Seat 2: rahulh1 ($2216.58 in chips) 
Seat 3: rA-j891 ($5000 in chips) 
Seat 4: No username ($4250.22 in chips) 
Seat 5: RaghSaiAyy ($4675 in chips) 
Seat 6: akshark108 ($1237.46 in chips) 
Lucifer999: posts small blind $25
rahulh1: posts big blind $50
*** HOLE CARDS ***
Dealt to Lucifer999 [7s Qh]
No username: raises $125.00 to $175
RaghSaiAyy: folds
akshark108: folds
Lucifer999: folds
rahulh1: folds
Uncalled bet ($125) returned to No username
No username: doesn't show hand
No username collected $125 from pot
*** SUMMARY ***
Total pot $125.00 | Rake $0
Board []
Seat 1: Lucifer999 (small blind) folded before Flop
Seat 2: rahulh1 (big blind) folded before Flop
Seat 4: No username collected ($125)
Seat 5: RaghSaiAyy folded before Flop (didn't bet)
Seat 6: akshark108 (button) folded before Flop (didn't bet)



PokerStars Game #00327547839: Hold'em No Limit ($10/$25 USD) - 2022/04/30 11:36:57 ET
Table 'Hold'em (Min 500Max 2500)  1282' 6-max Seat #6 is the button
Seat 1: movetome ($2989.85 in chips) 
Seat 2: jas8k ($2178.68 in chips) 
Seat 3: Mastkalandar ($2636.92 in chips) 
Seat 4: fishfry123 ($1100 in chips) 
Seat 5: Lucifer999 ($10221.67 in chips) 
Seat 6: devi7 ($4994.57 in chips) 
movetome: posts small blind $10
jas8k: posts big blind $25
fishfry123: posts big blind $25
*** HOLE CARDS ***
Dealt to Lucifer999 [8d Ad]
Mastkalandar: folds
fishfry123: checks
Lucifer999: raises $65.00 to $90
devi7: folds
movetome: calls $80
jas8k: folds
fishfry123: calls $65
*** FLOP *** [7h Ac 3d]
movetome: bets $200
fishfry123: folds
Lucifer999: calls $200
*** TURN *** [7h Ac 3d] [7c]
movetome: checks
Lucifer999: checks
*** RIVER *** [7h Ac 3d 7c] [2d]
movetome: checks
Lucifer999: checks
*** SHOW DOWN ***
movetome: shows [Ts Td] (Two pairs, TT77)
Lucifer999: shows [8d Ad] (Two pairs, AA77)
Lucifer999 collected $653.52 from pot
*** SUMMARY ***
Total pot $695.00 | Rake $41.48
Board [7h Ac 3d 7c 2d]
Seat 1: movetome (small blind) showed [Ts Td] and lost with Two pairs, TT77
Seat 2: jas8k (big blind) folded before Flop
Seat 3: Mastkalandar folded before Flop (didn't bet)
Seat 4: fishfry123 folded on the Flop
Seat 5: Lucifer999  showed [8d Ad] and won ($653.52) with Two pairs, AA77
Seat 6: devi7 (button) folded before Flop (didn't bet)



PokerStars Game #00327547971: Hold'em No Limit ($25/$50 USD) - 2022/04/30 11:37:41 ET
Table 'Hold'em (Min 1K Max 5K)   216' 6-max Seat #1 is the button
Seat 1: Lucifer999 ($13507.22 in chips) 
Seat 2: rahulh1 ($2166.58 in chips) 
Seat 3: rA-j891 ($5000 in chips) 
Seat 4: No username ($4325.22 in chips) 
Seat 5: RaghSaiAyy ($4675 in chips) 
Seat 6: akshark108 ($1237.46 in chips) 
rahulh1: posts small blind $25
rA-j891: posts big blind $50
*** HOLE CARDS ***
Dealt to Lucifer999 [3c 2s]
No username: folds
RaghSaiAyy: folds
akshark108: raises $150.00 to $200
Lucifer999: folds
rahulh1: folds
rA-j891: folds
Uncalled bet ($150) returned to akshark108
akshark108: doesn't show hand
akshark108 collected $125 from pot
*** SUMMARY ***
Total pot $125.00 | Rake $0
Board []
Seat 1: Lucifer999 (button) folded before Flop (didn't bet)
Seat 2: rahulh1 (small blind) folded before Flop
Seat 3: rA-j891 (big blind) folded before Flop
Seat 4: No username folded before Flop (didn't bet)
Seat 5: RaghSaiAyy folded before Flop (didn't bet)
Seat 6: akshark108 collected ($125)



PokerStars Game #00327547896: Hold'em No Limit ($10/$25 USD) - 2022/04/30 11:37:13 ET
Table 'Hold'em (Min 500Max 2500) 1001' 6-max Seat #5 is the button
Seat 1: JaspritBumrah786 ($2795.39 in chips) 
Seat 2: Millie ($2500 in chips) 
Seat 4: devi7 ($3011.76 in chips) 
Seat 5: Lucifer999 ($4182.72 in chips) 
Seat 6: spidy02 ($3731.11 in chips) 
spidy02: posts small blind $10
JaspritBumrah786: posts big blind $25
*** HOLE CARDS ***
Dealt to Lucifer999 [6d Kd]
Millie: folds
devi7: raises $50.00 to $75
Lucifer999: calls $75
spidy02: calls $65
JaspritBumrah786: folds
*** FLOP *** [6s 6c Js]
spidy02: checks
devi7: checks
Lucifer999: checks
*** TURN *** [6s 6c Js] [9s]
spidy02: checks
devi7: checks
Lucifer999: bets $180
spidy02: folds
devi7: folds
Uncalled bet ($180) returned to Lucifer999
Lucifer999: doesn't show hand
Lucifer999 collected $234.88 from pot
*** SUMMARY ***
Total pot $250.00 | Rake $15.12
Board [6s 6c Js 9s]
Seat 1: JaspritBumrah786 (big blind) folded before Flop
Seat 2: Millie folded before Flop (didn't bet)
Seat 4: devi7 folded on the Turn
Seat 5: Lucifer999 (button) collected ($234.88)
Seat 6: spidy02 (small blind) folded on the Turn



PokerStars Game #00327547948: Hold'em No Limit ($50/$100 USD) - 2022/04/30 11:37:33 ET
Table 'Hold'em (Min 25KMax 10K)    69' 6-max Seat #6 is the button
Seat 1: Lucifer999 ($20271.11 in chips) 
Seat 2: theplaya1 ($2874.53 in chips) 
Seat 3: Mpr@59  ($12167.26 in chips) 
Seat 4: Nucking Futs ($10181.63 in chips) 
Seat 5: tabby20 ($32443.34 in chips) 
Seat 6: manny007 ($2037.44 in chips) 
Lucifer999: posts small blind $50
theplaya1: posts big blind $100
*** HOLE CARDS ***
Dealt to Lucifer999 [9s Jc]
Mpr@59 : folds
Nucking Futs: folds
tabby20: folds
manny007: calls $100
Lucifer999: calls $50
theplaya1: checks
*** FLOP *** [3s Qd 5c]
Lucifer999: checks
theplaya1: checks
manny007: checks
*** TURN *** [3s Qd 5c] [8h]
Lucifer999: bets $200
theplaya1: folds
manny007: calls $200
*** RIVER *** [3s Qd 5c 8h] [7c]
Lucifer999: checks
manny007: checks
*** SHOW DOWN ***
Lucifer999: shows [9s Jc] (High card, Q)
manny007: shows [8s Js] (Pair, 88)
manny007 collected $669.2 from pot
*** SUMMARY ***
Total pot $700.00 | Rake $30.8
Board [3s Qd 5c 8h 7c]
Seat 1: Lucifer999 (small blind) showed [9s Jc] and lost with High card, Q
Seat 2: theplaya1 (big blind) folded on the Turn
Seat 3: Mpr@59  folded before Flop (didn't bet)
Seat 4: Nucking Futs folded before Flop (didn't bet)
Seat 5: tabby20 folded before Flop (didn't bet)
Seat 6: manny007  (button) showed [8s Js] and won ($669.2) with Pair, 88



PokerStars Game #00327548070: Hold'em No Limit ($25/$50 USD) - 2022/04/30 11:38:13 ET
Table 'Hold'em (Min 1K Max 5K)   216' 6-max Seat #2 is the button
Seat 1: Lucifer999 ($13507.22 in chips) 
Seat 2: rahulh1 ($2141.58 in chips) 
Seat 3: rA-j891 ($5000 in chips) 
Seat 4: No username ($4325.22 in chips) 
Seat 5: RaghSaiAyy ($4675 in chips) 
Seat 6: akshark108 ($1312.46 in chips) 
rA-j891: posts small blind $25
No username: posts big blind $50
*** HOLE CARDS ***
Dealt to Lucifer999 [2d 5d]
RaghSaiAyy: folds
akshark108: calls $50
Lucifer999: folds
rahulh1: folds
rA-j891: calls $25
No username: checks
*** FLOP *** [Jc 8s Ac]
rA-j891: bets $50
No username: folds
akshark108: raises $242.75 to $292.75
rA-j891: folds
Uncalled bet ($242.75) returned to akshark108
akshark108: doesn't show hand
akshark108 collected $237.5 from pot
*** SUMMARY ***
Total pot $250.00 | Rake $12.5
Board [Jc 8s Ac]
Seat 1: Lucifer999 folded before Flop (didn't bet)
Seat 2: rahulh1 (button) folded before Flop (didn't bet)
Seat 3: rA-j891 (small blind) folded on the Flop
Seat 4: No username (big blind) folded on the Flop
Seat 5: RaghSaiAyy folded before Flop (didn't bet)
Seat 6: akshark108 collected ($237.5)



PokerStars Game #00327548000: Hold'em No Limit ($10/$25 USD) - 2022/04/30 11:37:50 ET
Table 'Hold'em (Min 500Max 2500)  1282' 6-max Seat #1 is the button
Seat 1: movetome ($2699.85 in chips) 
Seat 2: jas8k ($2153.68 in chips) 
Seat 3: Mastkalandar ($2636.92 in chips) 
Seat 4: fishfry123 ($1010 in chips) 
Seat 5: Lucifer999 ($10585.19 in chips) 
Seat 6: devi7 ($4994.57 in chips) 
jas8k: posts small blind $10
Mastkalandar: posts big blind $25
*** HOLE CARDS ***
Dealt to Lucifer999 [3s 8d]
fishfry123: folds
Lucifer999: folds
devi7: folds
movetome: raises $50.00 to $75
jas8k: folds
Mastkalandar: folds
Uncalled bet ($50) returned to movetome
movetome: doesn't show hand
movetome collected $60 from pot
*** SUMMARY ***
Total pot $60.00 | Rake $0
Board []
Seat 1: movetome (button) collected ($60)
Seat 2: jas8k (small blind) folded before Flop
Seat 3: Mastkalandar (big blind) folded before Flop
Seat 4: fishfry123 folded before Flop (didn't bet)
Seat 5: Lucifer999 folded before Flop (didn't bet)
Seat 6: devi7 folded before Flop (didn't bet)



PokerStars Game #00327548118: Hold'em No Limit ($50/$100 USD) - 2022/04/30 11:38:30 ET
Table 'Hold'em (Min 25KMax 10K)    69' 6-max Seat #1 is the button
Seat 1: Lucifer999 ($19971.11 in chips) 
Seat 2: theplaya1 ($2774.53 in chips) 
Seat 3: Mpr@59  ($12167.26 in chips) 
Seat 4: Nucking Futs ($10181.63 in chips) 
Seat 5: tabby20 ($32443.34 in chips) 
Seat 6: manny007 ($2406.64 in chips) 
theplaya1: posts small blind $50
Mpr@59 : posts big blind $100
*** HOLE CARDS ***
Dealt to Lucifer999 [Ks 6d]
Nucking Futs: folds
tabby20: folds
manny007: folds
Lucifer999: folds
theplaya1: folds
Uncalled bet ($50) returned to Mpr@59 
Mpr@59 : doesn't show hand
Mpr@59  collected $100 from pot
*** SUMMARY ***
Total pot $100.00 | Rake $0
Board []
Seat 1: Lucifer999 (button) folded before Flop (didn't bet)
Seat 2: theplaya1 (small blind) folded before Flop
Seat 3: Mpr@59  (big blind) collected ($100)
Seat 4: Nucking Futs folded before Flop (didn't bet)
Seat 5: tabby20 folded before Flop (didn't bet)
Seat 6: manny007 folded before Flop (didn't bet)



PokerStars Game #00327548090: Hold'em No Limit ($10/$25 USD) - 2022/04/30 11:38:19 ET
Table 'Hold'em (Min 500Max 2500) 1001' 6-max Seat #6 is the button
Seat 1: JaspritBumrah786 ($2770.39 in chips) 
Seat 2: Millie ($2500 in chips) 
Seat 4: devi7 ($2936.76 in chips) 
Seat 5: Lucifer999 ($4342.6 in chips) 
Seat 6: spidy02 ($3656.11 in chips) 
JaspritBumrah786: posts small blind $10
Millie: posts big blind $25
*** HOLE CARDS ***
Dealt to Lucifer999 [Td As]
devi7: folds
Lucifer999: raises $55.00 to $80
spidy02: folds
JaspritBumrah786: calls $70
Millie: folds
*** FLOP *** [Qd 6h 5h]
JaspritBumrah786: checks
Lucifer999: checks
*** TURN *** [Qd 6h 5h] [5c]
JaspritBumrah786: checks
Lucifer999: checks
*** RIVER *** [Qd 6h 5h 5c] [Th]
JaspritBumrah786: bets $125
Lucifer999: calls $125
*** SHOW DOWN ***
JaspritBumrah786: shows [9s Qs] (Two pairs, QQ55)
Lucifer999: doesn't show hand
JaspritBumrah786 collected $408.17 from pot
*** SUMMARY ***
Total pot $435.00 | Rake $26.83
Board [Qd 6h 5h 5c Th]
Seat 1: JaspritBumrah786  (small blind) showed [9s Qs] and won ($408.17) with Two pairs, QQ55
Seat 2: Millie (big blind) folded before Flop
Seat 4: devi7 folded before Flop (didn't bet)
Seat 5: Lucifer999 mucked
Seat 6: spidy02 (button) folded before Flop (didn't bet)



PokerStars Game #00327548214: Hold'em No Limit ($50/$100 USD) - 2022/04/30 11:38:54 ET
Table 'Hold'em (Min 25KMax 10K)    69' 6-max Seat #2 is the button
Seat 1: Lucifer999 ($19971.11 in chips) 
Seat 2: theplaya1 ($2724.53 in chips) 
Seat 3: Mpr@59  ($12217.26 in chips) 
Seat 4: Nucking Futs ($10181.63 in chips) 
Seat 5: tabby20 ($32443.34 in chips) 
Seat 6: manny007 ($2406.64 in chips) 
Mpr@59 : posts small blind $50
Nucking Futs: posts big blind $100
*** HOLE CARDS ***
Dealt to Lucifer999 [Jc 5c]
tabby20: folds
manny007: calls $100
Lucifer999: folds
theplaya1: raises $350.00 to $450
Mpr@59 : folds
Nucking Futs: folds
manny007: calls $350
*** FLOP *** [4d 3h 4h]
manny007: checks
theplaya1: bets $662.51
manny007: raises $1294.13 to $1956.64
theplaya1: raises $317.89 to $2274.53
Uncalled bet ($317.89) returned to theplaya1
*** TURN *** [4d 3h 4h] [7c]
*** TURN *** [4d 3h 4h] [9h]
*** RIVER *** [4d 3h 4h 7c] [Qh]
*** RIVER *** [4d 3h 4h 7c] [As]
*** SHOW DOWN ***
theplaya1: shows [6d Ad] (Two pairs, AA44)
manny007: shows [Ah Kh] (Flush, A high)
manny007 collected $2372.46 from pot
manny007 collected $2372.45 from pot
*** SUMMARY ***
Total pot $4963.28 | Rake $218.37
Board [4d 3h 4h 7c Qh]
Seat 1: Lucifer999 folded before Flop (didn't bet)
Seat 2: theplaya1 (button) showed [6d Ad] and lost with Two pairs, AA44
Seat 3: Mpr@59  (small blind) folded before Flop
Seat 4: Nucking Futs (big blind) folded before Flop
Seat 5: tabby20 folded before Flop (didn't bet)
Seat 6: manny007  showed [Ah Kh] and won ($2372.45) with Flush, A high



PokerStars Game #00327548151: Hold'em No Limit ($25/$50 USD) - 2022/04/30 11:38:40 ET
Table 'Hold'em (Min 1K Max 5K)   216' 6-max Seat #3 is the button
Seat 1: Lucifer999 ($13507.22 in chips) 
Seat 2: rahulh1 ($2141.58 in chips) 
Seat 3: rA-j891 ($5000 in chips) 
Seat 4: No username ($4275.22 in chips) 
Seat 5: RaghSaiAyy ($4675 in chips) 
Seat 6: akshark108 ($1449.96 in chips) 
No username: posts small blind $25
RaghSaiAyy: posts big blind $50
*** HOLE CARDS ***
Dealt to Lucifer999 [5h 4h]
akshark108: folds
Lucifer999: folds
rahulh1: calls $50
rA-j891: folds
No username: calls $25
RaghSaiAyy: raises $225.00 to $275
rahulh1: folds
No username: calls $225
*** FLOP *** [7c 7h Tc]
No username: checks
RaghSaiAyy: bets $570
No username: raises $3430.22 to $4000.22
RaghSaiAyy: calls $3430.22
*** TURN *** [7c 7h Tc] [Td]
*** TURN *** [7c 7h Tc] [8h]
*** RIVER *** [7c 7h Tc Td] [Jc]
*** RIVER *** [7c 7h Tc Td] [Qh]
*** SHOW DOWN ***
No username: shows [9c Kc] (Pair, 77)
RaghSaiAyy: shows [Ts Ah] (Two pairs, TT77)
RaghSaiAyy collected $4155.72 from pot
RaghSaiAyy collected $4155.72 from pot
*** SUMMARY ***
Total pot $8600.44 | Rake $289
Board [7c 7h Tc Td Jc]
Seat 1: Lucifer999 folded before Flop (didn't bet)
Seat 2: rahulh1 folded before Flop
Seat 3: rA-j891 (button) folded before Flop (didn't bet)
Seat 4: No username (small blind) showed [9c Kc] and lost with Pair, 77
Seat 5: RaghSaiAyy  (big blind) showed [Ts Ah] and won ($4155.72) with Two pairs, TT77
Seat 6: akshark108 folded before Flop (didn't bet)



PokerStars Game #00327548191: Hold'em No Limit ($10/$25 USD) - 2022/04/30 11:38:49 ET
Table 'Hold'em (Min 500Max 2500)  1282' 6-max Seat #2 is the button
Seat 1: movetome ($2734.85 in chips) 
Seat 2: jas8k ($2143.68 in chips) 
Seat 3: Mastkalandar ($2611.92 in chips) 
Seat 4: fishfry123 ($1010 in chips) 
Seat 5: Lucifer999 ($10585.19 in chips) 
Seat 6: devi7 ($4994.57 in chips) 
Mastkalandar: posts small blind $10
fishfry123: posts big blind $25
*** HOLE CARDS ***
Dealt to Lucifer999 [Qd Ac]
Lucifer999: folds
devi7: folds
movetome: folds
jas8k: raises $25.00 to $50
Mastkalandar: folds
fishfry123: calls $25
*** FLOP *** [6h Th 8s]
fishfry123: checks
jas8k: checks
*** TURN *** [6h Th 8s] [2c]
fishfry123: bets $77.42
jas8k: folds
Uncalled bet ($77.42) returned to fishfry123
fishfry123: doesn't show hand
fishfry123 collected $103.23 from pot
*** SUMMARY ***
Total pot $110.00 | Rake $6.77
Board [6h Th 8s 2c]
Seat 1: movetome folded before Flop (didn't bet)
Seat 2: jas8k (button) folded on the Turn
Seat 3: Mastkalandar (small blind) folded before Flop
Seat 4: fishfry123 (big blind) collected ($103.23)
Seat 5: Lucifer999 folded before Flop (didn't bet)
Seat 6: devi7 folded before Flop (didn't bet)



PokerStars Game #00327548270: Hold'em No Limit ($10/$25 USD) - 2022/04/30 11:39:13 ET
Table 'Hold'em (Min 500Max 2500) 1001' 6-max Seat #1 is the button
Seat 1: JaspritBumrah786 ($2973.56 in chips) 
Seat 2: Millie ($2500 in chips) 
Seat 4: devi7 ($2936.76 in chips) 
Seat 5: Lucifer999 ($4137.6 in chips) 
Seat 6: spidy02 ($3656.11 in chips) 
Millie: posts small blind $10
devi7: posts big blind $25
*** HOLE CARDS ***
Dealt to Lucifer999 [4c 8d]
Lucifer999: folds
spidy02: folds
JaspritBumrah786: raises $50.00 to $75
Millie: folds
devi7: calls $50
*** FLOP *** [5c Kc Jh]
devi7: bets $125
JaspritBumrah786: raises $275.00 to $400
devi7: calls $275
*** TURN *** [5c Kc Jh] [Jd]
devi7: checks
JaspritBumrah786: bets $725
devi7: folds
Uncalled bet ($725) returned to JaspritBumrah786
JaspritBumrah786: doesn't show hand
JaspritBumrah786 collected $904.6 from pot
*** SUMMARY ***
Total pot $960.00 | Rake $55.4
Board [5c Kc Jh Jd]
Seat 1: JaspritBumrah786 (button) collected ($904.6)
Seat 2: Millie (small blind) folded before Flop
Seat 4: devi7 (big blind) folded on the Turn
Seat 5: Lucifer999 folded before Flop (didn't bet)
Seat 6: spidy02 folded before Flop (didn't bet)



PokerStars Game #00327548355: Hold'em No Limit ($50/$100 USD) - 2022/04/30 11:39:39 ET
Table 'Hold'em (Min 25KMax 10K)    69' 6-max Seat #3 is the button
Seat 1: Lucifer999 ($19971.11 in chips) 
Seat 2: vinuth ($10000 in chips) 
Seat 3: Mpr@59  ($12167.26 in chips) 
Seat 4: Nucking Futs ($10081.63 in chips) 
Seat 5: tabby20 ($32443.34 in chips) 
Seat 6: manny007 ($4744.91 in chips) 
Nucking Futs: posts small blind $50
tabby20: posts big blind $100
*** HOLE CARDS ***
Dealt to Lucifer999 [3h Ah]
manny007: calls $100
Lucifer999: calls $100
Mpr@59 : calls $100
Nucking Futs: calls $50
tabby20: checks
*** FLOP *** [3c 2h 4h]
Nucking Futs: checks
tabby20: bets $400
manny007: folds
Lucifer999: raises $500.00 to $900
Mpr@59 : folds
Nucking Futs: folds
tabby20: folds
Uncalled bet ($500) returned to Lucifer999
Lucifer999: doesn't show hand
Lucifer999 collected $1242.8 from pot
*** SUMMARY ***
Total pot $1300.00 | Rake $57.2
Board [3c 2h 4h]
Seat 1: Lucifer999 collected ($1242.8)
Seat 3: Mpr@59  (button) folded on the Flop
Seat 4: Nucking Futs (small blind) folded on the Flop
Seat 5: tabby20 (big blind) folded on the Flop
Seat 6: manny007 folded on the Flop



PokerStars Game #00327548431: Hold'em No Limit ($10/$25 USD) - 2022/04/30 11:40:03 ET
Table 'Hold'em (Min 500Max 2500) 1001' 6-max Seat #4 is the button
Seat 1: JaspritBumrah786 ($3403.16 in chips) 
Seat 2: Millie ($2500 in chips) 
Seat 4: devi7 ($2461.76 in chips) 
Seat 5: Lucifer999 ($4137.6 in chips) 
Seat 6: spidy02 ($3656.11 in chips) 
Lucifer999: posts small blind $10
spidy02: posts big blind $25
*** HOLE CARDS ***
Dealt to Lucifer999 [4d 5h]
JaspritBumrah786: raises $50.00 to $75
devi7: folds
Lucifer999: folds
spidy02: folds
Uncalled bet ($50) returned to JaspritBumrah786
JaspritBumrah786: doesn't show hand
JaspritBumrah786 collected $60 from pot
*** SUMMARY ***
Total pot $60.00 | Rake $0
Board []
Seat 1: JaspritBumrah786 collected ($60)
Seat 4: devi7 (button) folded before Flop (didn't bet)
Seat 5: Lucifer999 (small blind) folded before Flop
Seat 6: spidy02 (big blind) folded before Flop



PokerStars Game #00327548393: Hold'em No Limit ($10/$25 USD) - 2022/04/30 11:39:53 ET
Table 'Hold'em (Min 500Max 2500)  1282' 6-max Seat #3 is the button
Seat 1: movetome ($2734.85 in chips) 
Seat 2: jas8k ($2093.68 in chips) 
Seat 3: Mastkalandar ($2601.92 in chips) 
Seat 4: fishfry123 ($1063.23 in chips) 
Seat 5: Lucifer999 ($10585.19 in chips) 
Seat 6: devi7 ($4994.57 in chips) 
fishfry123: posts small blind $10
Lucifer999: posts big blind $25
*** HOLE CARDS ***
Dealt to Lucifer999 [2d Ks]
devi7: folds
movetome: folds
jas8k: folds
Mastkalandar: folds
fishfry123: calls $15
Lucifer999: raises $65.00 to $90
fishfry123: calls $65
*** FLOP *** [Th 6d 3h]
fishfry123: checks
Lucifer999: checks
*** TURN *** [Th 6d 3h] [5s]
fishfry123: checks
Lucifer999: bets $110
fishfry123: folds
Uncalled bet ($110) returned to Lucifer999
Lucifer999: doesn't show hand
Lucifer999 collected $169.55 from pot
*** SUMMARY ***
Total pot $180.00 | Rake $10.45
Board [Th 6d 3h 5s]
Seat 1: movetome folded before Flop (didn't bet)
Seat 2: jas8k folded before Flop (didn't bet)
Seat 3: Mastkalandar (button) folded before Flop (didn't bet)
Seat 4: fishfry123 (small blind) folded on the Turn
Seat 5: Lucifer999 (big blind) collected ($169.55)
Seat 6: devi7 folded before Flop (didn't bet)



PokerStars Game #00327548511: Hold'em No Limit ($10/$25 USD) - 2022/04/30 11:40:29 ET
Table 'Hold'em (Min 500Max 2500) 1001' 6-max Seat #5 is the button
Seat 1: JaspritBumrah786 ($3438.16 in chips) 
Seat 2: Millie ($2500 in chips) 
Seat 4: devi7 ($2461.76 in chips) 
Seat 5: Lucifer999 ($4127.6 in chips) 
Seat 6: spidy02 ($3631.11 in chips) 
spidy02: posts small blind $10
JaspritBumrah786: posts big blind $25
*** HOLE CARDS ***
Dealt to Lucifer999 [9c Qh]
devi7: folds
Lucifer999: raises $55.00 to $80
spidy02: calls $70
JaspritBumrah786: raises $245.00 to $325
Lucifer999: folds
spidy02: folds
Uncalled bet ($245) returned to JaspritBumrah786
JaspritBumrah786: doesn't show hand
JaspritBumrah786 collected $240 from pot
*** SUMMARY ***
Total pot $240.00 | Rake $0
Board []
Seat 1: JaspritBumrah786 (big blind) collected ($240)
Seat 4: devi7 folded before Flop (didn't bet)
Seat 5: Lucifer999 (button) folded before Flop
Seat 6: spidy02 (small blind) folded before Flop



PokerStars Game #00327548375: Hold'em No Limit ($25/$50 USD) - 2022/04/30 11:39:46 ET
Table 'Hold'em (Min 1K Max 5K)   216' 6-max Seat #5 is the button
Seat 1: Lucifer999 ($13507.22 in chips) 
Seat 2: rahulh1 ($2091.58 in chips) 
Seat 3: rA-j891 ($5000 in chips) 
Seat 5: RaghSaiAyy ($8711.22 in chips) 
Seat 6: akshark108 ($1449.96 in chips) 
akshark108: posts small blind $25
Lucifer999: posts big blind $50
*** HOLE CARDS ***
Dealt to Lucifer999 [Qc 8d]
rahulh1: folds
rA-j891: folds
RaghSaiAyy: folds
akshark108: calls $25
Lucifer999: raises $125.00 to $175
akshark108: calls $125
*** FLOP *** [Qd Jd 6s]
akshark108: checks
Lucifer999: checks
*** TURN *** [Qd Jd 6s] [7s]
akshark108: checks
Lucifer999: bets $250
akshark108: calls $250
*** RIVER *** [Qd Jd 6s 7s] [6c]
akshark108: checks
Lucifer999: bets $425
akshark108: folds
Uncalled bet ($425) returned to Lucifer999
Lucifer999: doesn't show hand
Lucifer999 collected $807.5 from pot
*** SUMMARY ***
Total pot $850.00 | Rake $42.5
Board [Qd Jd 6s 7s 6c]
Seat 1: Lucifer999 (big blind) collected ($807.5)
Seat 2: rahulh1 folded before Flop (didn't bet)
Seat 3: rA-j891 folded before Flop (didn't bet)
Seat 5: RaghSaiAyy (button) folded before Flop (didn't bet)
Seat 6: akshark108 (small blind) folded on the River



PokerStars Game #00327548619: Hold'em No Limit ($25/$50 USD) - 2022/04/30 11:41:00 ET
Table 'Hold'em (Min 1K Max 5K)   216' 6-max Seat #6 is the button
Seat 1: Lucifer999 ($13889.72 in chips) 
Seat 2: rahulh1 ($2091.58 in chips) 
Seat 3: rA-j891 ($5000 in chips) 
Seat 5: RaghSaiAyy ($8711.22 in chips) 
Seat 6: akshark108 ($1024.96 in chips) 
Lucifer999: posts small blind $25
rahulh1: posts big blind $50
*** HOLE CARDS ***
Dealt to Lucifer999 [3h 7h]
akshark108: folds
Lucifer999: folds
Uncalled bet ($25) returned to rahulh1
rahulh1: doesn't show hand
rahulh1 collected $50 from pot
*** SUMMARY ***
Total pot $50.00 | Rake $0
Board []
Seat 1: Lucifer999 (small blind) folded before Flop
Seat 2: rahulh1 (big blind) collected ($50)
Seat 6: akshark108 (button) folded before Flop (didn't bet)



PokerStars Game #00327548615: Hold'em No Limit ($10/$25 USD) - 2022/04/30 11:41:00 ET
Table 'Hold'em (Min 500Max 2500) 1001' 6-max Seat #6 is the button
Seat 1: JaspritBumrah786 ($3598.16 in chips) 
Seat 2: Millie ($2500 in chips) 
Seat 4: devi7 ($2461.76 in chips) 
Seat 5: Lucifer999 ($4047.6 in chips) 
Seat 6: spidy02 ($3551.11 in chips) 
JaspritBumrah786: posts small blind $10
devi7: posts big blind $25
*** HOLE CARDS ***
Dealt to Lucifer999 [9d Qd]
Lucifer999: raises $55.00 to $80
spidy02: folds
JaspritBumrah786: folds
devi7: folds
Uncalled bet ($55) returned to Lucifer999
Lucifer999: doesn't show hand
Lucifer999 collected $60 from pot
*** SUMMARY ***
Total pot $60.00 | Rake $0
Board []
Seat 1: JaspritBumrah786 (small blind) folded before Flop
Seat 4: devi7 (big blind) folded before Flop
Seat 5: Lucifer999 collected ($60)
Seat 6: spidy02 (button) folded before Flop (didn't bet)



PokerStars Game #00327548491: Hold'em No Limit ($50/$100 USD) - 2022/04/30 11:40:23 ET
Table 'Hold'em (Min 25KMax 10K)    69' 6-max Seat #4 is the button
Seat 1: Lucifer999 ($20713.91 in chips) 
Seat 2: bigbucks ($10000 in chips) 
Seat 3: Mpr@59  ($12067.26 in chips) 
Seat 4: Nucking Futs ($9981.63 in chips) 
Seat 5: tabby20 ($31943.34 in chips) 
Seat 6: manny007 ($4644.91 in chips) 
tabby20: posts small blind $50
manny007: posts big blind $100
bigbucks: posts big blind $100
*** HOLE CARDS ***
Dealt to Lucifer999 [As Jc]
Lucifer999: folds
bigbucks: checks
Mpr@59 : calls $100
Nucking Futs: raises $150.00 to $250
tabby20: calls $200
manny007: folds
bigbucks: calls $150
Mpr@59 : calls $150
*** FLOP *** [7d 4h Qc]
tabby20: checks
bigbucks: checks
Mpr@59 : checks
Nucking Futs: checks
*** TURN *** [7d 4h Qc] [6d]
tabby20: bets $950
bigbucks: calls $950
Mpr@59 : folds
Nucking Futs: folds
*** RIVER *** [7d 4h Qc 6d] [Tc]
tabby20: bets $2000
bigbucks: folds
Uncalled bet ($2000) returned to tabby20
tabby20: doesn't show hand
tabby20 collected $2868 from pot
*** SUMMARY ***
Total pot $3000.00 | Rake $132
Board [7d 4h Qc 6d Tc]
Seat 1: Lucifer999 folded before Flop (didn't bet)
Seat 2: bigbucks folded on the River
Seat 3: Mpr@59  folded on the Turn
Seat 4: Nucking Futs (button) folded on the Turn
Seat 5: tabby20 (small blind) collected ($2868)
Seat 6: manny007 (big blind) folded before Flop



PokerStars Game #00327548689: Hold'em No Limit ($10/$25 USD) - 2022/04/30 11:41:26 ET
Table 'Hold'em (Min 500Max 2500) 1001' 6-max Seat #1 is the button
Seat 1: JaspritBumrah786 ($3588.16 in chips) 
Seat 2: Millie ($2500 in chips) 
Seat 4: devi7 ($2436.76 in chips) 
Seat 5: Lucifer999 ($4082.6 in chips) 
Seat 6: spidy02 ($3551.11 in chips) 
devi7: posts small blind $10
Lucifer999: posts big blind $25
*** HOLE CARDS ***
Dealt to Lucifer999 [9s Ks]
spidy02: calls $25
JaspritBumrah786: raises $100.00 to $125
devi7: folds
Lucifer999: calls $100
spidy02: folds
*** FLOP *** [3s 7s 6s]
Lucifer999: bets $130
JaspritBumrah786: folds
Uncalled bet ($130) returned to Lucifer999
Lucifer999: doesn't show hand
Lucifer999 collected $268.04 from pot
*** SUMMARY ***
Total pot $285.00 | Rake $16.96
Board [3s 7s 6s]
Seat 1: JaspritBumrah786 (button) folded on the Flop
Seat 4: devi7 (small blind) folded before Flop
Seat 5: Lucifer999 (big blind) collected ($268.04)
Seat 6: spidy02 folded before Flop



PokerStars Game #00327548611: Hold'em No Limit ($10/$25 USD) - 2022/04/30 11:40:58 ET
Table 'Hold'em (Min 500Max 2500)  1282' 6-max Seat #4 is the button
Seat 1: movetome ($2734.85 in chips) 
Seat 2: jas8k ($2093.68 in chips) 
Seat 3: Mastkalandar ($2601.92 in chips) 
Seat 4: fishfry123 ($973.23 in chips) 
Seat 5: Lucifer999 ($10664.74 in chips) 
Seat 6: devi7 ($4994.57 in chips) 
Lucifer999: posts small blind $10
devi7: posts big blind $25
*** HOLE CARDS ***
Dealt to Lucifer999 [Kc Jh]
movetome: raises $50.00 to $75
jas8k: calls $75
Mastkalandar: folds
fishfry123: folds
Lucifer999: folds
devi7: folds
*** FLOP *** [Ks Ts Qs]
movetome: checks
jas8k: checks
*** TURN *** [Ks Ts Qs] [2s]
movetome: checks
jas8k: bets $87.15
movetome: calls $87.15
*** RIVER *** [Ks Ts Qs 2s] [7c]
movetome: checks
jas8k: bets $189.74
movetome: folds
Uncalled bet ($189.74) returned to jas8k
jas8k: doesn't show hand
jas8k collected $337.46 from pot
*** SUMMARY ***
Total pot $359.30 | Rake $21.84
Board [Ks Ts Qs 2s 7c]
Seat 1: movetome folded on the River
Seat 2: jas8k collected ($337.46)
Seat 3: Mastkalandar folded before Flop (didn't bet)
Seat 4: fishfry123 (button) folded before Flop (didn't bet)
Seat 5: Lucifer999 (small blind) folded before Flop
Seat 6: devi7 (big blind) folded before Flop



PokerStars Game #00327548674: Hold'em No Limit ($25/$50 USD) - 2022/04/30 11:41:22 ET
Table 'Hold'em (Min 1K Max 5K)   216' 6-max Seat #1 is the button
Seat 1: Lucifer999 ($13864.72 in chips) 
Seat 2: rahulh1 ($2116.58 in chips) 
Seat 3: rA-j891 ($5000 in chips) 
Seat 6: akshark108 ($1024.96 in chips) 
rahulh1: posts small blind $25
rA-j891: posts big blind $50
*** HOLE CARDS ***
Dealt to Lucifer999 [4c 6d]
akshark108: folds
Lucifer999: folds
rahulh1: raises $68.75 to $118.75
rA-j891: raises $387.50 to $506.25
rahulh1: calls $387.5
*** FLOP *** [6h Qs Jc]
rahulh1: checks
rA-j891: bets $721.43
rahulh1: calls $721.43
*** TURN *** [6h Qs Jc] [Td]
rahulh1: checks
rA-j891: checks
*** RIVER *** [6h Qs Jc Td] [8s]
rahulh1: bets $888.9
rA-j891: calls $888.9
*** SHOW DOWN ***
rahulh1: shows [9s Ts] (Straight, Q-8)
rA-j891: shows [As Ks] (Straight, A-T)
rA-j891 collected $4021.51 from pot
*** SUMMARY ***
Total pot $4233.16 | Rake $211.65
Board [6h Qs Jc Td 8s]
Seat 1: Lucifer999 (button) folded before Flop (didn't bet)
Seat 2: rahulh1 (small blind) showed [9s Ts] and lost with Straight, Q-8
Seat 3: rA-j891  (big blind) showed [As Ks] and won ($4021.51) with Straight, A-T
Seat 6: akshark108 folded before Flop (didn't bet)



PokerStars Game #00327548808: Hold'em No Limit ($10/$25 USD) - 2022/04/30 11:42:03 ET
Table 'Hold'em (Min 500Max 2500) 1001' 6-max Seat #4 is the button
Seat 1: JaspritBumrah786 ($3463.16 in chips) 
Seat 2: Millie ($2500 in chips) 
Seat 4: devi7 ($2426.76 in chips) 
Seat 5: Lucifer999 ($4225.64 in chips) 
Seat 6: spidy02 ($3526.11 in chips) 
Lucifer999: posts small blind $10
spidy02: posts big blind $25
*** HOLE CARDS ***
Dealt to Lucifer999 [2d 6h]
JaspritBumrah786: folds
devi7: folds
Lucifer999: folds
Uncalled bet ($15) returned to spidy02
spidy02: doesn't show hand
spidy02 collected $20 from pot
*** SUMMARY ***
Total pot $20.00 | Rake $0
Board []
Seat 1: JaspritBumrah786 folded before Flop (didn't bet)
Seat 4: devi7 (button) folded before Flop (didn't bet)
Seat 5: Lucifer999 (small blind) folded before Flop
Seat 6: spidy02 (big blind) collected ($20)



PokerStars Game #00327548708: Hold'em No Limit ($50/$100 USD) - 2022/04/30 11:41:32 ET
Table 'Hold'em (Min 25KMax 10K)    69' 6-max Seat #5 is the button
Seat 1: Lucifer999 ($20713.91 in chips) 
Seat 2: bigbucks ($8800 in chips) 
Seat 3: Mpr@59  ($11817.26 in chips) 
Seat 4: Nucking Futs ($9731.63 in chips) 
Seat 5: tabby20 ($33611.34 in chips) 
Seat 6: manny007 ($4544.91 in chips) 
manny007: posts small blind $50
Lucifer999: posts big blind $100
*** HOLE CARDS ***
Dealt to Lucifer999 [Ks Th]
bigbucks: folds
Mpr@59 : calls $100
Nucking Futs: folds
tabby20: folds
manny007: calls $50
Lucifer999: raises $350.00 to $450
Mpr@59 : calls $350
manny007: calls $350
*** FLOP *** [4c 8d Ad]
manny007: checks
Lucifer999: bets $800
Mpr@59 : calls $800
manny007: calls $800
*** TURN *** [4c 8d Ad] [Kd]
manny007: checks
Lucifer999: checks
Mpr@59 : bets $3585
manny007: folds
Lucifer999: folds
Uncalled bet ($3585) returned to Mpr@59 
Mpr@59 : doesn't show hand
Mpr@59  collected $3585 from pot
*** SUMMARY ***
Total pot $3750.00 | Rake $165
Board [4c 8d Ad Kd]
Seat 1: Lucifer999 (big blind) folded on the Turn
Seat 2: bigbucks folded before Flop (didn't bet)
Seat 3: Mpr@59  collected ($3585)
Seat 4: Nucking Futs folded before Flop (didn't bet)
Seat 5: tabby20 (button) folded before Flop (didn't bet)
Seat 6: manny007 (small blind) folded on the Turn



PokerStars Game #00327548891: Hold'em No Limit ($10/$25 USD) - 2022/04/30 11:42:27 ET
Table 'Hold'em (Min 500Max 2500) 1001' 6-max Seat #5 is the button
Seat 1: JaspritBumrah786 ($3463.16 in chips) 
Seat 2: Millie ($2500 in chips) 
Seat 4: devi7 ($2426.76 in chips) 
Seat 5: Lucifer999 ($4215.64 in chips) 
Seat 6: spidy02 ($3536.11 in chips) 
spidy02: posts small blind $10
JaspritBumrah786: posts big blind $25
*** HOLE CARDS ***
Dealt to Lucifer999 [Td 9d]
devi7: folds
Lucifer999: raises $55.00 to $80
spidy02: calls $70
JaspritBumrah786: folds
*** FLOP *** [7s 6s Ah]
spidy02: checks
Lucifer999: bets $110
spidy02: folds
Uncalled bet ($110) returned to Lucifer999
Lucifer999: doesn't show hand
Lucifer999 collected $174.29 from pot
*** SUMMARY ***
Total pot $185.00 | Rake $10.71
Board [7s 6s Ah]
Seat 1: JaspritBumrah786 (big blind) folded before Flop
Seat 4: devi7 folded before Flop (didn't bet)
Seat 5: Lucifer999 (button) collected ($174.29)
Seat 6: spidy02 (small blind) folded on the Flop



PokerStars Game #00327548871: Hold'em No Limit ($25/$50 USD) - 2022/04/30 11:42:20 ET
Table 'Hold'em (Min 1K Max 5K)   216' 6-max Seat #3 is the button
Seat 1: Lucifer999 ($13864.72 in chips) 
Seat 3: rA-j891 ($6904.93 in chips) 
Seat 6: akshark108 ($1024.96 in chips) 
akshark108: posts small blind $25
Lucifer999: posts big blind $50
*** HOLE CARDS ***
Dealt to Lucifer999 [7d Jh]
rA-j891: folds
akshark108: calls $25
Lucifer999: raises $175.00 to $225
akshark108: calls $175
*** FLOP *** [4s Jd 8c]
akshark108: checks
Lucifer999: bets $150
akshark108: calls $150
*** TURN *** [4s Jd 8c] [9h]
akshark108: bets $649.96
Lucifer999: calls $649.96
*** RIVER *** [4s Jd 8c 9h] [Jc]
*** RIVER *** [4s Jd 8c 9h] [9c]
*** SHOW DOWN ***
Lucifer999: shows [7d Jh] (Two pairs, JJ99)
akshark108: shows [Tc 9s] (Three of a kind, 999)
Lucifer999 collected $973.74 from pot
akshark108 collected $973.73 from pot
*** SUMMARY ***
Total pot $2049.92 | Rake $102.45
Board [4s Jd 8c 9h Jc]
Seat 1: Lucifer999  (big blind) showed [7d Jh] and won ($973.74) with Two pairs, JJ99
Seat 3: rA-j891 (button) folded before Flop (didn't bet)
Seat 6: akshark108  (small blind) showed [Tc 9s] and won ($973.73) with Three of a kind, 999



PokerStars Game #00327548858: Hold'em No Limit ($10/$25 USD) - 2022/04/30 11:42:16 ET
Table 'Hold'em (Min 500Max 2500)  1282' 6-max Seat #5 is the button
Seat 1: movetome ($2572.7 in chips) 
Seat 2: jas8k ($2268.99 in chips) 
Seat 3: Mastkalandar ($2601.92 in chips) 
Seat 4: fishfry123 ($973.23 in chips) 
Seat 5: Lucifer999 ($10654.74 in chips) 
Seat 6: devi7 ($4969.57 in chips) 
devi7: posts small blind $10
movetome: posts big blind $25
*** HOLE CARDS ***
Dealt to Lucifer999 [Jd 9d]
jas8k: folds
Mastkalandar: raises $50.00 to $75
fishfry123: folds
Lucifer999: calls $75
devi7: folds
movetome: folds
*** FLOP *** [Ks Jh 3d]
Mastkalandar: checks
Lucifer999: checks
*** TURN *** [Ks Jh 3d] [Kc]
Mastkalandar: checks
Lucifer999: bets $110
Mastkalandar: raises $265.00 to $375
Lucifer999: calls $265
*** RIVER *** [Ks Jh 3d Kc] [8c]
Mastkalandar: bets $625
Lucifer999: folds
Uncalled bet ($625) returned to Mastkalandar
Mastkalandar: doesn't show hand
Mastkalandar collected $880.92 from pot
*** SUMMARY ***
Total pot $935.00 | Rake $54.08
Board [Ks Jh 3d Kc 8c]
Seat 1: movetome (big blind) folded before Flop
Seat 2: jas8k folded before Flop (didn't bet)
Seat 3: Mastkalandar collected ($880.92)
Seat 4: fishfry123 folded before Flop (didn't bet)
Seat 5: Lucifer999 (button) folded on the River
Seat 6: devi7 (small blind) folded before Flop



PokerStars Game #00327549019: Hold'em No Limit ($50/$100 USD) - 2022/04/30 11:43:11 ET
Table 'Hold'em (Min 25KMax 10K)    69' 6-max Seat #6 is the button
Seat 1: Lucifer999 ($19463.91 in chips) 
Seat 2: bigbucks ($8800 in chips) 
Seat 3: Mpr@59  ($14152.26 in chips) 
Seat 4: Nucking Futs ($9731.63 in chips) 
Seat 5: tabby20 ($33611.34 in chips) 
Seat 6: manny007 ($3294.91 in chips) 
Lucifer999: posts small blind $50
Mpr@59 : posts big blind $100
*** HOLE CARDS ***
Dealt to Lucifer999 [4h Ad]
Nucking Futs: folds
tabby20: folds
manny007: folds
Lucifer999: folds
Uncalled bet ($50) returned to Mpr@59 
Mpr@59 : doesn't show hand
Mpr@59  collected $100 from pot
*** SUMMARY ***
Total pot $100.00 | Rake $0
Board []
Seat 1: Lucifer999 (small blind) folded before Flop
Seat 3: Mpr@59  (big blind) collected ($100)
Seat 4: Nucking Futs folded before Flop (didn't bet)
Seat 5: tabby20 folded before Flop (didn't bet)
Seat 6: manny007 (button) folded before Flop (didn't bet)



PokerStars Game #00327549031: Hold'em No Limit ($10/$25 USD) - 2022/04/30 11:43:13 ET
Table 'Hold'em (Min 500Max 2500) 1001' 6-max Seat #6 is the button
Seat 1: JaspritBumrah786 ($3438.16 in chips) 
Seat 2: Millie ($2500 in chips) 
Seat 4: devi7 ($2426.76 in chips) 
Seat 5: Lucifer999 ($4309.93 in chips) 
Seat 6: spidy02 ($3456.11 in chips) 
JaspritBumrah786: posts small blind $10
Millie: posts big blind $25
*** HOLE CARDS ***
Dealt to Lucifer999 [6d Ad]
devi7: folds
Lucifer999: folds
spidy02: raises $35.00 to $60
JaspritBumrah786: folds
Millie: folds
Uncalled bet ($35) returned to spidy02
spidy02: doesn't show hand
spidy02 collected $60 from pot
*** SUMMARY ***
Total pot $60.00 | Rake $0
Board []
Seat 1: JaspritBumrah786 (small blind) folded before Flop
Seat 2: Millie (big blind) folded before Flop
Seat 4: devi7 folded before Flop (didn't bet)
Seat 5: Lucifer999 folded before Flop (didn't bet)
Seat 6: spidy02 (button) collected ($60)



PokerStars Game #00327549056: Hold'em No Limit ($25/$50 USD) - 2022/04/30 11:43:20 ET
Table 'Hold'em (Min 1K Max 5K)   216' 6-max Seat #1 is the button
Seat 1: Lucifer999 ($13813.5 in chips) 
Seat 6: akshark108 ($973.73 in chips) 
Lucifer999: posts small blind $25
akshark108: posts big blind $50
*** HOLE CARDS ***
Dealt to Lucifer999 [6d 9d]
Lucifer999: calls $25
akshark108: checks
*** FLOP *** [Ks 2c Jd]
akshark108: checks
Lucifer999: checks
*** TURN *** [Ks 2c Jd] [3h]
akshark108: bets $50
Lucifer999: folds
Uncalled bet ($50) returned to akshark108
akshark108: doesn't show hand
akshark108 collected $95.5 from pot
*** SUMMARY ***
Total pot $100.00 | Rake $4.5
Board [Ks 2c Jd 3h]
Seat 1: Lucifer999 (button) (small blind) folded on the Turn
Seat 6: akshark108 (big blind) collected ($95.5)



PokerStars Game #00327549137: Hold'em No Limit ($10/$25 USD) - 2022/04/30 11:43:44 ET
Table 'Hold'em (Min 500Max 2500) 1001' 6-max Seat #1 is the button
Seat 1: JaspritBumrah786 ($3428.16 in chips) 
Seat 2: Millie ($2500 in chips) 
Seat 4: devi7 ($2426.76 in chips) 
Seat 5: Lucifer999 ($4309.93 in chips) 
Seat 6: spidy02 ($3491.11 in chips) 
Millie: posts small blind $10
devi7: posts big blind $25
*** HOLE CARDS ***
Dealt to Lucifer999 [Ad 2h]
Lucifer999: folds
spidy02: calls $25
JaspritBumrah786: raises $100.00 to $125
Millie: folds
devi7: folds
spidy02: folds
Uncalled bet ($100) returned to JaspritBumrah786
JaspritBumrah786: doesn't show hand
JaspritBumrah786 collected $85 from pot
*** SUMMARY ***
Total pot $85.00 | Rake $0
Board []
Seat 1: JaspritBumrah786 (button) collected ($85)
Seat 2: Millie (small blind) folded before Flop
Seat 4: devi7 (big blind) folded before Flop
Seat 5: Lucifer999 folded before Flop (didn't bet)
Seat 6: spidy02 folded before Flop



PokerStars Game #00327549221: Hold'em No Limit ($10/$25 USD) - 2022/04/30 11:44:17 ET
Table 'Hold'em (Min 500Max 2500) 1001' 6-max Seat #2 is the button
Seat 1: JaspritBumrah786 ($3488.16 in chips) 
Seat 2: Millie ($2500 in chips) 
Seat 4: devi7 ($2401.76 in chips) 
Seat 5: Lucifer999 ($4309.93 in chips) 
Seat 6: spidy02 ($3466.11 in chips) 
devi7: posts small blind $10
Lucifer999: posts big blind $25
*** HOLE CARDS ***
Dealt to Lucifer999 [Qh 6s]
spidy02: folds
JaspritBumrah786: folds
Millie: folds
devi7: folds
Uncalled bet ($15) returned to Lucifer999
Lucifer999: doesn't show hand
Lucifer999 collected $20 from pot
*** SUMMARY ***
Total pot $20.00 | Rake $0
Board []
Seat 1: JaspritBumrah786 folded before Flop (didn't bet)
Seat 2: Millie (button) folded before Flop (didn't bet)
Seat 4: devi7 (small blind) folded before Flop
Seat 5: Lucifer999 (big blind) collected ($20)
Seat 6: spidy02 folded before Flop (didn't bet)



PokerStars Game #00327549159: Hold'em No Limit ($25/$50 USD) - 2022/04/30 11:43:51 ET
Table 'Hold'em (Min 1K Max 5K)   216' 6-max Seat #6 is the button
Seat 1: Lucifer999 ($13763.5 in chips) 
Seat 6: akshark108 ($1019.23 in chips) 
akshark108: posts small blind $25
Lucifer999: posts big blind $50
*** HOLE CARDS ***
Dealt to Lucifer999 [2s 7h]
akshark108: calls $25
Lucifer999: checks
*** FLOP *** [Th Tc Ac]
Lucifer999: checks
akshark108: checks
*** TURN *** [Th Tc Ac] [8d]
Lucifer999: checks
akshark108: bets $95.5
Lucifer999: folds
Uncalled bet ($95.5) returned to akshark108
akshark108: doesn't show hand
akshark108 collected $95.5 from pot
*** SUMMARY ***
Total pot $100.00 | Rake $4.5
Board [Th Tc Ac 8d]
Seat 1: Lucifer999 (big blind) folded on the Turn
Seat 6: akshark108 (button) (small blind) collected ($95.5)



PokerStars Game #00327549110: Hold'em No Limit ($50/$100 USD) - 2022/04/30 11:43:37 ET
Table 'Hold'em (Min 25KMax 10K)    69' 6-max Seat #1 is the button
Seat 1: Lucifer999 ($19413.91 in chips) 
Seat 2: bigbucks ($8800 in chips) 
Seat 3: Mpr@59  ($14202.26 in chips) 
Seat 4: Nucking Futs ($9731.63 in chips) 
Seat 5: tabby20 ($33611.34 in chips) 
Seat 6: manny007 ($3294.91 in chips) 
Mpr@59 : posts small blind $50
Nucking Futs: posts big blind $100
*** HOLE CARDS ***
Dealt to Lucifer999 [Ad Js]
tabby20: raises $250.00 to $350
manny007: folds
Lucifer999: calls $350
Mpr@59 : calls $300
Nucking Futs: calls $250
*** FLOP *** [Ah 2c 9d]
Mpr@59 : checks
Nucking Futs: checks
tabby20: bets $850
Lucifer999: calls $850
Mpr@59 : folds
Nucking Futs: folds
*** TURN *** [Ah 2c 9d] [9h]
tabby20: checks
Lucifer999: checks
*** RIVER *** [Ah 2c 9d 9h] [8d]
tabby20: checks
Lucifer999: bets $1100
tabby20: folds
Uncalled bet ($1100) returned to Lucifer999
Lucifer999: doesn't show hand
Lucifer999 collected $2963.6 from pot
*** SUMMARY ***
Total pot $3100.00 | Rake $136.4
Board [Ah 2c 9d 9h 8d]
Seat 1: Lucifer999 (button) collected ($2963.6)
Seat 3: Mpr@59  (small blind) folded on the Flop
Seat 4: Nucking Futs (big blind) folded on the Flop
Seat 5: tabby20 folded on the River
Seat 6: manny007 folded before Flop (didn't bet)



PokerStars Game #00327549112: Hold'em No Limit ($10/$25 USD) - 2022/04/30 11:43:37 ET
Table 'Hold'em (Min 500Max 2500)  1282' 6-max Seat #6 is the button
Seat 1: movetome ($2547.7 in chips) 
Seat 2: jas8k ($2268.99 in chips) 
Seat 3: Mastkalandar ($3032.84 in chips) 
Seat 4: fishfry123 ($973.23 in chips) 
Seat 5: Lucifer999 ($10204.74 in chips) 
Seat 6: devi7 ($4959.57 in chips) 
movetome: posts small blind $10
jas8k: posts big blind $25
*** HOLE CARDS ***
Dealt to Lucifer999 [As 5s]
Mastkalandar: folds
fishfry123: raises $60.00 to $85
Lucifer999: calls $85
devi7: folds
movetome: folds
jas8k: calls $60
*** FLOP *** [7d 3s Ad]
jas8k: bets $124.55
fishfry123: folds
Lucifer999: calls $124.55
*** TURN *** [7d 3s Ad] [Jd]
jas8k: checks
Lucifer999: checks
*** RIVER *** [7d 3s Ad Jd] [Jh]
jas8k: bets $361.59
Lucifer999: calls $361.59
*** SHOW DOWN ***
jas8k: shows [Ah Kc] (Two pairs, AAJJ)
Lucifer999: doesn't show hand
jas8k collected $1167.34 from pot
*** SUMMARY ***
Total pot $1237.28 | Rake $69.94
Board [7d 3s Ad Jd Jh]
Seat 1: movetome (small blind) folded before Flop
Seat 2: jas8k  (big blind) showed [Ah Kc] and won ($1167.34) with Two pairs, AAJJ
Seat 3: Mastkalandar folded before Flop (didn't bet)
Seat 4: fishfry123 folded on the Flop
Seat 5: Lucifer999 mucked
Seat 6: devi7 (button) folded before Flop (didn't bet)



PokerStars Game #00327549290: Hold'em No Limit ($25/$50 USD) - 2022/04/30 11:44:39 ET
Table 'Hold'em (Min 1K Max 5K)   216' 6-max Seat #1 is the button
Seat 1: Lucifer999 ($13713.5 in chips) 
Seat 6: akshark108 ($1064.73 in chips) 
Lucifer999: posts small blind $25
akshark108: posts big blind $50
*** HOLE CARDS ***
Dealt to Lucifer999 [Qd 9s]
Lucifer999: calls $25
akshark108: checks
*** FLOP *** [6h Qc 3c]
akshark108: checks
Lucifer999: checks
*** TURN *** [6h Qc 3c] [As]
akshark108: checks
Lucifer999: bets $50
akshark108: folds
Uncalled bet ($50) returned to Lucifer999
Lucifer999: doesn't show hand
Lucifer999 collected $95.5 from pot
*** SUMMARY ***
Total pot $100.00 | Rake $4.5
Board [6h Qc 3c As]
Seat 1: Lucifer999 (button) (small blind) collected ($95.5)
Seat 6: akshark108 (big blind) folded on the Turn



PokerStars Game #00327549404: Hold'em No Limit ($25/$50 USD) - 2022/04/30 11:45:15 ET
Table 'Hold'em (Min 1K Max 5K)   216' 6-max Seat #6 is the button
Seat 1: Lucifer999 ($13759 in chips) 
Seat 6: akshark108 ($1014.73 in chips) 
akshark108: posts small blind $25
Lucifer999: posts big blind $50
*** HOLE CARDS ***
Dealt to Lucifer999 [2h 8c]
akshark108: folds
Uncalled bet ($25) returned to Lucifer999
Lucifer999: doesn't show hand
Lucifer999 collected $50 from pot
*** SUMMARY ***
Total pot $50.00 | Rake $0
Board []
Seat 1: Lucifer999 (big blind) collected ($50)
Seat 6: akshark108 (button) (small blind) folded before Flop



PokerStars Game #00327549284: Hold'em No Limit ($10/$25 USD) - 2022/04/30 11:44:38 ET
Table 'Hold'em (Min 500Max 2500) 1001' 6-max Seat #4 is the button
Seat 1: JaspritBumrah786 ($3488.16 in chips) 
Seat 2: Millie ($2500 in chips) 
Seat 4: devi7 ($2391.76 in chips) 
Seat 5: Lucifer999 ($4319.93 in chips) 
Seat 6: spidy02 ($3466.11 in chips) 
Lucifer999: posts small blind $10
spidy02: posts big blind $25
*** HOLE CARDS ***
Dealt to Lucifer999 [4d 4h]
JaspritBumrah786: folds
Millie: folds
devi7: folds
Lucifer999: raises $55.00 to $80
spidy02: calls $55
*** FLOP *** [8d 3d 2s]
Lucifer999: checks
spidy02: bets $99.21
Lucifer999: raises $140.79 to $240
spidy02: calls $140.79
*** TURN *** [8d 3d 2s] [9h]
Lucifer999: bets $540
spidy02: calls $540
*** RIVER *** [8d 3d 2s 9h] [7c]
Lucifer999: checks
spidy02: checks
*** SHOW DOWN ***
Lucifer999: shows [4d 4h] (Pair, 44)
spidy02: shows [Kc 8c] (Pair, 88)
spidy02 collected $1624.7 from pot
*** SUMMARY ***
Total pot $1720.00 | Rake $95.3
Board [8d 3d 2s 9h 7c]
Seat 1: JaspritBumrah786 folded before Flop (didn't bet)
Seat 2: Millie folded before Flop (didn't bet)
Seat 4: devi7 (button) folded before Flop (didn't bet)
Seat 5: Lucifer999 (small blind) showed [4d 4h] and lost with Pair, 44
Seat 6: spidy02  (big blind) showed [Kc 8c] and won ($1624.7) with Pair, 88



PokerStars Game #00327549292: Hold'em No Limit ($50/$100 USD) - 2022/04/30 11:44:39 ET
Table 'Hold'em (Min 25KMax 10K)    69' 6-max Seat #3 is the button
Seat 1: Lucifer999 ($21177.51 in chips) 
Seat 2: bigbucks ($8800 in chips) 
Seat 3: Mpr@59  ($13852.26 in chips) 
Seat 4: Nucking Futs ($9381.63 in chips) 
Seat 5: tabby20 ($32411.34 in chips) 
Seat 6: manny007 ($3294.91 in chips) 
Nucking Futs: posts small blind $50
tabby20: posts big blind $100
*** HOLE CARDS ***
Dealt to Lucifer999 [9c 6h]
manny007: folds
Lucifer999: folds
Mpr@59 : calls $100
Nucking Futs: calls $50
tabby20: raises $350.00 to $450
Mpr@59 : folds
Nucking Futs: calls $350
*** FLOP *** [Ad 9d Qd]
Nucking Futs: checks
tabby20: checks
*** TURN *** [Ad 9d Qd] [6d]
Nucking Futs: checks
tabby20: checks
*** RIVER *** [Ad 9d Qd 6d] [Tc]
Nucking Futs: bets $478
tabby20: folds
Uncalled bet ($478) returned to Nucking Futs
Nucking Futs: doesn't show hand
Nucking Futs collected $956 from pot
*** SUMMARY ***
Total pot $1000.00 | Rake $44
Board [Ad 9d Qd 6d Tc]
Seat 1: Lucifer999 folded before Flop (didn't bet)
Seat 3: Mpr@59  (button) folded before Flop
Seat 4: Nucking Futs (small blind) collected ($956)
Seat 5: tabby20 (big blind) folded on the River
Seat 6: manny007 folded before Flop (didn't bet)



PokerStars Game #00327549423: Hold'em No Limit ($25/$50 USD) - 2022/04/30 11:45:22 ET
Table 'Hold'em (Min 1K Max 5K)   216' 6-max Seat #1 is the button
Seat 1: Lucifer999 ($13784 in chips) 
Seat 6: akshark108 ($989.73 in chips) 
Lucifer999: posts small blind $25
akshark108: posts big blind $50
*** HOLE CARDS ***
Dealt to Lucifer999 [4s 6d]
Lucifer999: calls $25
akshark108: checks
*** FLOP *** [7d 5d Th]
akshark108: checks
Lucifer999: checks
*** TURN *** [7d 5d Th] [3d]
akshark108: bets $63.67
Lucifer999: raises $137.59 to $201.26
akshark108: calls $137.59
*** RIVER *** [7d 5d Th 3d] [9h]
akshark108: checks
Lucifer999: bets $800
akshark108: folds
Uncalled bet ($800) returned to Lucifer999
Lucifer999: doesn't show hand
Lucifer999 collected $479.93 from pot
*** SUMMARY ***
Total pot $502.52 | Rake $22.59
Board [7d 5d Th 3d 9h]
Seat 1: Lucifer999 (button) (small blind) collected ($479.93)
Seat 6: akshark108 (big blind) folded on the River



PokerStars Game #00327549497: Hold'em No Limit ($10/$25 USD) - 2022/04/30 11:45:45 ET
Table 'Hold'em (Min 500Max 2500) 1001' 6-max Seat #5 is the button
Seat 1: JaspritBumrah786 ($3488.16 in chips) 
Seat 2: Millie ($2500 in chips) 
Seat 4: devi7 ($2391.76 in chips) 
Seat 5: Lucifer999 ($3459.93 in chips) 
Seat 6: spidy02 ($4230.81 in chips) 
spidy02: posts small blind $10
JaspritBumrah786: posts big blind $25
*** HOLE CARDS ***
Dealt to Lucifer999 [Kc 9d]
Millie: folds
devi7: folds
Lucifer999: raises $55.00 to $80
spidy02: calls $70
JaspritBumrah786: folds
*** FLOP *** [5c 4h 4c]
spidy02: checks
Lucifer999: bets $110
spidy02: folds
Uncalled bet ($110) returned to Lucifer999
Lucifer999: doesn't show hand
Lucifer999 collected $174.29 from pot
*** SUMMARY ***
Total pot $185.00 | Rake $10.71
Board [5c 4h 4c]
Seat 1: JaspritBumrah786 (big blind) folded before Flop
Seat 2: Millie folded before Flop (didn't bet)
Seat 4: devi7 folded before Flop (didn't bet)
Seat 5: Lucifer999 (button) collected ($174.29)
Seat 6: spidy02 (small blind) folded on the Flop



PokerStars Game #00327549309: Hold'em No Limit ($10/$25 USD) - 2022/04/30 11:44:45 ET
Table 'Hold'em (Min 500Max 2500)  1282' 6-max Seat #1 is the button
Seat 1: movetome ($2537.7 in chips) 
Seat 2: jas8k ($2865.19 in chips) 
Seat 3: Mastkalandar ($3032.84 in chips) 
Seat 4: fishfry123 ($888.23 in chips) 
Seat 5: Lucifer999 ($9633.6 in chips) 
Seat 6: devi7 ($4959.57 in chips) 
jas8k: posts small blind $10
Mastkalandar: posts big blind $25
*** HOLE CARDS ***
Dealt to Lucifer999 [8c 5h]
fishfry123: folds
Lucifer999: folds
devi7: raises $50.00 to $75
movetome: folds
jas8k: folds
Mastkalandar: calls $50
*** FLOP *** [Tc 2s 7d]
Mastkalandar: checks
devi7: bets $75
Mastkalandar: calls $75
*** TURN *** [Tc 2s 7d] [7s]
Mastkalandar: checks
devi7: checks
*** RIVER *** [Tc 2s 7d 7s] [Td]
Mastkalandar: checks
devi7: checks
*** SHOW DOWN ***
devi7: shows [Ac 9c] (Two pairs, TT77)
Mastkalandar: shows [As Js] (Two pairs, TT77)
Mastkalandar collected $145.37 from pot
devi7 collected $145.36 from pot
*** SUMMARY ***
Total pot $310.00 | Rake $19.27
Board [Tc 2s 7d 7s Td]
Seat 1: movetome (button) folded before Flop (didn't bet)
Seat 2: jas8k (small blind) folded before Flop
Seat 3: Mastkalandar  (big blind) showed [As Js] and won ($145.37) with Two pairs, TT77
Seat 4: fishfry123 folded before Flop (didn't bet)
Seat 5: Lucifer999 folded before Flop (didn't bet)
Seat 6: devi7  showed [Ac 9c] and won ($145.36) with Two pairs, TT77



PokerStars Game #00327549595: Hold'em No Limit ($25/$50 USD) - 2022/04/30 11:46:17 ET
Table 'Hold'em (Min 1K Max 5K)   216' 6-max Seat #6 is the button
Seat 1: Lucifer999 ($14012.67 in chips) 
Seat 6: akshark108 ($738.47 in chips) 
akshark108: posts small blind $25
Lucifer999: posts big blind $50
*** HOLE CARDS ***
Dealt to Lucifer999 [8h 8d]
akshark108: raises $688.47 to $738.47
Lucifer999: calls $688.47
*** FLOP *** [Jd 4c Qs]
*** FLOP *** [Ts Jc 9d]
*** TURN *** [Jd 4c Qs] [2c]
*** TURN *** [Jd 4c Qs] [8c]
*** RIVER *** [Jd 4c Qs 2c] [7c]
*** RIVER *** [Jd 4c Qs 2c] [5s]
*** SHOW DOWN ***
Lucifer999: shows [8h 8d] (Three of a kind, 888)
akshark108: shows [As 7d] (Straight, J-7)
Lucifer999 collected $705.26 from pot
akshark108 collected $705.26 from pot
*** SUMMARY ***
Total pot $1476.94 | Rake $66.42
Board [Jd 4c Qs 2c 7c]
Seat 1: Lucifer999  (big blind) showed [8h 8d] and won ($705.26) with Three of a kind, 888
Seat 6: akshark108  (button) (small blind) showed [As 7d] and won ($705.26) with Straight, J-7



PokerStars Game #00327549502: Hold'em No Limit ($50/$100 USD) - 2022/04/30 11:45:46 ET
Table 'Hold'em (Min 25KMax 10K)    69' 6-max Seat #4 is the button
Seat 1: Lucifer999 ($21177.51 in chips) 
Seat 2: bigbucks ($8800 in chips) 
Seat 3: Mpr@59  ($13752.26 in chips) 
Seat 4: Nucking Futs ($9887.63 in chips) 
Seat 5: tabby20 ($31961.34 in chips) 
Seat 6: manny007 ($3294.91 in chips) 
tabby20: posts small blind $50
manny007: posts big blind $100
*** HOLE CARDS ***
Dealt to Lucifer999 [7h 7s]
Lucifer999: raises $200.00 to $300
Mpr@59 : folds
Nucking Futs: calls $300
tabby20: folds
manny007: calls $200
*** FLOP *** [3d 8h As]
manny007: checks
Lucifer999: checks
Nucking Futs: checks
*** TURN *** [3d 8h As] [Kc]
manny007: checks
Lucifer999: checks
Nucking Futs: checks
*** RIVER *** [3d 8h As Kc] [Jh]
manny007: checks
Lucifer999: checks
Nucking Futs: bets $1008.2
manny007: calls $1008.2
Lucifer999: folds
*** SHOW DOWN ***
Nucking Futs: shows [Ks Jc] (Two pairs, KKJJ)
manny007: doesn't show hand
Nucking Futs collected $2835.9 from pot
*** SUMMARY ***
Total pot $2966.40 | Rake $130.5
Board [3d 8h As Kc Jh]
Seat 1: Lucifer999 folded on the River
Seat 3: Mpr@59  folded before Flop (didn't bet)
Seat 4: Nucking Futs  (button) showed [Ks Jc] and won ($2835.9) with Two pairs, KKJJ
Seat 5: tabby20 (small blind) folded before Flop
Seat 6: manny007 (big blind) mucked



PokerStars Game #00327549654: Hold'em No Limit ($10/$25 USD) - 2022/04/30 11:46:34 ET
Table 'Hold'em (Min 500Max 2500)  1282' 6-max Seat #2 is the button
Seat 1: movetome ($2537.7 in chips) 
Seat 2: jas8k ($2855.19 in chips) 
Seat 3: Mastkalandar ($3028.21 in chips) 
Seat 4: fishfry123 ($888.23 in chips) 
Seat 5: Lucifer999 ($9633.6 in chips) 
Seat 6: devi7 ($4954.93 in chips) 
Mastkalandar: posts small blind $10
Lucifer999: posts big blind $25
*** HOLE CARDS ***
Dealt to Lucifer999 [Jd 8d]
devi7: raises $50.00 to $75
movetome: folds
jas8k: folds
Mastkalandar: folds
Lucifer999: folds
Uncalled bet ($50) returned to devi7
devi7: doesn't show hand
devi7 collected $60 from pot
*** SUMMARY ***
Total pot $60.00 | Rake $0
Board []
Seat 1: movetome folded before Flop (didn't bet)
Seat 2: jas8k (button) folded before Flop (didn't bet)
Seat 3: Mastkalandar (small blind) folded before Flop
Seat 5: Lucifer999 (big blind) folded before Flop
Seat 6: devi7 collected ($60)



PokerStars Game #00327549648: Hold'em No Limit ($10/$25 USD) - 2022/04/30 11:46:33 ET
Table 'Hold'em (Min 500Max 2500) 1001' 6-max Seat #6 is the button
Seat 1: JaspritBumrah786 ($3463.16 in chips) 
Seat 2: Millie ($2500 in chips) 
Seat 3: KehKeLungaAA ($2500 in chips) 
Seat 4: devi7 ($2391.76 in chips) 
Seat 5: Lucifer999 ($3554.22 in chips) 
Seat 6: spidy02 ($4150.81 in chips) 
JaspritBumrah786: posts small blind $10
Millie: posts big blind $25
*** HOLE CARDS ***
Dealt to Lucifer999 [7d Ad]
KehKeLungaAA: checks
devi7: folds
Lucifer999: raises $85.00 to $110
spidy02: calls $110
JaspritBumrah786: folds
Millie: folds
KehKeLungaAA: folds
*** FLOP *** [3s 3c 4c]
Lucifer999: bets $190
spidy02: folds
Uncalled bet ($190) returned to Lucifer999
Lucifer999: doesn't show hand
Lucifer999 collected $263.3 from pot
*** SUMMARY ***
Total pot $280.00 | Rake $16.7
Board [3s 3c 4c]
Seat 1: JaspritBumrah786 (small blind) folded before Flop
Seat 2: Millie (big blind) folded before Flop
Seat 3: KehKeLungaAA folded before Flop (didn't bet)
Seat 4: devi7 folded before Flop (didn't bet)
Seat 5: Lucifer999 collected ($263.3)
Seat 6: spidy02 (button) folded on the Flop



PokerStars Game #00327549662: Hold'em No Limit ($25/$50 USD) - 2022/04/30 11:46:37 ET
Table 'Hold'em (Min 1K Max 5K)   216' 6-max Seat #1 is the button
Seat 1: Lucifer999 ($13979.46 in chips) 
Seat 6: akshark108 ($705.26 in chips) 
Lucifer999: posts small blind $25
akshark108: posts big blind $50
*** HOLE CARDS ***
Dealt to Lucifer999 [3s 2c]
Lucifer999: calls $25
akshark108: checks
*** FLOP *** [Jc 9c 9h]
akshark108: checks
Lucifer999: checks
*** TURN *** [Jc 9c 9h] [Ac]
akshark108: checks
Lucifer999: bets $50
akshark108: folds
Uncalled bet ($50) returned to Lucifer999
Lucifer999: doesn't show hand
Lucifer999 collected $95.5 from pot
*** SUMMARY ***
Total pot $100.00 | Rake $4.5
Board [Jc 9c 9h Ac]
Seat 1: Lucifer999 (button) (small blind) collected ($95.5)
Seat 6: akshark108 (big blind) folded on the Turn



PokerStars Game #00327549795: Hold'em No Limit ($25/$50 USD) - 2022/04/30 11:47:18 ET
Table 'Hold'em (Min 1K Max 5K)   216' 6-max Seat #6 is the button
Seat 1: Lucifer999 ($14024.96 in chips) 
Seat 6: akshark108 ($655.26 in chips) 
akshark108: posts small blind $25
Lucifer999: posts big blind $50
*** HOLE CARDS ***
Dealt to Lucifer999 [6c 7d]
akshark108: raises $605.26 to $655.26
Lucifer999: folds
Uncalled bet ($605.26) returned to akshark108
akshark108: doesn't show hand
akshark108 collected $100 from pot
*** SUMMARY ***
Total pot $100.00 | Rake $0
Board []
Seat 1: Lucifer999 (big blind) folded before Flop
Seat 6: akshark108 (button) (small blind) collected ($100)



PokerStars Game #00327549750: Hold'em No Limit ($10/$25 USD) - 2022/04/30 11:47:04 ET
Table 'Hold'em (Min 500Max 2500)  1282' 6-max Seat #3 is the button
Seat 1: movetome ($2537.7 in chips) 
Seat 2: jas8k ($2855.19 in chips) 
Seat 3: Mastkalandar ($3018.21 in chips) 
Seat 4: fishfry123 ($888.23 in chips) 
Seat 5: Lucifer999 ($9608.6 in chips) 
Seat 6: devi7 ($4989.93 in chips) 
Lucifer999: posts small blind $10
devi7: posts big blind $25
*** HOLE CARDS ***
Dealt to Lucifer999 [Jc 7h]
movetome: folds
jas8k: folds
Mastkalandar: raises $50.00 to $75
Lucifer999: folds
devi7: folds
Uncalled bet ($50) returned to Mastkalandar
Mastkalandar: doesn't show hand
Mastkalandar collected $60 from pot
*** SUMMARY ***
Total pot $60.00 | Rake $0
Board []
Seat 1: movetome folded before Flop (didn't bet)
Seat 2: jas8k folded before Flop (didn't bet)
Seat 3: Mastkalandar (button) collected ($60)
Seat 5: Lucifer999 (small blind) folded before Flop
Seat 6: devi7 (big blind) folded before Flop



PokerStars Game #00327549855: Hold'em No Limit ($25/$50 USD) - 2022/04/30 11:47:36 ET
Table 'Hold'em (Min 1K Max 5K)   216' 6-max Seat #1 is the button
Seat 1: Lucifer999 ($13974.96 in chips) 
Seat 6: akshark108 ($705.26 in chips) 
Lucifer999: posts small blind $25
akshark108: posts big blind $50
*** HOLE CARDS ***
Dealt to Lucifer999 [Kh Kc]
Lucifer999: raises $75.00 to $125
akshark108: folds
Uncalled bet ($75) returned to Lucifer999
Lucifer999: doesn't show hand
Lucifer999 collected $100 from pot
*** SUMMARY ***
Total pot $100.00 | Rake $0
Board []
Seat 1: Lucifer999 (button) (small blind) collected ($100)
Seat 6: akshark108 (big blind) folded before Flop



PokerStars Game #00327549894: Hold'em No Limit ($25/$50 USD) - 2022/04/30 11:47:50 ET
Table 'Hold'em (Min 1K Max 5K)   216' 6-max Seat #6 is the button
Seat 1: Lucifer999 ($14024.96 in chips) 
Seat 6: akshark108 ($655.26 in chips) 
akshark108: posts small blind $25
Lucifer999: posts big blind $50
*** HOLE CARDS ***
Dealt to Lucifer999 [6d 3h]
akshark108: folds
Uncalled bet ($25) returned to Lucifer999
Lucifer999: doesn't show hand
Lucifer999 collected $50 from pot
*** SUMMARY ***
Total pot $50.00 | Rake $0
Board []
Seat 1: Lucifer999 (big blind) collected ($50)
Seat 6: akshark108 (button) (small blind) folded before Flop



PokerStars Game #00327549742: Hold'em No Limit ($50/$100 USD) - 2022/04/30 11:47:02 ET
Table 'Hold'em (Min 25KMax 10K)    69' 6-max Seat #5 is the button
Seat 1: Lucifer999 ($20877.51 in chips) 
Seat 2: bigbucks ($8800 in chips) 
Seat 3: Mpr@59  ($13752.26 in chips) 
Seat 4: Nucking Futs ($11415.33 in chips) 
Seat 5: tabby20 ($31911.34 in chips) 
Seat 6: manny007 ($1986.71 in chips) 
manny007: posts small blind $50
Lucifer999: posts big blind $100
*** HOLE CARDS ***
Dealt to Lucifer999 [Qd 2d]
bigbucks: checks
Mpr@59 : folds
Nucking Futs: folds
tabby20: folds
manny007: calls $50
Lucifer999: raises $300.00 to $400
bigbucks: folds
manny007: calls $300
*** FLOP *** [Jh 4s 9c]
manny007: bets $908.2
Lucifer999: folds
Uncalled bet ($908.2) returned to manny007
manny007: doesn't show hand
manny007 collected $908.2 from pot
*** SUMMARY ***
Total pot $950.00 | Rake $41.8
Board [Jh 4s 9c]
Seat 1: Lucifer999 (big blind) folded on the Flop
Seat 2: bigbucks folded before Flop (didn't bet)
Seat 3: Mpr@59  folded before Flop (didn't bet)
Seat 4: Nucking Futs folded before Flop (didn't bet)
Seat 5: tabby20 (button) folded before Flop (didn't bet)
Seat 6: manny007 (small blind) collected ($908.2)



PokerStars Game #00327549870: Hold'em No Limit ($10/$25 USD) - 2022/04/30 11:47:41 ET
Table 'Hold'em (Min 500Max 2500)  1282' 6-max Seat #5 is the button
Seat 1: movetome ($2537.7 in chips) 
Seat 2: jas8k ($2855.19 in chips) 
Seat 3: Mastkalandar ($3053.21 in chips) 
Seat 4: fishfry123 ($888.23 in chips) 
Seat 5: Lucifer999 ($9598.6 in chips) 
Seat 6: devi7 ($4964.93 in chips) 
devi7: posts small blind $10
movetome: posts big blind $25
*** HOLE CARDS ***
Dealt to Lucifer999 [2s Qd]
jas8k: folds
Mastkalandar: folds
Lucifer999: folds
devi7: raises $55.00 to $80
movetome: folds
Uncalled bet ($55) returned to devi7
devi7: doesn't show hand
devi7 collected $50 from pot
*** SUMMARY ***
Total pot $50.00 | Rake $0
Board []
Seat 1: movetome (big blind) folded before Flop
Seat 2: jas8k folded before Flop (didn't bet)
Seat 3: Mastkalandar folded before Flop (didn't bet)
Seat 5: Lucifer999 (button) folded before Flop (didn't bet)
Seat 6: devi7 (small blind) collected ($50)



PokerStars Game #00327549792: Hold'em No Limit ($10/$25 USD) - 2022/04/30 11:47:17 ET
Table 'Hold'em (Min 500Max 2500) 1001' 6-max Seat #1 is the button
Seat 1: JaspritBumrah786 ($3453.16 in chips) 
Seat 2: Millie ($2500 in chips) 
Seat 3: KehKeLungaAA ($2475 in chips) 
Seat 4: devi7 ($2391.76 in chips) 
Seat 5: Lucifer999 ($3707.52 in chips) 
Seat 6: spidy02 ($4040.81 in chips) 
Millie: posts small blind $10
KehKeLungaAA: posts big blind $25
*** HOLE CARDS ***
Dealt to Lucifer999 [9h Kc]
devi7: folds
Lucifer999: folds
spidy02: raises $38.75 to $63.75
JaspritBumrah786: folds
Millie: folds
KehKeLungaAA: calls $38.75
*** FLOP *** [8c Th 9d]
KehKeLungaAA: checks
spidy02: checks
*** TURN *** [8c Th 9d] [As]
KehKeLungaAA: checks
spidy02: bets $64.66
KehKeLungaAA: calls $64.66
*** RIVER *** [8c Th 9d As] [Ah]
KehKeLungaAA: checks
spidy02: bets $250.86
KehKeLungaAA: calls $250.86
*** SHOW DOWN ***
spidy02: shows [Qh Jd] (Straight, Q-8)
KehKeLungaAA: doesn't show hand
spidy02 collected $723.22 from pot
*** SUMMARY ***
Total pot $768.54 | Rake $45.32
Board [8c Th 9d As Ah]
Seat 1: JaspritBumrah786 (button) folded before Flop (didn't bet)
Seat 2: Millie (small blind) folded before Flop
Seat 3: KehKeLungaAA (big blind) mucked
Seat 4: devi7 folded before Flop (didn't bet)
Seat 5: Lucifer999 folded before Flop (didn't bet)
Seat 6: spidy02  showed [Qh Jd] and won ($723.22) with Straight, Q-8



PokerStars Game #00327549915: Hold'em No Limit ($25/$50 USD) - 2022/04/30 11:47:57 ET
Table 'Hold'em (Min 1K Max 5K)   216' 6-max Seat #1 is the button
Seat 1: Lucifer999 ($14049.96 in chips) 
Seat 6: akshark108 ($630.26 in chips) 
Lucifer999: posts small blind $25
akshark108: posts big blind $50
*** HOLE CARDS ***
Dealt to Lucifer999 [Qc 7h]
Lucifer999: calls $25
akshark108: checks
*** FLOP *** [5d As 6d]
akshark108: checks
Lucifer999: bets $75
akshark108: raises $505.26 to $580.26
Lucifer999: folds
Uncalled bet ($505.26) returned to akshark108
akshark108: doesn't show hand
akshark108 collected $238.75 from pot
*** SUMMARY ***
Total pot $250.00 | Rake $11.25
Board [5d As 6d]
Seat 1: Lucifer999 (button) (small blind) folded on the Flop
Seat 6: akshark108 (big blind) collected ($238.75)



PokerStars Game #00327549962: Hold'em No Limit ($10/$25 USD) - 2022/04/30 11:48:08 ET
Table 'Hold'em (Min 500Max 2500)  1282' 6-max Seat #6 is the button
Seat 1: movetome ($2512.7 in chips) 
Seat 2: jas8k ($2855.19 in chips) 
Seat 3: Mastkalandar ($3053.21 in chips) 
Seat 4: fishfry123 ($888.23 in chips) 
Seat 5: Lucifer999 ($9598.6 in chips) 
Seat 6: devi7 ($4989.93 in chips) 
movetome: posts small blind $10
jas8k: posts big blind $25
*** HOLE CARDS ***
Dealt to Lucifer999 [Jd 7c]
Mastkalandar: folds
Lucifer999: folds
devi7: folds
movetome: folds
Uncalled bet ($15) returned to jas8k
jas8k: doesn't show hand
jas8k collected $20 from pot
*** SUMMARY ***
Total pot $20.00 | Rake $0
Board []
Seat 1: movetome (small blind) folded before Flop
Seat 2: jas8k (big blind) collected ($20)
Seat 3: Mastkalandar folded before Flop (didn't bet)
Seat 5: Lucifer999 folded before Flop (didn't bet)
Seat 6: devi7 (button) folded before Flop (didn't bet)



PokerStars Game #00327550047: Hold'em No Limit ($25/$50 USD) - 2022/04/30 11:48:34 ET
Table 'Hold'em (Min 1K Max 5K)   216' 6-max Seat #6 is the button
Seat 1: Lucifer999 ($13924.96 in chips) 
Seat 6: akshark108 ($744.01 in chips) 
akshark108: posts small blind $25
Lucifer999: posts big blind $50
*** HOLE CARDS ***
Dealt to Lucifer999 [Ts 6c]
akshark108: folds
Uncalled bet ($25) returned to Lucifer999
Lucifer999: doesn't show hand
Lucifer999 collected $50 from pot
*** SUMMARY ***
Total pot $50.00 | Rake $0
Board []
Seat 1: Lucifer999 (big blind) collected ($50)
Seat 6: akshark108 (button) (small blind) folded before Flop



PokerStars Game #00327549933: Hold'em No Limit ($50/$100 USD) - 2022/04/30 11:48:00 ET
Table 'Hold'em (Min 25KMax 10K)    69' 6-max Seat #6 is the button
Seat 1: Lucifer999 ($20477.51 in chips) 
Seat 2: bigbucks ($8650 in chips) 
Seat 3: Mpr@59  ($13752.26 in chips) 
Seat 4: Coco98 ($10000 in chips) 
Seat 5: tabby20 ($31911.34 in chips) 
Seat 6: manny007 ($2494.91 in chips) 
Lucifer999: posts small blind $50
bigbucks: posts big blind $100
*** HOLE CARDS ***
Dealt to Lucifer999 [Jh Ah]
Mpr@59 : folds
Coco98: folds
tabby20: folds
manny007: calls $100
Lucifer999: raises $350.00 to $450
bigbucks: folds
manny007: raises $350.00 to $800
Lucifer999: raises $19677.50 to $20477.5
manny007: calls $1694.91
Uncalled bet ($17982.59) returned to Lucifer999
*** FLOP *** [2d 2h 4d]
*** FLOP *** [3h Ad 9s]
*** TURN *** [2d 2h 4d] [8h]
*** TURN *** [2d 2h 4d] [As]
*** RIVER *** [2d 2h 4d 8h] [5h]
*** RIVER *** [2d 2h 4d 8h] [3c]
*** SHOW DOWN ***
Lucifer999: shows [Jh Ah] (Full house, AAA33)
manny007: shows [Kc Kh] (Two pairs, AAKK)
Lucifer999 collected $2432.96 from pot
Lucifer999 collected $2432.95 from pot
*** SUMMARY ***
Total pot $5089.82 | Rake $223.91
Board [2d 2h 4d 8h 5h]
Seat 1: Lucifer999  (small blind) showed [Jh Ah] and won ($2432.95) with Full house, AAA33
Seat 2: bigbucks (big blind) folded before Flop
Seat 3: Mpr@59  folded before Flop (didn't bet)
Seat 4: Coco98 folded before Flop (didn't bet)
Seat 5: tabby20 folded before Flop (didn't bet)
Seat 6: manny007 (button) showed [Kc Kh] and lost with Two pairs, AAKK



PokerStars Game #00327550051: Hold'em No Limit ($10/$25 USD) - 2022/04/30 11:48:36 ET
Table 'Hold'em (Min 500Max 2500)  1282' 6-max Seat #1 is the button
Seat 1: movetome ($2502.7 in chips) 
Seat 2: jas8k ($2865.19 in chips) 
Seat 3: Mastkalandar ($3053.21 in chips) 
Seat 4: fishfry123 ($888.23 in chips) 
Seat 5: Lucifer999 ($9598.6 in chips) 
Seat 6: devi7 ($4989.93 in chips) 
jas8k: posts small blind $10
Lucifer999: posts big blind $25
*** HOLE CARDS ***
Dealt to Lucifer999 [3s Td]
devi7: raises $50.00 to $75
movetome: folds
jas8k: folds
Lucifer999: folds
Uncalled bet ($50) returned to devi7
devi7: doesn't show hand
devi7 collected $60 from pot
*** SUMMARY ***
Total pot $60.00 | Rake $0
Board []
Seat 1: movetome (button) folded before Flop (didn't bet)
Seat 2: jas8k (small blind) folded before Flop
Seat 5: Lucifer999 (big blind) folded before Flop
Seat 6: devi7 collected ($60)



PokerStars Game #00327550071: Hold'em No Limit ($25/$50 USD) - 2022/04/30 11:48:42 ET
Table 'Hold'em (Min 1K Max 5K)   216' 6-max Seat #1 is the button
Seat 1: Lucifer999 ($13949.96 in chips) 
Seat 6: akshark108 ($719.01 in chips) 
Lucifer999: posts small blind $25
akshark108: posts big blind $50
*** HOLE CARDS ***
Dealt to Lucifer999 [5c 8d]
Lucifer999: calls $25
akshark108: checks
*** FLOP *** [4s Td Ac]
akshark108: checks
Lucifer999: bets $75
akshark108: folds
Uncalled bet ($75) returned to Lucifer999
Lucifer999: doesn't show hand
Lucifer999 collected $95.5 from pot
*** SUMMARY ***
Total pot $100.00 | Rake $4.5
Board [4s Td Ac]
Seat 1: Lucifer999 (button) (small blind) collected ($95.5)
Seat 6: akshark108 (big blind) folded on the Flop



PokerStars Game #00327549963: Hold'em No Limit ($10/$25 USD) - 2022/04/30 11:48:09 ET
Table 'Hold'em (Min 500Max 2500) 1001' 6-max Seat #2 is the button
Seat 1: JaspritBumrah786 ($3453.16 in chips) 
Seat 2: Millie ($2500 in chips) 
Seat 3: KehKeLungaAA ($2095.73 in chips) 
Seat 4: devi7 ($2391.76 in chips) 
Seat 5: Lucifer999 ($3707.52 in chips) 
Seat 6: spidy02 ($4384.76 in chips) 
KehKeLungaAA: posts small blind $10
devi7: posts big blind $25
*** HOLE CARDS ***
Dealt to Lucifer999 [6s 6c]
Lucifer999: raises $55.00 to $80
spidy02: folds
JaspritBumrah786: folds
Millie: calls $80
KehKeLungaAA: calls $70
devi7: folds
*** FLOP *** [Ts Js 2d]
KehKeLungaAA: checks
Lucifer999: checks
Millie: bets $180
KehKeLungaAA: folds
Lucifer999: folds
Uncalled bet ($180) returned to Millie
Millie: doesn't show hand
Millie collected $249.09 from pot
*** SUMMARY ***
Total pot $265.00 | Rake $15.91
Board [Ts Js 2d]
Seat 1: JaspritBumrah786 folded before Flop (didn't bet)
Seat 2: Millie (button) collected ($249.09)
Seat 3: KehKeLungaAA (small blind) folded on the Flop
Seat 4: devi7 (big blind) folded before Flop
Seat 5: Lucifer999 folded on the Flop
Seat 6: spidy02 folded before Flop (didn't bet)



PokerStars Game #00327550097: Hold'em No Limit ($50/$100 USD) - 2022/04/30 11:48:50 ET
Table 'Hold'em (Min 25KMax 10K)    69' 6-max Seat #1 is the button
Seat 1: Lucifer999 ($22848.51 in chips) 
Seat 2: bigbucks ($8550 in chips) 
Seat 3: Mpr@59  ($13752.26 in chips) 
Seat 4: Coco98 ($10000 in chips) 
Seat 5: tabby20 ($31911.34 in chips) 
bigbucks: posts small blind $50
Mpr@59 : posts big blind $100
*** HOLE CARDS ***
Dealt to Lucifer999 [6d Kd]
tabby20: folds
Lucifer999: raises $250.00 to $350
bigbucks: folds
Mpr@59 : calls $250
*** FLOP *** [4d 4s 7c]
Mpr@59 : checks
Lucifer999: bets $350
Mpr@59 : folds
Uncalled bet ($350) returned to Lucifer999
Lucifer999: doesn't show hand
Lucifer999 collected $717 from pot
*** SUMMARY ***
Total pot $750.00 | Rake $33
Board [4d 4s 7c]
Seat 1: Lucifer999 (button) collected ($717)
Seat 2: bigbucks (small blind) folded before Flop
Seat 3: Mpr@59  (big blind) folded on the Flop
Seat 5: tabby20 folded before Flop (didn't bet)



PokerStars Game #00327550211: Hold'em No Limit ($50/$100 USD) - 2022/04/30 11:49:30 ET
Table 'Hold'em (Min 25KMax 10K)    69' 6-max Seat #3 is the button
Seat 1: Lucifer999 ($23215.51 in chips) 
Seat 2: bigbucks ($8500 in chips) 
Seat 3: Mpr@59  ($13402.26 in chips) 
Seat 4: Coco98 ($10000 in chips) 
Seat 5: tabby20 ($31911.34 in chips) 
tabby20: posts small blind $50
Lucifer999: posts big blind $100
*** HOLE CARDS ***
Dealt to Lucifer999 [Jh 6c]
Mpr@59 : folds
tabby20: raises $200.00 to $300
Lucifer999: folds
Uncalled bet ($200) returned to tabby20
tabby20: doesn't show hand
tabby20 collected $200 from pot
*** SUMMARY ***
Total pot $200.00 | Rake $0
Board []
Seat 1: Lucifer999 (big blind) folded before Flop
Seat 3: Mpr@59  (button) folded before Flop (didn't bet)
Seat 5: tabby20 (small blind) collected ($200)



PokerStars Game #00327550189: Hold'em No Limit ($10/$25 USD) - 2022/04/30 11:49:22 ET
Table 'Hold'em (Min 500Max 2500) 1001' 6-max Seat #3 is the button
Seat 1: JaspritBumrah786 ($3453.16 in chips) 
Seat 2: Millie ($2669.09 in chips) 
Seat 3: KehKeLungaAA ($2015.73 in chips) 
Seat 4: devi7 ($2366.76 in chips) 
Seat 5: Lucifer999 ($3627.52 in chips) 
Seat 6: spidy02 ($4384.76 in chips) 
devi7: posts small blind $10
Lucifer999: posts big blind $25
*** HOLE CARDS ***
Dealt to Lucifer999 [2h Qh]
spidy02: raises $60.00 to $85
Millie: folds
KehKeLungaAA: folds
devi7: folds
Lucifer999: folds
Uncalled bet ($60) returned to spidy02
spidy02: doesn't show hand
spidy02 collected $60 from pot
*** SUMMARY ***
Total pot $60.00 | Rake $0
Board []
Seat 2: Millie folded before Flop (didn't bet)
Seat 3: KehKeLungaAA (button) folded before Flop (didn't bet)
Seat 4: devi7 (small blind) folded before Flop
Seat 5: Lucifer999 (big blind) folded before Flop
Seat 6: spidy02 collected ($60)



PokerStars Game #00327550178: Hold'em No Limit ($25/$50 USD) - 2022/04/30 11:49:19 ET
Table 'Hold'em (Min 1K Max 5K)   216' 6-max Seat #6 is the button
Seat 1: Lucifer999 ($13995.46 in chips) 
Seat 6: akshark108 ($669.01 in chips) 
akshark108: posts small blind $25
Lucifer999: posts big blind $50
*** HOLE CARDS ***
Dealt to Lucifer999 [9c 4d]
akshark108: calls $25
Lucifer999: checks
*** FLOP *** [Js 7s Ah]
Lucifer999: checks
akshark108: bets $95.5
Lucifer999: folds
Uncalled bet ($95.5) returned to akshark108
akshark108: doesn't show hand
akshark108 collected $95.5 from pot
*** SUMMARY ***
Total pot $100.00 | Rake $4.5
Board [Js 7s Ah]
Seat 1: Lucifer999 (big blind) folded on the Flop
Seat 6: akshark108 (button) (small blind) collected ($95.5)



PokerStars Game #00327550112: Hold'em No Limit ($10/$25 USD) - 2022/04/30 11:48:56 ET
Table 'Hold'em (Min 500Max 2500)  1282' 6-max Seat #2 is the button
Seat 1: movetome ($2502.7 in chips) 
Seat 2: jas8k ($2855.19 in chips) 
Seat 3: Vanquish01 ($500 in chips) 
Seat 4: fishfry123 ($888.23 in chips) 
Seat 5: Lucifer999 ($9573.6 in chips) 
Seat 6: devi7 ($5024.93 in chips) 
Lucifer999: posts small blind $10
devi7: posts big blind $25
*** HOLE CARDS ***
Dealt to Lucifer999 [8s 4s]
movetome: raises $50.00 to $75
jas8k: calls $75
Lucifer999: folds
devi7: raises $325.00 to $400
movetome: folds
jas8k: calls $325
*** FLOP *** [3h As Js]
devi7: bets $550.14
jas8k: folds
Uncalled bet ($550.14) returned to devi7
devi7: doesn't show hand
devi7 collected $833.54 from pot
*** SUMMARY ***
Total pot $885.00 | Rake $51.46
Board [3h As Js]
Seat 1: movetome folded before Flop
Seat 2: jas8k (button) folded on the Flop
Seat 5: Lucifer999 (small blind) folded before Flop
Seat 6: devi7 (big blind) collected ($833.54)



PokerStars Game #00327550256: Hold'em No Limit ($50/$100 USD) - 2022/04/30 11:49:45 ET
Table 'Hold'em (Min 25KMax 10K)    69' 6-max Seat #5 is the button
Seat 1: Lucifer999 ($23115.51 in chips) 
Seat 2: bigbucks ($8500 in chips) 
Seat 3: Mpr@59  ($13402.26 in chips) 
Seat 4: Coco98 ($10000 in chips) 
Seat 5: tabby20 ($32011.34 in chips) 
Lucifer999: posts small blind $50
Mpr@59 : posts big blind $100
*** HOLE CARDS ***
Dealt to Lucifer999 [Ad 9s]
tabby20: raises $200.00 to $300
Lucifer999: folds
Mpr@59 : folds
Uncalled bet ($200) returned to tabby20
tabby20: doesn't show hand
tabby20 collected $250 from pot
*** SUMMARY ***
Total pot $250.00 | Rake $0
Board []
Seat 1: Lucifer999 (small blind) folded before Flop
Seat 3: Mpr@59  (big blind) folded before Flop
Seat 5: tabby20 (button) collected ($250)



PokerStars Game #00327550277: Hold'em No Limit ($10/$25 USD) - 2022/04/30 11:49:49 ET
Table 'Hold'em (Min 500Max 2500) 1001' 6-max Seat #4 is the button
Seat 2: Millie ($2669.09 in chips) 
Seat 3: KehKeLungaAA ($2015.73 in chips) 
Seat 4: devi7 ($2356.76 in chips) 
Seat 5: Lucifer999 ($3602.52 in chips) 
Seat 6: spidy02 ($4419.76 in chips) 
Lucifer999: posts small blind $10
spidy02: posts big blind $25
*** HOLE CARDS ***
Dealt to Lucifer999 [Qh 2h]
Millie: folds
KehKeLungaAA: raises $41.67 to $66.67
devi7: folds
Lucifer999: folds
spidy02: folds
Uncalled bet ($41.67) returned to KehKeLungaAA
KehKeLungaAA: doesn't show hand
KehKeLungaAA collected $60 from pot
*** SUMMARY ***
Total pot $60.00 | Rake $0
Board []
Seat 2: Millie folded before Flop (didn't bet)
Seat 3: KehKeLungaAA collected ($60)
Seat 4: devi7 (button) folded before Flop (didn't bet)
Seat 5: Lucifer999 (small blind) folded before Flop
Seat 6: spidy02 (big blind) folded before Flop



PokerStars Game #00327550278: Hold'em No Limit ($25/$50 USD) - 2022/04/30 11:49:50 ET
Table 'Hold'em (Min 1K Max 5K)   216' 6-max Seat #1 is the button
Seat 1: Lucifer999 ($13945.46 in chips) 
Seat 6: akshark108 ($714.51 in chips) 
Lucifer999: posts small blind $25
akshark108: posts big blind $50
*** HOLE CARDS ***
Dealt to Lucifer999 [Jh 9s]
Lucifer999: calls $25
akshark108: checks
*** FLOP *** [Kd 2s 2c]
akshark108: checks
Lucifer999: checks
*** TURN *** [Kd 2s 2c] [2h]
akshark108: checks
Lucifer999: checks
*** RIVER *** [Kd 2s 2c 2h] [7s]
akshark108: checks
Lucifer999: checks
*** SHOW DOWN ***
akshark108: shows [5s Qc] (Three of a kind, 222)
Lucifer999: doesn't show hand
akshark108 collected $95.5 from pot
*** SUMMARY ***
Total pot $100.00 | Rake $4.5
Board [Kd 2s 2c 2h 7s]
Seat 1: Lucifer999 (button) (small blind) mucked
Seat 6: akshark108  (big blind) showed [5s Qc] and won ($95.5) with Three of a kind, 222



PokerStars Game #00327550286: Hold'em No Limit ($10/$25 USD) - 2022/04/30 11:49:53 ET
Table 'Hold'em (Min 500Max 2500)  1282' 6-max Seat #5 is the button
Seat 1: movetome ($2427.7 in chips) 
Seat 2: jas8k ($2455.19 in chips) 
Seat 3: Vanquish01 ($500 in chips) 
Seat 4: fishfry123 ($888.23 in chips) 
Seat 5: Lucifer999 ($9563.6 in chips) 
Seat 6: devi7 ($5458.47 in chips) 
devi7: posts small blind $10
jas8k: posts big blind $25
*** HOLE CARDS ***
Dealt to Lucifer999 [9c 3s]
Vanquish01: checks
Lucifer999: folds
devi7: raises $75.00 to $100
jas8k: folds
Vanquish01: calls $75
*** FLOP *** [5s 9h 6s]
devi7: bets $105.6
Vanquish01: calls $105.6
*** TURN *** [5s 9h 6s] [9s]
devi7: bets $5252.87
Vanquish01: calls $294.4
Uncalled bet ($4958.47) returned to devi7
*** RIVER *** [5s 9h 6s 9s] [2c]
*** SHOW DOWN ***
Vanquish01: shows [Jh Ac] (Pair, 99)
devi7: shows [Ah 5c] (Two pairs, 9955)
devi7 collected $966.19 from pot
*** SUMMARY ***
Total pot $1025.00 | Rake $58.81
Board [5s 9h 6s 9s 2c]
Seat 2: jas8k (big blind) folded before Flop
Seat 3: Vanquish01 showed [Jh Ac] and lost with Pair, 99
Seat 5: Lucifer999 (button) folded before Flop (didn't bet)
Seat 6: devi7  (small blind) showed [Ah 5c] and won ($966.19) with Two pairs, 9955



PokerStars Game #00327550409: Hold'em No Limit ($25/$50 USD) - 2022/04/30 11:50:36 ET
Table 'Hold'em (Min 1K Max 5K)   216' 6-max Seat #6 is the button
Seat 1: Lucifer999 ($13895.46 in chips) 
Seat 6: akshark108 ($760.01 in chips) 
akshark108: posts small blind $25
Lucifer999: posts big blind $50
*** HOLE CARDS ***
Dealt to Lucifer999 [4h Kc]
akshark108: folds
Uncalled bet ($25) returned to Lucifer999
Lucifer999: doesn't show hand
Lucifer999 collected $50 from pot
*** SUMMARY ***
Total pot $50.00 | Rake $0
Board []
Seat 1: Lucifer999 (big blind) collected ($50)
Seat 6: akshark108 (button) (small blind) folded before Flop



PokerStars Game #00327550338: Hold'em No Limit ($50/$100 USD) - 2022/04/30 11:50:11 ET
Table 'Hold'em (Min 25KMax 10K)    69' 6-max Seat #1 is the button
Seat 1: Lucifer999 ($23065.51 in chips) 
Seat 2: bigbucks ($18500 in chips) 
Seat 3: Mpr@59  ($13302.26 in chips) 
Seat 4: Coco98 ($10000 in chips) 
Seat 5: tabby20 ($32161.34 in chips) 
Mpr@59 : posts small blind $50
Coco98: posts big blind $100
*** HOLE CARDS ***
Dealt to Lucifer999 [3s 8h]
tabby20: raises $200.00 to $300
Lucifer999: folds
Mpr@59 : calls $250
Coco98: folds
*** FLOP *** [6c Ts Ac]
Mpr@59 : checks
tabby20: checks
*** TURN *** [6c Ts Ac] [6h]
Mpr@59 : checks
tabby20: bets $400
Mpr@59 : folds
Uncalled bet ($400) returned to tabby20
tabby20: doesn't show hand
tabby20 collected $669.2 from pot
*** SUMMARY ***
Total pot $700.00 | Rake $30.8
Board [6c Ts Ac 6h]
Seat 1: Lucifer999 (button) folded before Flop (didn't bet)
Seat 3: Mpr@59  (small blind) folded on the Turn
Seat 4: Coco98 (big blind) folded before Flop
Seat 5: tabby20 collected ($669.2)



PokerStars Game #00327550422: Hold'em No Limit ($25/$50 USD) - 2022/04/30 11:50:43 ET
Table 'Hold'em (Min 1K Max 5K)   216' 6-max Seat #1 is the button
Seat 1: Lucifer999 ($13920.46 in chips) 
Seat 6: akshark108 ($735.01 in chips) 
Lucifer999: posts small blind $25
akshark108: posts big blind $50
*** HOLE CARDS ***
Dealt to Lucifer999 [Js Ad]
Lucifer999: calls $25
akshark108: raises $685.01 to $735.01
Lucifer999: calls $685.01
*** FLOP *** [5d 3h 4h]
*** FLOP *** [3d 8d 8h]
*** TURN *** [5d 3h 4h] [2d]
*** TURN *** [5d 3h 4h] [Jc]
*** RIVER *** [5d 3h 4h 2d] [Jd]
*** RIVER *** [5d 3h 4h 2d] [9s]
*** SHOW DOWN ***
Lucifer999: shows [Js Ad] (Two pairs, JJ88)
akshark108: shows [Ah Tc] (Pair, 88)
Lucifer999 collected $350.97 from pot
akshark108 collected $350.97 from pot
Lucifer999 collected $701.93 from pot
*** SUMMARY ***
Total pot $1470.02 | Rake $66.15
Board [5d 3h 4h 2d Jd]
Seat 1: Lucifer999  (button) (small blind) showed [Js Ad] and won ($701.93) with Two pairs, JJ88
Seat 6: akshark108  (big blind) showed [Ah Tc] and won ($350.97) with Pair, 88



PokerStars Game #00327550350: Hold'em No Limit ($10/$25 USD) - 2022/04/30 11:50:15 ET
Table 'Hold'em (Min 500Max 2500) 1001' 6-max Seat #5 is the button
Seat 2: Millie ($2669.09 in chips) 
Seat 3: KehKeLungaAA ($2050.73 in chips) 
Seat 4: devi7 ($2356.76 in chips) 
Seat 5: Lucifer999 ($3592.52 in chips) 
Seat 6: spidy02 ($4394.76 in chips) 
spidy02: posts small blind $10
Millie: posts big blind $25
*** HOLE CARDS ***
Dealt to Lucifer999 [Ks 2h]
devi7: folds
Lucifer999: folds
spidy02: calls $40
Millie: folds
KehKeLungaAA: checks
*** FLOP *** [Qs Ts Kh]
spidy02: bets $58.72
KehKeLungaAA: calls $58.72
*** TURN *** [Qs Ts Kh] [Jh]
spidy02: checks
KehKeLungaAA: checks
*** RIVER *** [Qs Ts Kh Jh] [Jc]
spidy02: bets $227.74
KehKeLungaAA: raises $379.57 to $607.31
spidy02: calls $379.57
*** SHOW DOWN ***
KehKeLungaAA: shows [Jd Th] (Full house, JJJTT)
spidy02: doesn't show hand
KehKeLungaAA collected $1375.57 from pot
*** SUMMARY ***
Total pot $1457.06 | Rake $81.49
Board [Qs Ts Kh Jh Jc]
Seat 2: Millie (big blind) folded before Flop
Seat 3: KehKeLungaAA  showed [Jd Th] and won ($1375.57) with Full house, JJJTT
Seat 4: devi7 folded before Flop (didn't bet)
Seat 5: Lucifer999 (button) folded before Flop (didn't bet)
Seat 6: spidy02 (small blind) mucked



PokerStars Game #00327550495: Hold'em No Limit ($25/$50 USD) - 2022/04/30 11:51:07 ET
Table 'Hold'em (Min 1K Max 5K)   216' 6-max Seat #6 is the button
Seat 1: Lucifer999 ($14238.35 in chips) 
Seat 6: akshark108 ($350.97 in chips) 
akshark108: posts small blind $25
Lucifer999: posts big blind $50
*** HOLE CARDS ***
Dealt to Lucifer999 [9d 5h]
akshark108: raises $300.97 to $350.97
Lucifer999: folds
Uncalled bet ($300.97) returned to akshark108
akshark108: doesn't show hand
akshark108 collected $100 from pot
*** SUMMARY ***
Total pot $100.00 | Rake $0
Board []
Seat 1: Lucifer999 (big blind) folded before Flop
Seat 6: akshark108 (button) (small blind) collected ($100)



PokerStars Game #00327550533: Hold'em No Limit ($25/$50 USD) - 2022/04/30 11:51:19 ET
Table 'Hold'em (Min 1K Max 5K)   216' 6-max Seat #1 is the button
Seat 1: Lucifer999 ($14188.35 in chips) 
Seat 6: akshark108 ($400.97 in chips) 
Lucifer999: posts small blind $25
akshark108: posts big blind $50
*** HOLE CARDS ***
Dealt to Lucifer999 [Kc 3c]
Lucifer999: raises $400.00 to $450
akshark108: folds
Uncalled bet ($400) returned to Lucifer999
Lucifer999: doesn't show hand
Lucifer999 collected $100 from pot
*** SUMMARY ***
Total pot $100.00 | Rake $0
Board []
Seat 1: Lucifer999 (button) (small blind) collected ($100)
Seat 6: akshark108 (big blind) folded before Flop



PokerStars Game #00327550470: Hold'em No Limit ($50/$100 USD) - 2022/04/30 11:50:57 ET
Table 'Hold'em (Min 25KMax 10K)    69' 6-max Seat #3 is the button
Seat 1: Lucifer999 ($23065.51 in chips) 
Seat 2: SPARTANKING0007 ($10000 in chips) 
Seat 3: Mpr@59  ($13002.26 in chips) 
Seat 4: Coco98 ($10000 in chips) 
Seat 5: tabby20 ($32530.54 in chips) 
Coco98: posts small blind $50
tabby20: posts big blind $100
SPARTANKING0007: posts big blind $100
*** HOLE CARDS ***
Dealt to Lucifer999 [Kc 8d]
Lucifer999: folds
SPARTANKING0007: checks
Mpr@59 : folds
Coco98: calls $50
tabby20: raises $300.00 to $400
SPARTANKING0007: folds
Coco98: folds
Uncalled bet ($300) returned to tabby20
tabby20: doesn't show hand
tabby20 collected $300 from pot
*** SUMMARY ***
Total pot $300.00 | Rake $0
Board []
Seat 1: Lucifer999 folded before Flop (didn't bet)
Seat 2: SPARTANKING0007 folded before Flop
Seat 3: Mpr@59  (button) folded before Flop (didn't bet)
Seat 4: Coco98 (small blind) folded before Flop
Seat 5: tabby20 (big blind) collected ($300)



PokerStars Game #00327550425: Hold'em No Limit ($10/$25 USD) - 2022/04/30 11:50:45 ET
Table 'Hold'em (Min 500Max 2500)  1282' 6-max Seat #6 is the button
Seat 2: jas8k ($2430.19 in chips) 
Seat 3: Vanquish01 ($500 in chips) 
Seat 4: fishfry123 ($888.23 in chips) 
Seat 5: Lucifer999 ($9563.6 in chips) 
Seat 6: devi7 ($5924.66 in chips) 
jas8k: posts small blind $10
Lucifer999: posts big blind $25
*** HOLE CARDS ***
Dealt to Lucifer999 [7h 9s]
devi7: folds
jas8k: calls $15
Lucifer999: raises $65.00 to $90
jas8k: calls $65
*** FLOP *** [9d Ks 2h]
jas8k: bets $127.91
Lucifer999: calls $127.91
*** TURN *** [9d Ks 2h] [3s]
jas8k: bets $206.5
Lucifer999: calls $206.5
*** RIVER *** [9d Ks 2h 3s] [4d]
jas8k: bets $2005.78
Lucifer999: folds
Uncalled bet ($2005.78) returned to jas8k
jas8k: doesn't show hand
jas8k collected $804.3 from pot
*** SUMMARY ***
Total pot $848.82 | Rake $44.52
Board [9d Ks 2h 3s 4d]
Seat 2: jas8k (small blind) collected ($804.3)
Seat 5: Lucifer999 (big blind) folded on the River
Seat 6: devi7 (button) folded before Flop (didn't bet)



PokerStars Game #00327550573: Hold'em No Limit ($25/$50 USD) - 2022/04/30 11:51:33 ET
Table 'Hold'em (Min 1K Max 5K)   216' 6-max Seat #6 is the button
Seat 1: Lucifer999 ($14238.35 in chips) 
Seat 6: akshark108 ($350.97 in chips) 
akshark108: posts small blind $25
Lucifer999: posts big blind $50
*** HOLE CARDS ***
Dealt to Lucifer999 [6c Ad]
akshark108: raises $300.97 to $350.97
Lucifer999: calls $300.97
*** FLOP *** [3c 5s Ac]
*** FLOP *** [As 4c 9d]
*** TURN *** [3c 5s Ac] [Kd]
*** TURN *** [3c 5s Ac] [7h]
*** RIVER *** [3c 5s Ac Kd] [8d]
*** RIVER *** [3c 5s Ac Kd] [6h]
*** SHOW DOWN ***
Lucifer999: shows [6c Ad] (Two pairs, AA66)
akshark108: shows [Jh 8h] (High card, A)
Lucifer999 collected $335.2 from pot
Lucifer999 collected $335.2 from pot
*** SUMMARY ***
Total pot $701.94 | Rake $31.54
Board [3c 5s Ac Kd 8d]
Seat 1: Lucifer999  (big blind) showed [6c Ad] and won ($335.2) with Two pairs, AA66
Seat 6: akshark108 (button) (small blind) showed [Jh 8h] and lost with High card, A



PokerStars Game #00327550613: Hold'em No Limit ($10/$25 USD) - 2022/04/30 11:51:46 ET
Table 'Hold'em (Min 500Max 2500)  1282' 6-max Seat #2 is the button
Seat 2: jas8k ($2810.08 in chips) 
Seat 3: Vanquish01 ($500 in chips) 
Seat 4: fishfry123 ($888.23 in chips) 
Seat 5: Lucifer999 ($9139.19 in chips) 
Seat 6: devi7 ($5924.66 in chips) 
Lucifer999: posts small blind $10
devi7: posts big blind $25
*** HOLE CARDS ***
Dealt to Lucifer999 [Kh 6c]
jas8k: folds
Lucifer999: folds
Uncalled bet ($15) returned to devi7
devi7: doesn't show hand
devi7 collected $20 from pot
*** SUMMARY ***
Total pot $20.00 | Rake $0
Board []
Seat 2: jas8k (button) folded before Flop (didn't bet)
Seat 5: Lucifer999 (small blind) folded before Flop
Seat 6: devi7 (big blind) collected ($20)



PokerStars Game #00327550504: Hold'em No Limit ($10/$25 USD) - 2022/04/30 11:51:10 ET
Table 'Hold'em (Min 500Max 2500) 1001' 6-max Seat #6 is the button
Seat 2: Millie ($2644.09 in chips) 
Seat 3: KehKeLungaAA ($2710.27 in chips) 
Seat 4: devi7 ($2356.76 in chips) 
Seat 5: Lucifer999 ($3592.52 in chips) 
Seat 6: spidy02 ($3678.73 in chips) 
KehKeLungaAA: posts small blind $10
devi7: posts big blind $25
*** HOLE CARDS ***
Dealt to Lucifer999 [4s Qs]
Lucifer999: folds
spidy02: folds
KehKeLungaAA: raises $48.33 to $73.33
devi7: calls $48.33
*** FLOP *** [3h Jc Ac]
KehKeLungaAA: checks
devi7: checks
*** TURN *** [3h Jc Ac] [Jh]
KehKeLungaAA: bets $69
devi7: calls $69
*** RIVER *** [3h Jc Ac Jh] [Ah]
KehKeLungaAA: checks
devi7: bets $125
KehKeLungaAA: raises $285.00 to $410
devi7: calls $285
*** SHOW DOWN ***
KehKeLungaAA: shows [As Kd] (Full house, AAAJJ)
devi7: shows [9h Ad] (Full house, AAAJJ)
KehKeLungaAA collected $520.85 from pot
devi7 collected $520.85 from pot
*** SUMMARY ***
Total pot $1104.66 | Rake $62.96
Board [3h Jc Ac Jh Ah]
Seat 3: KehKeLungaAA  (small blind) showed [As Kd] and won ($520.85) with Full house, AAAJJ
Seat 4: devi7  (big blind) showed [9h Ad] and won ($520.85) with Full house, AAAJJ
Seat 5: Lucifer999 folded before Flop (didn't bet)
Seat 6: spidy02 (button) folded before Flop (didn't bet)



PokerStars Game #00327550608: Hold'em No Limit ($50/$100 USD) - 2022/04/30 11:51:44 ET
Table 'Hold'em (Min 25KMax 10K)    69' 6-max Seat #4 is the button
Seat 1: Lucifer999 ($23065.51 in chips) 
Seat 3: Mpr@59  ($13002.26 in chips) 
Seat 4: Coco98 ($10000 in chips) 
Seat 5: tabby20 ($32730.54 in chips) 
tabby20: posts small blind $50
Lucifer999: posts big blind $100
*** HOLE CARDS ***
Dealt to Lucifer999 [Ah Qc]
Mpr@59 : folds
Coco98: raises $9900.00 to $10000
tabby20: folds
Lucifer999: calls $9900
*** FLOP *** [9h 4h 5c]
*** FLOP *** [5d Js 3h]
*** TURN *** [9h 4h 5c] [8c]
*** TURN *** [9h 4h 5c] [Td]
*** RIVER *** [9h 4h 5c 8c] [Ad]
*** RIVER *** [9h 4h 5c 8c] [2c]
*** SHOW DOWN ***
Lucifer999: shows [Ah Qc] (High card, A)
Coco98: shows [Ac 7c] (High card, A)
Lucifer999 collected $9805 from pot
Lucifer999 collected $9805 from pot
*** SUMMARY ***
Total pot $20050.00 | Rake $440
Board [9h 4h 5c 8c Ad]
Seat 1: Lucifer999  (big blind) showed [Ah Qc] and won ($9805) with High card, A
Seat 3: Mpr@59  folded before Flop (didn't bet)
Seat 4: Coco98 (button) showed [Ac 7c] and lost with High card, A
Seat 5: tabby20 (small blind) folded before Flop



PokerStars Game #00327550695: Hold'em No Limit ($10/$25 USD) - 2022/04/30 11:52:13 ET
Table 'Hold'em (Min 500Max 2500) 1001' 6-max Seat #3 is the button
Seat 1: Mastkalandar ($500 in chips) 
Seat 3: KehKeLungaAA ($2678.79 in chips) 
Seat 4: devi7 ($2325.28 in chips) 
Seat 5: Lucifer999 ($3592.52 in chips) 
Seat 6: spidy02 ($3678.73 in chips) 
devi7: posts small blind $10
Lucifer999: posts big blind $25
*** HOLE CARDS ***
Dealt to Lucifer999 [6d 2d]
spidy02: folds
KehKeLungaAA: raises $38.75 to $63.75
devi7: folds
Lucifer999: folds
Uncalled bet ($38.75) returned to KehKeLungaAA
KehKeLungaAA: doesn't show hand
KehKeLungaAA collected $60 from pot
*** SUMMARY ***
Total pot $60.00 | Rake $0
Board []
Seat 3: KehKeLungaAA (button) collected ($60)
Seat 4: devi7 (small blind) folded before Flop
Seat 5: Lucifer999 (big blind) folded before Flop
Seat 6: spidy02 folded before Flop (didn't bet)



PokerStars Game #00327550645: Hold'em No Limit ($10/$25 USD) - 2022/04/30 11:51:56 ET
Table 'Hold'em (Min 500Max 2500)  1282' 6-max Seat #5 is the button
Seat 2: jas8k ($2810.08 in chips) 
Seat 3: Vanquish01 ($500 in chips) 
Seat 4: fishfry123 ($888.23 in chips) 
Seat 5: Lucifer999 ($9129.19 in chips) 
Seat 6: devi7 ($5934.66 in chips) 
devi7: posts small blind $10
jas8k: posts big blind $25
*** HOLE CARDS ***
Dealt to Lucifer999 [6d As]
Vanquish01: checks
Lucifer999: raises $65.00 to $90
devi7: calls $80
jas8k: folds
Vanquish01: folds
*** FLOP *** [5s 4h 3d]
devi7: checks
Lucifer999: bets $105
devi7: folds
Uncalled bet ($105) returned to Lucifer999
Lucifer999: doesn't show hand
Lucifer999 collected $225.4 from pot
*** SUMMARY ***
Total pot $240.00 | Rake $14.6
Board [5s 4h 3d]
Seat 2: jas8k (big blind) folded before Flop
Seat 3: Vanquish01 folded before Flop (didn't bet)
Seat 5: Lucifer999 (button) collected ($225.4)
Seat 6: devi7 (small blind) folded on the Flop



PokerStars Game #00327550723: Hold'em No Limit ($50/$100 USD) - 2022/04/30 11:52:21 ET
Table 'Hold'em (Min 25KMax 10K)    69' 6-max Seat #5 is the button
Seat 1: Lucifer999 ($32675.51 in chips) 
Seat 3: Mpr@59  ($13002.26 in chips) 
Seat 4: Coco98 ($10000 in chips) 
Seat 5: tabby20 ($32680.54 in chips) 
Seat 6: manny007 ($2500 in chips) 
Lucifer999: posts small blind $50
Mpr@59 : posts big blind $100
*** HOLE CARDS ***
Dealt to Lucifer999 [Tc 6c]
Coco98: folds
tabby20: raises $200.00 to $300
Lucifer999: folds
Mpr@59 : folds
Uncalled bet ($200) returned to tabby20
tabby20: doesn't show hand
tabby20 collected $250 from pot
*** SUMMARY ***
Total pot $250.00 | Rake $0
Board []
Seat 1: Lucifer999 (small blind) folded before Flop
Seat 3: Mpr@59  (big blind) folded before Flop
Seat 4: Coco98 folded before Flop (didn't bet)
Seat 5: tabby20 (button) collected ($250)



PokerStars Game #00327550794: Hold'em No Limit ($50/$100 USD) - 2022/04/30 11:52:47 ET
Table 'Hold'em (Min 25KMax 10K)    69' 6-max Seat #1 is the button
Seat 1: Lucifer999 ($32625.51 in chips) 
Seat 2: TheWay ($2500 in chips) 
Seat 3: Mpr@59  ($12902.26 in chips) 
Seat 4: Coco98 ($10000 in chips) 
Seat 5: tabby20 ($32830.54 in chips) 
Seat 6: manny007 ($2500 in chips) 
Mpr@59 : posts small blind $50
Coco98: posts big blind $100
manny007: posts small & big blinds $150
*** HOLE CARDS ***
Dealt to Lucifer999 [5h Ac]
tabby20: folds
manny007: checks
Lucifer999: folds
Mpr@59 : calls $50
Coco98: raises $300.00 to $450
manny007: folds
Mpr@59 : folds
Uncalled bet ($350) returned to Coco98
Coco98: doesn't show hand
Coco98 collected $350 from pot
*** SUMMARY ***
Total pot $350.00 | Rake $0
Board []
Seat 1: Lucifer999 (button) folded before Flop (didn't bet)
Seat 3: Mpr@59  (small blind) folded before Flop
Seat 4: Coco98 (big blind) collected ($350)
Seat 5: tabby20 folded before Flop (didn't bet)
Seat 6: manny007 folded before Flop



PokerStars Game #00327550763: Hold'em No Limit ($10/$25 USD) - 2022/04/30 11:52:38 ET
Table 'Hold'em (Min 500Max 2500) 1001' 6-max Seat #4 is the button
Seat 1: Mastkalandar ($500 in chips) 
Seat 3: KehKeLungaAA ($2713.79 in chips) 
Seat 4: devi7 ($2315.28 in chips) 
Seat 5: Lucifer999 ($3567.52 in chips) 
Seat 6: spidy02 ($3678.73 in chips) 
Lucifer999: posts small blind $10
spidy02: posts big blind $25
*** HOLE CARDS ***
Dealt to Lucifer999 [As 6h]
devi7: folds
Lucifer999: folds
spidy02: calls $25
KehKeLungaAA: checks
*** FLOP *** [5s 7s 8h]
spidy02: checks
KehKeLungaAA: bets $77.42
spidy02: folds
Uncalled bet ($77.42) returned to KehKeLungaAA
KehKeLungaAA: doesn't show hand
KehKeLungaAA collected $103.23 from pot
*** SUMMARY ***
Total pot $110.00 | Rake $6.77
Board [5s 7s 8h]
Seat 3: KehKeLungaAA collected ($103.23)
Seat 4: devi7 (button) folded before Flop (didn't bet)
Seat 5: Lucifer999 (small blind) folded before Flop
Seat 6: spidy02 (big blind) folded on the Flop



PokerStars Game #00327550779: Hold'em No Limit ($10/$25 USD) - 2022/04/30 11:52:43 ET
Table 'Hold'em (Min 500Max 2500)  1282' 6-max Seat #6 is the button
Seat 1: JaspritBumrah786 ($500 in chips) 
Seat 2: jas8k ($2785.08 in chips) 
Seat 3: Vanquish01 ($465 in chips) 
Seat 4: fishfry123 ($888.23 in chips) 
Seat 5: Lucifer999 ($9264.59 in chips) 
Seat 6: devi7 ($5844.66 in chips) 
jas8k: posts small blind $10
Vanquish01: posts big blind $25
*** HOLE CARDS ***
Dealt to Lucifer999 [Th Qs]
Lucifer999: folds
devi7: raises $50.00 to $75
jas8k: folds
Vanquish01: folds
Uncalled bet ($50) returned to devi7
devi7: doesn't show hand
devi7 collected $60 from pot
*** SUMMARY ***
Total pot $60.00 | Rake $0
Board []
Seat 2: jas8k (small blind) folded before Flop
Seat 3: Vanquish01 (big blind) folded before Flop
Seat 5: Lucifer999 folded before Flop (didn't bet)
Seat 6: devi7 (button) collected ($60)



PokerStars Game #00327550874: Hold'em No Limit ($10/$25 USD) - 2022/04/30 11:53:12 ET
Table 'Hold'em (Min 500Max 2500) 1001' 6-max Seat #5 is the button
Seat 1: Mastkalandar ($500 in chips) 
Seat 3: KehKeLungaAA ($2767.02 in chips) 
Seat 4: devi7 ($2315.28 in chips) 
Seat 5: Lucifer999 ($3557.52 in chips) 
Seat 6: spidy02 ($3628.73 in chips) 
spidy02: posts small blind $10
Mastkalandar: posts big blind $25
*** HOLE CARDS ***
Dealt to Lucifer999 [As 5d]
devi7: folds
Lucifer999: folds
spidy02: calls $40
Mastkalandar: raises $150.00 to $200
KehKeLungaAA: folds
spidy02: folds
Uncalled bet ($150) returned to Mastkalandar
Mastkalandar: doesn't show hand
Mastkalandar collected $150 from pot
*** SUMMARY ***
Total pot $150.00 | Rake $0
Board []
Seat 1: Mastkalandar (big blind) collected ($150)
Seat 3: KehKeLungaAA folded before Flop (didn't bet)
Seat 4: devi7 folded before Flop (didn't bet)
Seat 5: Lucifer999 (button) folded before Flop (didn't bet)
Seat 6: spidy02 (small blind) folded before Flop



PokerStars Game #00327550870: Hold'em No Limit ($50/$100 USD) - 2022/04/30 11:53:11 ET
Table 'Hold'em (Min 25KMax 10K)    69' 6-max Seat #3 is the button
Seat 1: Lucifer999 ($32625.51 in chips) 
Seat 2: TheWay ($2500 in chips) 
Seat 3: Mpr@59  ($12802.26 in chips) 
Seat 4: Coco98 ($10250 in chips) 
Seat 5: tabby20 ($32830.54 in chips) 
Seat 6: manny007 ($2350 in chips) 
Coco98: posts small blind $50
tabby20: posts big blind $100
TheWay: posts big blind $100
*** HOLE CARDS ***
Dealt to Lucifer999 [4d 3s]
manny007: calls $100
Lucifer999: folds
TheWay: checks
Mpr@59 : calls $100
Coco98: calls $50
tabby20: checks
*** FLOP *** [Ad 9d 6h]
Coco98: checks
tabby20: bets $400
manny007: folds
TheWay: folds
Mpr@59 : folds
Coco98: folds
Uncalled bet ($400) returned to tabby20
tabby20: doesn't show hand
tabby20 collected $478 from pot
*** SUMMARY ***
Total pot $500.00 | Rake $22
Board [Ad 9d 6h]
Seat 1: Lucifer999 folded before Flop (didn't bet)
Seat 2: TheWay folded on the Flop
Seat 3: Mpr@59  (button) folded on the Flop
Seat 4: Coco98 (small blind) folded on the Flop
Seat 5: tabby20 (big blind) collected ($478)
Seat 6: manny007 folded on the Flop



PokerStars Game #00327550972: Hold'em No Limit ($50/$100 USD) - 2022/04/30 11:53:47 ET
Table 'Hold'em (Min 25KMax 10K)    69' 6-max Seat #4 is the button
Seat 1: Lucifer999 ($32625.51 in chips) 
Seat 2: TheWay ($2400 in chips) 
Seat 3: Mpr@59  ($12702.26 in chips) 
Seat 4: Coco98 ($10150 in chips) 
Seat 5: tabby20 ($33208.54 in chips) 
Seat 6: manny007 ($2250 in chips) 
tabby20: posts small blind $50
manny007: posts big blind $100
*** HOLE CARDS ***
Dealt to Lucifer999 [Td 2d]
Lucifer999: folds
TheWay: folds
Mpr@59 : raises $250.00 to $350
Coco98: folds
tabby20: folds
manny007: folds
Uncalled bet ($250) returned to Mpr@59 
Mpr@59 : doesn't show hand
Mpr@59  collected $250 from pot
*** SUMMARY ***
Total pot $250.00 | Rake $0
Board []
Seat 1: Lucifer999 folded before Flop (didn't bet)
Seat 2: TheWay folded before Flop (didn't bet)
Seat 3: Mpr@59  collected ($250)
Seat 4: Coco98 (button) folded before Flop (didn't bet)
Seat 5: tabby20 (small blind) folded before Flop
Seat 6: manny007 (big blind) folded before Flop



PokerStars Game #00327550962: Hold'em No Limit ($10/$25 USD) - 2022/04/30 11:53:43 ET
Table 'Hold'em (Min 500Max 2500) 1001' 6-max Seat #6 is the button
Seat 1: Mastkalandar ($600 in chips) 
Seat 2: movetome ($500 in chips) 
Seat 3: KehKeLungaAA ($2717.02 in chips) 
Seat 4: devi7 ($2315.28 in chips) 
Seat 5: Lucifer999 ($3557.52 in chips) 
Seat 6: spidy02 ($3578.73 in chips) 
Mastkalandar: posts small blind $10
KehKeLungaAA: posts big blind $25
*** HOLE CARDS ***
Dealt to Lucifer999 [9c Js]
devi7: raises $50.00 to $75
Lucifer999: folds
spidy02: folds
Mastkalandar: raises $525.00 to $600
KehKeLungaAA: folds
devi7: folds
Uncalled bet ($525) returned to Mastkalandar
Mastkalandar: doesn't show hand
Mastkalandar collected $175 from pot
*** SUMMARY ***
Total pot $175.00 | Rake $0
Board []
Seat 1: Mastkalandar (small blind) collected ($175)
Seat 3: KehKeLungaAA (big blind) folded before Flop
Seat 4: devi7 folded before Flop
Seat 5: Lucifer999 folded before Flop (didn't bet)
Seat 6: spidy02 (button) folded before Flop (didn't bet)



PokerStars Game #00327550878: Hold'em No Limit ($10/$25 USD) - 2022/04/30 11:53:13 ET
Table 'Hold'em (Min 500Max 2500)  1282' 6-max Seat #2 is the button
Seat 1: JaspritBumrah786 ($500 in chips) 
Seat 2: jas8k ($2775.08 in chips) 
Seat 3: Vanquish01 ($440 in chips) 
Seat 4: fishfry123 ($888.23 in chips) 
Seat 5: Lucifer999 ($9264.59 in chips) 
Seat 6: devi7 ($5879.66 in chips) 
Vanquish01: posts small blind $10
Lucifer999: posts big blind $25
*** HOLE CARDS ***
Dealt to Lucifer999 [4s Jd]
devi7: folds
jas8k: raises $25.00 to $50
Vanquish01: calls $40
Lucifer999: folds
*** FLOP *** [Td Ts Qh]
Vanquish01: checks
jas8k: checks
*** TURN *** [Td Ts Qh] [As]
Vanquish01: checks
jas8k: checks
*** RIVER *** [Td Ts Qh As] [Kh]
Vanquish01: bets $25
jas8k: folds
Uncalled bet ($25) returned to Vanquish01
Vanquish01: doesn't show hand
Vanquish01 collected $117.44 from pot
*** SUMMARY ***
Total pot $125.00 | Rake $7.56
Board [Td Ts Qh As Kh]
Seat 2: jas8k (button) folded on the River
Seat 3: Vanquish01 (small blind) collected ($117.44)
Seat 5: Lucifer999 (big blind) folded before Flop
Seat 6: devi7 folded before Flop (didn't bet)



PokerStars Game #00327551066: Hold'em No Limit ($10/$25 USD) - 2022/04/30 11:54:19 ET
Table 'Hold'em (Min 500Max 2500)  1282' 6-max Seat #3 is the button
Seat 1: JaspritBumrah786 ($500 in chips) 
Seat 2: jas8k ($2725.08 in chips) 
Seat 3: Vanquish01 ($507.44 in chips) 
Seat 4: fishfry123 ($888.23 in chips) 
Seat 5: Lucifer999 ($9239.59 in chips) 
Seat 6: devi7 ($5879.66 in chips) 
Lucifer999: posts small blind $10
devi7: posts big blind $25
*** HOLE CARDS ***
Dealt to Lucifer999 [Th 6h]
jas8k: raises $25.00 to $50
Vanquish01: folds
Lucifer999: folds
devi7: folds
Uncalled bet ($25) returned to jas8k
jas8k: doesn't show hand
jas8k collected $60 from pot
*** SUMMARY ***
Total pot $60.00 | Rake $0
Board []
Seat 2: jas8k collected ($60)
Seat 3: Vanquish01 (button) folded before Flop (didn't bet)
Seat 5: Lucifer999 (small blind) folded before Flop
Seat 6: devi7 (big blind) folded before Flop



PokerStars Game #00327551044: Hold'em No Limit ($50/$100 USD) - 2022/04/30 11:54:12 ET
Table 'Hold'em (Min 25KMax 10K)    69' 6-max Seat #5 is the button
Seat 1: Lucifer999 ($32625.51 in chips) 
Seat 2: TheWay ($2400 in chips) 
Seat 3: Mpr@59  ($12852.26 in chips) 
Seat 4: Coco98 ($10150 in chips) 
Seat 5: tabby20 ($33158.54 in chips) 
Seat 6: manny007 ($2150 in chips) 
manny007: posts small blind $50
Lucifer999: posts big blind $100
*** HOLE CARDS ***
Dealt to Lucifer999 [4d Td]
TheWay: folds
Mpr@59 : raises $100.00 to $200
Coco98: folds
tabby20: folds
manny007: folds
Lucifer999: calls $100
*** FLOP *** [Js 7s 5h]
Lucifer999: checks
Mpr@59 : checks
*** TURN *** [Js 7s 5h] [9d]
Lucifer999: bets $350
Mpr@59 : folds
Uncalled bet ($350) returned to Lucifer999
Lucifer999: doesn't show hand
Lucifer999 collected $430.2 from pot
*** SUMMARY ***
Total pot $450.00 | Rake $19.8
Board [Js 7s 5h 9d]
Seat 1: Lucifer999 (big blind) collected ($430.2)
Seat 2: TheWay folded before Flop (didn't bet)
Seat 3: Mpr@59  folded on the Turn
Seat 4: Coco98 folded before Flop (didn't bet)
Seat 5: tabby20 (button) folded before Flop (didn't bet)
Seat 6: manny007 (small blind) folded before Flop



PokerStars Game #00327551126: Hold'em No Limit ($10/$25 USD) - 2022/04/30 11:54:42 ET
Table 'Hold'em (Min 500Max 2500)  1282' 6-max Seat #5 is the button
Seat 1: JaspritBumrah786 ($500 in chips) 
Seat 2: jas8k ($2760.08 in chips) 
Seat 3: Vanquish01 ($507.44 in chips) 
Seat 4: fishfry123 ($888.23 in chips) 
Seat 5: Lucifer999 ($9229.59 in chips) 
Seat 6: devi7 ($5854.66 in chips) 
devi7: posts small blind $10
JaspritBumrah786: posts big blind $25
*** HOLE CARDS ***
Dealt to Lucifer999 [Ad 6h]
jas8k: folds
Vanquish01: folds
Lucifer999: raises $55.00 to $80
devi7: folds
JaspritBumrah786: folds
Uncalled bet ($55) returned to Lucifer999
Lucifer999: doesn't show hand
Lucifer999 collected $60 from pot
*** SUMMARY ***
Total pot $60.00 | Rake $0
Board []
Seat 1: JaspritBumrah786 (big blind) folded before Flop
Seat 2: jas8k folded before Flop (didn't bet)
Seat 3: Vanquish01 folded before Flop (didn't bet)
Seat 5: Lucifer999 (button) collected ($60)
Seat 6: devi7 (small blind) folded before Flop



PokerStars Game #00327551047: Hold'em No Limit ($10/$25 USD) - 2022/04/30 11:54:13 ET
Table 'Hold'em (Min 500Max 2500) 1001' 6-max Seat #1 is the button
Seat 1: Mastkalandar ($2135 in chips) 
Seat 2: movetome ($500 in chips) 
Seat 3: KehKeLungaAA ($2692.02 in chips) 
Seat 4: devi7 ($2240.28 in chips) 
Seat 5: Lucifer999 ($3557.52 in chips) 
Seat 6: spidy02 ($3578.73 in chips) 
KehKeLungaAA: posts small blind $10
devi7: posts big blind $25
*** HOLE CARDS ***
Dealt to Lucifer999 [As 9d]
Lucifer999: folds
spidy02: raises $60.00 to $85
Mastkalandar: calls $85
KehKeLungaAA: folds
devi7: folds
*** FLOP *** [2c 5c 8s]
spidy02: checks
Mastkalandar: bets $150
spidy02: calls $150
*** TURN *** [2c 5c 8s] [2d]
spidy02: checks
Mastkalandar: checks
*** RIVER *** [2c 5c 8s 2d] [Qc]
spidy02: bets $355.12
Mastkalandar: folds
Uncalled bet ($355.12) returned to spidy02
spidy02: doesn't show hand
spidy02 collected $473.49 from pot
*** SUMMARY ***
Total pot $505.00 | Rake $31.51
Board [2c 5c 8s 2d Qc]
Seat 1: Mastkalandar (button) folded on the River
Seat 3: KehKeLungaAA (small blind) folded before Flop
Seat 4: devi7 (big blind) folded before Flop
Seat 5: Lucifer999 folded before Flop (didn't bet)
Seat 6: spidy02 collected ($473.49)



PokerStars Game #00327551179: Hold'em No Limit ($50/$100 USD) - 2022/04/30 11:54:59 ET
Table 'Hold'em (Min 25KMax 10K)    69' 6-max Seat #6 is the button
Seat 1: Lucifer999 ($32855.71 in chips) 
Seat 2: TheWay ($2400 in chips) 
Seat 3: Mpr@59  ($12652.26 in chips) 
Seat 4: Coco98 ($10150 in chips) 
Seat 5: tabby20 ($33158.54 in chips) 
Seat 6: manny007 ($2100 in chips) 
Lucifer999: posts small blind $50
TheWay: posts big blind $100
*** HOLE CARDS ***
Dealt to Lucifer999 [5s 9s]
Mpr@59 : calls $100
Coco98: folds
tabby20: folds
manny007: calls $100
Lucifer999: calls $50
TheWay: raises $200.00 to $300
Mpr@59 : raises $800.00 to $1100
manny007: calls $1000
Lucifer999: folds
TheWay: calls $800
*** FLOP *** [Th 8h Ad]
TheWay: checks
Mpr@59 : bets $3250.4
manny007: calls $1000
TheWay: folds
Uncalled bet ($2250.4) returned to Mpr@59 
*** TURN *** [Th 8h Ad] [9d]
*** TURN *** [Th 8h Ad] [5d]
*** RIVER *** [Th 8h Ad 9d] [4d]
*** RIVER *** [Th 8h Ad 9d] [Qh]
*** SHOW DOWN ***
Mpr@59 : shows [Ts Tc] (Three of a kind, TTT)
manny007: shows [Qd As] (Two pairs, AAQQ)
Mpr@59  collected $2581.2 from pot
Mpr@59  collected $2581.2 from pot
*** SUMMARY ***
Total pot $5400.00 | Rake $237.6
Board [Th 8h Ad 9d 4d]
Seat 1: Lucifer999 (small blind) folded before Flop
Seat 2: TheWay (big blind) folded on the Flop
Seat 3: Mpr@59   showed [Ts Tc] and won ($2581.2) with Three of a kind, TTT
Seat 4: Coco98 folded before Flop (didn't bet)
Seat 5: tabby20 folded before Flop (didn't bet)
Seat 6: manny007 (button) showed [Qd As] and lost with Two pairs, AAQQ



PokerStars Game #00327551214: Hold'em No Limit ($10/$25 USD) - 2022/04/30 11:55:11 ET
Table 'Hold'em (Min 500Max 2500)  1282' 6-max Seat #6 is the button
Seat 1: JaspritBumrah786 ($475 in chips) 
Seat 2: jas8k ($2760.08 in chips) 
Seat 3: Vanquish01 ($507.44 in chips) 
Seat 4: fishfry123 ($888.23 in chips) 
Seat 5: Lucifer999 ($9264.59 in chips) 
Seat 6: devi7 ($5844.66 in chips) 
JaspritBumrah786: posts small blind $10
jas8k: posts big blind $25
*** HOLE CARDS ***
Dealt to Lucifer999 [Ts Qd]
Vanquish01: raises $25.00 to $50
Lucifer999: folds
devi7: folds
JaspritBumrah786: folds
jas8k: calls $25
*** FLOP *** [7c Td 8h]
jas8k: bets $51.62
Vanquish01: calls $51.62
*** TURN *** [7c Td 8h] [4s]
jas8k: bets $150.05
Vanquish01: calls $150.05
*** RIVER *** [7c Td 8h 4s] [Ac]
jas8k: checks
Vanquish01: bets $255.77
jas8k: folds
Uncalled bet ($255.77) returned to Vanquish01
Vanquish01: doesn't show hand
Vanquish01 collected $481.41 from pot
*** SUMMARY ***
Total pot $513.34 | Rake $31.93
Board [7c Td 8h 4s Ac]
Seat 1: JaspritBumrah786 (small blind) folded before Flop
Seat 2: jas8k (big blind) folded on the River
Seat 3: Vanquish01 collected ($481.41)
Seat 5: Lucifer999 folded before Flop (didn't bet)
Seat 6: devi7 (button) folded before Flop (didn't bet)



PokerStars Game #00327551291: Hold'em No Limit ($50/$100 USD) - 2022/04/30 11:55:47 ET
Table 'Hold'em (Min 25KMax 10K)    69' 6-max Seat #1 is the button
Seat 1: Lucifer999 ($32755.71 in chips) 
Seat 2: TheWay ($1300 in chips) 
Seat 3: Mpr@59  ($15714.66 in chips) 
Seat 4: Coco98 ($10150 in chips) 
Seat 5: tabby20 ($33158.54 in chips) 
TheWay: posts small blind $50
Mpr@59 : posts big blind $100
*** HOLE CARDS ***
Dealt to Lucifer999 [4c 2h]
tabby20: raises $250.00 to $350
Lucifer999: folds
TheWay: folds
Mpr@59 : calls $250
*** FLOP *** [8d 5s 3s]
Mpr@59 : checks
tabby20: bets $600
Mpr@59 : folds
Uncalled bet ($600) returned to tabby20
tabby20: doesn't show hand
tabby20 collected $717 from pot
*** SUMMARY ***
Total pot $750.00 | Rake $33
Board [8d 5s 3s]
Seat 1: Lucifer999 (button) folded before Flop (didn't bet)
Seat 2: TheWay (small blind) folded before Flop
Seat 3: Mpr@59  (big blind) folded on the Flop
Seat 5: tabby20 collected ($717)



PokerStars Game #00327551365: Hold'em No Limit ($10/$25 USD) - 2022/04/30 11:56:21 ET
Table 'Hold'em (Min 500Max 2500)  1282' 6-max Seat #1 is the button
Seat 1: JaspritBumrah786 ($2025 in chips) 
Seat 2: jas8k ($2508.41 in chips) 
Seat 3: Vanquish01 ($737.18 in chips) 
Seat 4: fishfry123 ($888.23 in chips) 
Seat 5: Lucifer999 ($9264.59 in chips) 
Seat 6: devi7 ($5844.66 in chips) 
jas8k: posts small blind $10
Vanquish01: posts big blind $25
*** HOLE CARDS ***
Dealt to Lucifer999 [2c Tc]
Lucifer999: folds
devi7: raises $50.00 to $75
JaspritBumrah786: folds
jas8k: folds
Vanquish01: calls $50
*** FLOP *** [3d As Jd]
Vanquish01: checks
devi7: bets $75
Vanquish01: folds
Uncalled bet ($75) returned to devi7
devi7: doesn't show hand
devi7 collected $150.6 from pot
*** SUMMARY ***
Total pot $160.00 | Rake $9.4
Board [3d As Jd]
Seat 1: JaspritBumrah786 (button) folded before Flop (didn't bet)
Seat 2: jas8k (small blind) folded before Flop
Seat 3: Vanquish01 (big blind) folded on the Flop
Seat 5: Lucifer999 folded before Flop (didn't bet)
Seat 6: devi7 collected ($150.6)



PokerStars Game #00327551216: Hold'em No Limit ($10/$25 USD) - 2022/04/30 11:55:12 ET
Table 'Hold'em (Min 500Max 2500) 1001' 6-max Seat #3 is the button
Seat 1: Mastkalandar ($2025 in chips) 
Seat 2: movetome ($500 in chips) 
Seat 3: KehKeLungaAA ($2682.02 in chips) 
Seat 4: devi7 ($2215.28 in chips) 
Seat 5: Lucifer999 ($3557.52 in chips) 
Seat 6: spidy02 ($3817.22 in chips) 
devi7: posts small blind $10
Lucifer999: posts big blind $25
*** HOLE CARDS ***
Dealt to Lucifer999 [2s 7s]
spidy02: calls $25
Mastkalandar: folds
KehKeLungaAA: calls $25
devi7: folds
Lucifer999: checks
*** FLOP *** [9s 2c 9d]
Lucifer999: checks
spidy02: checks
KehKeLungaAA: bets $25
Lucifer999: calls $25
spidy02: raises $25.00 to $50
KehKeLungaAA: calls $25
Lucifer999: calls $25
*** TURN *** [9s 2c 9d] [Ad]
Lucifer999: checks
spidy02: checks
KehKeLungaAA: bets $80.34
Lucifer999: folds
spidy02: calls $80.34
*** RIVER *** [9s 2c 9d Ad] [4s]
spidy02: bets $278.96
KehKeLungaAA: raises $627.66 to $906.62
spidy02: calls $627.66
*** SHOW DOWN ***
KehKeLungaAA: shows [9h Qc] (Three of a kind, 999)
spidy02: shows [Kd 9c] (Three of a kind, 999)
spidy02 collected $2088 from pot
*** SUMMARY ***
Total pot $2208.92 | Rake $120.92
Board [9s 2c 9d Ad 4s]
Seat 1: Mastkalandar folded before Flop (didn't bet)
Seat 3: KehKeLungaAA (button) showed [9h Qc] and lost with Three of a kind, 999
Seat 4: devi7 (small blind) folded before Flop
Seat 5: Lucifer999 (big blind) folded on the Turn
Seat 6: spidy02  showed [Kd 9c] and won ($2088) with Three of a kind, 999



PokerStars Game #00327551372: Hold'em No Limit ($50/$100 USD) - 2022/04/30 11:56:24 ET
Table 'Hold'em (Min 25KMax 10K)    69' 6-max Seat #2 is the button
Seat 1: Lucifer999 ($32755.71 in chips) 
Seat 2: TheWay ($1250 in chips) 
Seat 3: Mpr@59  ($15364.66 in chips) 
Seat 4: Coco98 ($10150 in chips) 
Seat 5: tabby20 ($33525.54 in chips) 
Mpr@59 : posts small blind $50
Coco98: posts big blind $100
*** HOLE CARDS ***
Dealt to Lucifer999 [7d Qh]
tabby20: raises $200.00 to $300
Lucifer999: folds
TheWay: calls $300
Mpr@59 : folds
Coco98: folds
*** FLOP *** [Jd 3d Ks]
tabby20: bets $33225.54
TheWay: calls $950
Uncalled bet ($32275.54) returned to tabby20
*** TURN *** [Jd 3d Ks] [Qs]
*** TURN *** [Jd 3d Ks] [Td]
*** RIVER *** [Jd 3d Ks Qs] [3s]
*** RIVER *** [Jd 3d Ks Qs] [9d]
*** SHOW DOWN ***
TheWay: shows [As Th] (Pair, TT)
tabby20: shows [Tc Kc] (Two pairs, KKTT)
TheWay collected $1266.7 from pot
tabby20 collected $1266.7 from pot
*** SUMMARY ***
Total pot $2650.00 | Rake $116.6
Board [Jd 3d Ks Qs 3s]
Seat 1: Lucifer999 folded before Flop (didn't bet)
Seat 2: TheWay  (button) showed [As Th] and won ($1266.7) with Pair, TT
Seat 3: Mpr@59  (small blind) folded before Flop
Seat 4: Coco98 (big blind) folded before Flop
Seat 5: tabby20  showed [Tc Kc] and won ($1266.7) with Two pairs, KKTT



PokerStars Game #00327551454: Hold'em No Limit ($10/$25 USD) - 2022/04/30 11:57:01 ET
Table 'Hold'em (Min 500Max 2500)  1282' 6-max Seat #2 is the button
Seat 1: JaspritBumrah786 ($2025 in chips) 
Seat 2: jas8k ($2498.41 in chips) 
Seat 3: Vanquish01 ($662.18 in chips) 
Seat 5: Lucifer999 ($9264.59 in chips) 
Seat 6: devi7 ($5920.26 in chips) 
Vanquish01: posts small blind $10
Lucifer999: posts big blind $25
*** HOLE CARDS ***
Dealt to Lucifer999 [Td 5d]
devi7: folds
JaspritBumrah786: raises $50.00 to $75
jas8k: folds
Vanquish01: folds
Lucifer999: folds
Uncalled bet ($50) returned to JaspritBumrah786
JaspritBumrah786: doesn't show hand
JaspritBumrah786 collected $60 from pot
*** SUMMARY ***
Total pot $60.00 | Rake $0
Board []
Seat 1: JaspritBumrah786 collected ($60)
Seat 2: jas8k (button) folded before Flop (didn't bet)
Seat 3: Vanquish01 (small blind) folded before Flop
Seat 5: Lucifer999 (big blind) folded before Flop
Seat 6: devi7 folded before Flop (didn't bet)



PokerStars Game #00327551538: Hold'em No Limit ($10/$25 USD) - 2022/04/30 11:57:42 ET
Table 'Hold'em (Min 500Max 2500)  1282' 6-max Seat #3 is the button
Seat 1: JaspritBumrah786 ($2135 in chips) 
Seat 2: jas8k ($2498.41 in chips) 
Seat 3: Vanquish01 ($652.18 in chips) 
Seat 5: Lucifer999 ($9239.59 in chips) 
Seat 6: devi7 ($5920.26 in chips) 
Lucifer999: posts small blind $10
devi7: posts big blind $25
*** HOLE CARDS ***
Dealt to Lucifer999 [3c Ks]
JaspritBumrah786: folds
Vanquish01: folds
Lucifer999: folds
Uncalled bet ($15) returned to devi7
devi7: doesn't show hand
devi7 collected $20 from pot
*** SUMMARY ***
Total pot $20.00 | Rake $0
Board []
Seat 1: JaspritBumrah786 folded before Flop (didn't bet)
Seat 3: Vanquish01 (button) folded before Flop (didn't bet)
Seat 5: Lucifer999 (small blind) folded before Flop
Seat 6: devi7 (big blind) collected ($20)



PokerStars Game #00327551457: Hold'em No Limit ($50/$100 USD) - 2022/04/30 11:57:04 ET
Table 'Hold'em (Min 25KMax 10K)    69' 6-max Seat #3 is the button
Seat 1: Lucifer999 ($32755.71 in chips) 
Seat 2: TheWay ($1266.7 in chips) 
Seat 3: Mpr@59  ($15314.66 in chips) 
Seat 4: Coco98 ($10050 in chips) 
Seat 5: tabby20 ($33542.24 in chips) 
Coco98: posts small blind $50
tabby20: posts big blind $100
*** HOLE CARDS ***
Dealt to Lucifer999 [5d 6c]
Lucifer999: folds
TheWay: calls $100
Mpr@59 : calls $100
Coco98: raises $450.00 to $550
tabby20: folds
TheWay: calls $450
Mpr@59 : folds
*** FLOP *** [3h 3d Tc]
Coco98: bets $1242.8
TheWay: folds
Uncalled bet ($1242.8) returned to Coco98
Coco98: doesn't show hand
Coco98 collected $1242.8 from pot
*** SUMMARY ***
Total pot $1300.00 | Rake $57.2
Board [3h 3d Tc]
Seat 1: Lucifer999 folded before Flop (didn't bet)
Seat 2: TheWay folded on the Flop
Seat 3: Mpr@59  (button) folded before Flop
Seat 4: Coco98 (small blind) collected ($1242.8)
Seat 5: tabby20 (big blind) folded before Flop



PokerStars Game #00327551452: Hold'em No Limit ($10/$25 USD) - 2022/04/30 11:57:01 ET
Table 'Hold'em (Min 500Max 2500) 1001' 6-max Seat #4 is the button
Seat 1: Mastkalandar ($2025 in chips) 
Seat 2: movetome ($500 in chips) 
Seat 3: KehKeLungaAA ($1620.06 in chips) 
Seat 4: devi7 ($2205.28 in chips) 
Seat 5: Lucifer999 ($3482.52 in chips) 
Seat 6: spidy02 ($4843.26 in chips) 
Lucifer999: posts small blind $10
spidy02: posts big blind $25
*** HOLE CARDS ***
Dealt to Lucifer999 [9h 9c]
Mastkalandar: raises $50.00 to $75
KehKeLungaAA: folds
devi7: folds
Lucifer999: calls $65
spidy02: calls $50
*** FLOP *** [8d Td Ts]
Lucifer999: checks
spidy02: bets $158.39
Mastkalandar: calls $158.39
Lucifer999: folds
*** TURN *** [8d Td Ts] [Tc]
spidy02: bets $254.19
Mastkalandar: calls $254.19
*** RIVER *** [8d Td Ts Tc] [9s]
spidy02: checks
Mastkalandar: checks
*** SHOW DOWN ***
spidy02: shows [Kc Jh] (Three of a kind, TTT)
Mastkalandar: shows [Qc Jc] (Straight, Q-8)
Mastkalandar collected $990.04 from pot
*** SUMMARY ***
Total pot $1050.16 | Rake $60.12
Board [8d Td Ts Tc 9s]
Seat 1: Mastkalandar  showed [Qc Jc] and won ($990.04) with Straight, Q-8
Seat 3: KehKeLungaAA folded before Flop (didn't bet)
Seat 4: devi7 (button) folded before Flop (didn't bet)
Seat 5: Lucifer999 (small blind) folded on the Flop
Seat 6: spidy02 (big blind) showed [Kc Jh] and lost with Three of a kind, TTT



PokerStars Game #00327551570: Hold'em No Limit ($10/$25 USD) - 2022/04/30 11:57:54 ET
Table 'Hold'em (Min 500Max 2500)  1282' 6-max Seat #5 is the button
Seat 1: JaspritBumrah786 ($2135 in chips) 
Seat 2: jas8k ($2498.41 in chips) 
Seat 3: Vanquish01 ($652.18 in chips) 
Seat 5: Lucifer999 ($9229.59 in chips) 
Seat 6: devi7 ($5930.26 in chips) 
devi7: posts small blind $10
JaspritBumrah786: posts big blind $25
*** HOLE CARDS ***
Dealt to Lucifer999 [6d 5c]
jas8k: folds
Vanquish01: folds
Lucifer999: raises $55.00 to $80
devi7: folds
JaspritBumrah786: folds
Uncalled bet ($55) returned to Lucifer999
Lucifer999: doesn't show hand
Lucifer999 collected $60 from pot
*** SUMMARY ***
Total pot $60.00 | Rake $0
Board []
Seat 1: JaspritBumrah786 (big blind) folded before Flop
Seat 2: jas8k folded before Flop (didn't bet)
Seat 3: Vanquish01 folded before Flop (didn't bet)
Seat 5: Lucifer999 (button) collected ($60)
Seat 6: devi7 (small blind) folded before Flop



PokerStars Game #00327551586: Hold'em No Limit ($10/$25 USD) - 2022/04/30 11:58:01 ET
Table 'Hold'em (Min 500Max 2500) 1001' 6-max Seat #5 is the button
Seat 1: Mastkalandar ($2527.46 in chips) 
Seat 2: movetome ($500 in chips) 
Seat 3: KehKeLungaAA ($1620.06 in chips) 
Seat 4: devi7 ($2205.28 in chips) 
Seat 5: Lucifer999 ($3407.52 in chips) 
Seat 6: spidy02 ($4355.68 in chips) 
spidy02: posts small blind $10
Mastkalandar: posts big blind $25
*** HOLE CARDS ***
Dealt to Lucifer999 [Qd 8s]
devi7: folds
Lucifer999: folds
spidy02: folds
Mastkalandar: folds
Uncalled bet ($25) returned to KehKeLungaAA
KehKeLungaAA: doesn't show hand
KehKeLungaAA collected $60 from pot
*** SUMMARY ***
Total pot $60.00 | Rake $0
Board []
Seat 1: Mastkalandar (big blind) folded before Flop
Seat 3: KehKeLungaAA collected ($60)
Seat 4: devi7 folded before Flop (didn't bet)
Seat 5: Lucifer999 (button) folded before Flop (didn't bet)
Seat 6: spidy02 (small blind) folded before Flop



PokerStars Game #00327551568: Hold'em No Limit ($50/$100 USD) - 2022/04/30 11:57:54 ET
Table 'Hold'em (Min 25KMax 10K)    69' 6-max Seat #4 is the button
Seat 1: Lucifer999 ($32755.71 in chips) 
Seat 2: TheWay ($716.7 in chips) 
Seat 3: Mpr@59  ($15214.66 in chips) 
Seat 4: Coco98 ($10742.8 in chips) 
Seat 5: tabby20 ($33442.24 in chips) 
Seat 6: manny007 ($2600 in chips) 
tabby20: posts small blind $50
Lucifer999: posts big blind $100
*** HOLE CARDS ***
Dealt to Lucifer999 [As 3h]
TheWay: raises $616.70 to $716.7
Mpr@59 : folds
Coco98: folds
tabby20: calls $666.7
Lucifer999: calls $616.7
*** FLOP *** [4d 9h 2c]
tabby20: checks
Lucifer999: checks
*** TURN *** [4d 9h 2c] [7h]
tabby20: checks
Lucifer999: checks
*** RIVER *** [4d 9h 2c 7h] [Jd]
tabby20: checks
Lucifer999: bets $800
tabby20: folds
Uncalled bet ($800) returned to Lucifer999
*** SHOW DOWN ***
Lucifer999: shows [As 3h] (High card, A)
TheWay: shows [Qd 6d] (High card, Q)
Lucifer999 collected $2055.5 from pot
*** SUMMARY ***
Total pot $2150.10 | Rake $94.6
Board [4d 9h 2c 7h Jd]
Seat 1: Lucifer999  (big blind) showed [As 3h] and won ($2055.5) with High card, A
Seat 2: TheWay showed [Qd 6d] and lost with High card, Q
Seat 3: Mpr@59  folded before Flop (didn't bet)
Seat 4: Coco98 (button) folded before Flop (didn't bet)
Seat 5: tabby20 (small blind) folded on the River



PokerStars Game #00327551643: Hold'em No Limit ($10/$25 USD) - 2022/04/30 11:58:34 ET
Table 'Hold'em (Min 500Max 2500) 1001' 6-max Seat #6 is the button
Seat 1: Mastkalandar ($2502.46 in chips) 
Seat 2: movetome ($500 in chips) 
Seat 3: KehKeLungaAA ($1655.06 in chips) 
Seat 4: devi7 ($2205.28 in chips) 
Seat 5: Lucifer999 ($3407.52 in chips) 
Seat 6: spidy02 ($4345.68 in chips) 
Mastkalandar: posts small blind $10
movetome: posts big blind $25
*** HOLE CARDS ***
Dealt to Lucifer999 [9d As]
devi7: folds
Lucifer999: folds
spidy02: calls $50
Mastkalandar: raises $150.00 to $200
movetome: folds
KehKeLungaAA: calls $150
spidy02: folds
*** FLOP *** [3d 5h Ad]
Mastkalandar: bets $350
KehKeLungaAA: folds
Uncalled bet ($350) returned to Mastkalandar
Mastkalandar: doesn't show hand
Mastkalandar collected $446.07 from pot
*** SUMMARY ***
Total pot $475.00 | Rake $28.93
Board [3d 5h Ad]
Seat 1: Mastkalandar (small blind) collected ($446.07)
Seat 2: movetome (big blind) folded before Flop
Seat 3: KehKeLungaAA folded on the Flop
Seat 4: devi7 folded before Flop (didn't bet)
Seat 5: Lucifer999 folded before Flop (didn't bet)
Seat 6: spidy02 (button) folded before Flop



PokerStars Game #00327551630: Hold'em No Limit ($10/$25 USD) - 2022/04/30 11:58:28 ET
Table 'Hold'em (Min 500Max 2500)  1282' 6-max Seat #6 is the button
Seat 1: JaspritBumrah786 ($2110 in chips) 
Seat 2: jas8k ($2498.41 in chips) 
Seat 3: Vanquish01 ($652.18 in chips) 
Seat 5: Lucifer999 ($9264.59 in chips) 
Seat 6: devi7 ($5920.26 in chips) 
JaspritBumrah786: posts small blind $10
jas8k: posts big blind $25
*** HOLE CARDS ***
Dealt to Lucifer999 [Qh Ad]
Vanquish01: raises $48.75 to $73.75
Lucifer999: raises $126.25 to $200
devi7: folds
JaspritBumrah786: folds
jas8k: folds
Vanquish01: raises $452.18 to $652.18
Lucifer999: calls $452.18
*** FLOP *** [5s 7s 9c]
*** TURN *** [5s 7s 9c] [Js]
*** RIVER *** [5s 7s 9c Js] [2h]
*** SHOW DOWN ***
Vanquish01: shows [Tc Th] (Pair, TT)
Lucifer999: shows [Qh Ad] (High card, A)
Vanquish01 collected $1264.07 from pot
*** SUMMARY ***
Total pot $1339.36 | Rake $75.29
Board [5s 7s 9c Js 2h]
Seat 1: JaspritBumrah786 (small blind) folded before Flop
Seat 2: jas8k (big blind) folded before Flop
Seat 3: Vanquish01  showed [Tc Th] and won ($1264.07) with Pair, TT
Seat 5: Lucifer999 showed [Qh Ad] and lost with High card, A
Seat 6: devi7 (button) folded before Flop (didn't bet)



PokerStars Game #00327551675: Hold'em No Limit ($25/$50 USD) - 2022/04/30 11:58:48 ET
Table 'Hold'em (Min 1K Max 5K)   216' 6-max Seat #1 is the button
Seat 1: Lucifer999 ($14557.78 in chips) 
Seat 2: rahulh1 ($3000 in chips) 
Lucifer999: posts small blind $25
rahulh1: posts big blind $50
*** HOLE CARDS ***
Dealt to Lucifer999 [9h 9s]
Lucifer999: calls $25
rahulh1: checks
*** FLOP *** [5c Ad 6d]
rahulh1: checks
Lucifer999: checks
*** TURN *** [5c Ad 6d] [Qh]
rahulh1: checks
Lucifer999: checks
*** RIVER *** [5c Ad 6d Qh] [7c]
rahulh1: bets $50
Lucifer999: calls $50
*** SHOW DOWN ***
rahulh1: shows [4c 7d] (Pair, 77)
Lucifer999: shows [9h 9s] (Pair, 99)
Lucifer999 collected $191 from pot
*** SUMMARY ***
Total pot $200.00 | Rake $9
Board [5c Ad 6d Qh 7c]
Seat 1: Lucifer999  (button) (small blind) showed [9h 9s] and won ($191) with Pair, 99
Seat 2: rahulh1 (big blind) showed [4c 7d] and lost with Pair, 77



PokerStars Game #00327551678: Hold'em No Limit ($50/$100 USD) - 2022/04/30 11:58:49 ET
Table 'Hold'em (Min 25KMax 10K)    69' 6-max Seat #5 is the button
Seat 1: Lucifer999 ($34094.51 in chips) 
Seat 3: Mpr@59  ($15214.66 in chips) 
Seat 4: Coco98 ($10742.8 in chips) 
Seat 5: tabby20 ($32725.54 in chips) 
Seat 6: manny007 ($2600 in chips) 
Lucifer999: posts small blind $50
Mpr@59 : posts big blind $100
*** HOLE CARDS ***
Dealt to Lucifer999 [Qc Js]
Coco98: folds
tabby20: folds
Lucifer999: raises $200.00 to $300
Mpr@59 : calls $200
*** FLOP *** [9d 8d 2h]
Lucifer999: bets $500
Mpr@59 : folds
Uncalled bet ($500) returned to Lucifer999
Lucifer999: doesn't show hand
Lucifer999 collected $573.6 from pot
*** SUMMARY ***
Total pot $600.00 | Rake $26.4
Board [9d 8d 2h]
Seat 1: Lucifer999 (small blind) collected ($573.6)
Seat 3: Mpr@59  (big blind) folded on the Flop
Seat 4: Coco98 folded before Flop (didn't bet)
Seat 5: tabby20 (button) folded before Flop (didn't bet)



PokerStars Game #00327551738: Hold'em No Limit ($10/$25 USD) - 2022/04/30 11:59:18 ET
Table 'Hold'em (Min 500Max 2500)  1282' 6-max Seat #1 is the button
Seat 1: JaspritBumrah786 ($2100 in chips) 
Seat 2: jas8k ($2473.41 in chips) 
Seat 5: Lucifer999 ($8612.41 in chips) 
Seat 6: devi7 ($5920.26 in chips) 
jas8k: posts small blind $10
Lucifer999: posts big blind $25
*** HOLE CARDS ***
Dealt to Lucifer999 [6d Qc]
devi7: raises $50.00 to $75
JaspritBumrah786: folds
jas8k: folds
Lucifer999: folds
Uncalled bet ($50) returned to devi7
devi7: doesn't show hand
devi7 collected $60 from pot
*** SUMMARY ***
Total pot $60.00 | Rake $0
Board []
Seat 1: JaspritBumrah786 (button) folded before Flop (didn't bet)
Seat 2: jas8k (small blind) folded before Flop
Seat 5: Lucifer999 (big blind) folded before Flop
Seat 6: devi7 collected ($60)



PokerStars Game #00327551718: Hold'em No Limit ($10/$25 USD) - 2022/04/30 11:59:08 ET
Table 'Hold'em (Min 500Max 2500) 1001' 6-max Seat #1 is the button
Seat 1: Mastkalandar ($2748.53 in chips) 
Seat 2: movetome ($475 in chips) 
Seat 3: KehKeLungaAA ($1455.06 in chips) 
Seat 4: devi7 ($2205.28 in chips) 
Seat 5: Lucifer999 ($3407.52 in chips) 
Seat 6: spidy02 ($4295.68 in chips) 
movetome: posts small blind $10
KehKeLungaAA: posts big blind $25
*** HOLE CARDS ***
Dealt to Lucifer999 [Ac 4d]
devi7: folds
Lucifer999: folds
spidy02: folds
Mastkalandar: folds
movetome: folds
Uncalled bet ($15) returned to KehKeLungaAA
KehKeLungaAA: doesn't show hand
KehKeLungaAA collected $20 from pot
*** SUMMARY ***
Total pot $20.00 | Rake $0
Board []
Seat 1: Mastkalandar (button) folded before Flop (didn't bet)
Seat 2: movetome (small blind) folded before Flop
Seat 3: KehKeLungaAA (big blind) collected ($20)
Seat 4: devi7 folded before Flop (didn't bet)
Seat 5: Lucifer999 folded before Flop (didn't bet)
Seat 6: spidy02 folded before Flop (didn't bet)



PokerStars Game #00327551768: Hold'em No Limit ($25/$50 USD) - 2022/04/30 11:59:29 ET
Table 'Hold'em (Min 1K Max 5K)   216' 6-max Seat #2 is the button
Seat 1: Lucifer999 ($14648.78 in chips) 
Seat 2: rahulh1 ($2900 in chips) 
Seat 4: TheWay ($2367.89 in chips) 
rahulh1: posts small blind $25
Lucifer999: posts big blind $50
*** HOLE CARDS ***
Dealt to Lucifer999 [4s Kh]
rahulh1: raises $63.04 to $113.04
Lucifer999: raises $226.08 to $339.12
rahulh1: calls $226.08
*** FLOP *** [4c 4h 3s]
Lucifer999: bets $300
rahulh1: folds
Uncalled bet ($300) returned to Lucifer999
Lucifer999: doesn't show hand
Lucifer999 collected $647.73 from pot
*** SUMMARY ***
Total pot $678.24 | Rake $30.51
Board [4c 4h 3s]
Seat 1: Lucifer999 (big blind) collected ($647.73)
Seat 2: rahulh1 (button) (small blind) folded on the Flop



PokerStars Game #00327551769: Hold'em No Limit ($50/$100 USD) - 2022/04/30 11:59:29 ET
Table 'Hold'em (Min 25KMax 10K)    69' 6-max Seat #1 is the button
Seat 1: Lucifer999 ($34368.11 in chips) 
Seat 3: Mpr@59  ($14914.66 in chips) 
Seat 4: Coco98 ($10742.8 in chips) 
Seat 5: tabby20 ($32725.54 in chips) 
Seat 6: manny007 ($2600 in chips) 
Mpr@59 : posts small blind $50
Coco98: posts big blind $100
manny007: posts small & big blinds $150
*** HOLE CARDS ***
Dealt to Lucifer999 [Js Kh]
tabby20: folds
manny007: checks
Lucifer999: calls $100
Mpr@59 : calls $50
Coco98: checks
*** FLOP *** [6d 5h 3c]
Mpr@59 : checks
Coco98: bets $350
manny007: folds
Lucifer999: folds
Mpr@59 : calls $350
*** TURN *** [6d 5h 3c] [2s]
Mpr@59 : checks
Coco98: checks
*** RIVER *** [6d 5h 3c 2s] [6c]
Mpr@59 : bets $1099.4
Coco98: folds
Uncalled bet ($1099.4) returned to Mpr@59 
Mpr@59 : doesn't show hand
Mpr@59  collected $1099.4 from pot
*** SUMMARY ***
Total pot $1150.00 | Rake $50.6
Board [6d 5h 3c 2s 6c]
Seat 1: Lucifer999 (button) folded on the Flop
Seat 3: Mpr@59  (small blind) collected ($1099.4)
Seat 4: Coco98 (big blind) folded on the River
Seat 5: tabby20 folded before Flop (didn't bet)
Seat 6: manny007 folded on the Flop



PokerStars Game #00327551779: Hold'em No Limit ($10/$25 USD) - 2022/04/30 11:59:35 ET
Table 'Hold'em (Min 500Max 2500)  1282' 6-max Seat #2 is the button
Seat 1: JaspritBumrah786 ($2100 in chips) 
Seat 2: jas8k ($2463.41 in chips) 
Seat 5: Lucifer999 ($8587.41 in chips) 
Seat 6: devi7 ($5955.26 in chips) 
Lucifer999: posts small blind $10
devi7: posts big blind $25
*** HOLE CARDS ***
Dealt to Lucifer999 [Tc 8h]
JaspritBumrah786: raises $50.00 to $75
jas8k: folds
Lucifer999: folds
devi7: calls $50
*** FLOP *** [9d Kc Qd]
devi7: checks
JaspritBumrah786: bets $125
devi7: folds
Uncalled bet ($125) returned to JaspritBumrah786
JaspritBumrah786: doesn't show hand
JaspritBumrah786 collected $150.6 from pot
*** SUMMARY ***
Total pot $160.00 | Rake $9.4
Board [9d Kc Qd]
Seat 1: JaspritBumrah786 collected ($150.6)
Seat 2: jas8k (button) folded before Flop (didn't bet)
Seat 5: Lucifer999 (small blind) folded before Flop
Seat 6: devi7 (big blind) folded on the Flop



PokerStars Game #00327551839: Hold'em No Limit ($25/$50 USD) - 2022/04/30 12:00:02 ET
Table 'Hold'em (Min 1K Max 5K)   216' 6-max Seat #1 is the button
Seat 1: Lucifer999 ($14957.39 in chips) 
Seat 2: rahulh1 ($2560.88 in chips) 
Seat 4: TheWay ($2367.89 in chips) 
Seat 6: Pablit0 ($1000 in chips) 
rahulh1: posts small blind $25
TheWay: posts big blind $50
*** HOLE CARDS ***
Dealt to Lucifer999 [Ac 6h]
Pablit0: checks
Lucifer999: folds
rahulh1: folds
TheWay: raises $50.00 to $100
Pablit0: calls $50
*** FLOP *** [7d 8h 9c]
TheWay: bets $50
Pablit0: raises $100.00 to $150
TheWay: calls $100
*** TURN *** [7d 8h 9c] [Qc]
TheWay: checks
Pablit0: checks
*** RIVER *** [7d 8h 9c Qc] [Th]
TheWay: bets $249.38
Pablit0: folds
Uncalled bet ($249.38) returned to TheWay
TheWay: doesn't show hand
TheWay collected $498.75 from pot
*** SUMMARY ***
Total pot $525.00 | Rake $26.25
Board [7d 8h 9c Qc Th]
Seat 1: Lucifer999 (button) folded before Flop (didn't bet)
Seat 2: rahulh1 (small blind) folded before Flop
Seat 4: TheWay (big blind) collected ($498.75)
Seat 6: Pablit0 folded on the River



PokerStars Game #00327551783: Hold'em No Limit ($10/$25 USD) - 2022/04/30 11:59:36 ET
Table 'Hold'em (Min 500Max 2500) 1001' 6-max Seat #2 is the button
Seat 1: Mastkalandar ($2748.53 in chips) 
Seat 2: movetome ($2025 in chips) 
Seat 3: KehKeLungaAA ($1465.06 in chips) 
Seat 4: devi7 ($2205.28 in chips) 
Seat 5: Lucifer999 ($3407.52 in chips) 
Seat 6: spidy02 ($4295.68 in chips) 
KehKeLungaAA: posts small blind $10
devi7: posts big blind $25
*** HOLE CARDS ***
Dealt to Lucifer999 [3c 7d]
Lucifer999: folds
spidy02: calls $25
Mastkalandar: folds
movetome: raises $75.00 to $100
KehKeLungaAA: folds
devi7: folds
spidy02: calls $75
*** FLOP *** [3s 2h Qs]
spidy02: checks
movetome: checks
*** TURN *** [3s 2h Qs] [Kh]
spidy02: checks
movetome: bets $175
spidy02: calls $175
*** RIVER *** [3s 2h Qs Kh] [Td]
spidy02: bets $274.65
movetome: folds
Uncalled bet ($274.65) returned to spidy02
spidy02: doesn't show hand
spidy02 collected $549.29 from pot
*** SUMMARY ***
Total pot $585.00 | Rake $35.71
Board [3s 2h Qs Kh Td]
Seat 1: Mastkalandar folded before Flop (didn't bet)
Seat 2: movetome (button) folded on the River
Seat 3: KehKeLungaAA (small blind) folded before Flop
Seat 4: devi7 (big blind) folded before Flop
Seat 5: Lucifer999 folded before Flop (didn't bet)
Seat 6: spidy02 collected ($549.29)



PokerStars Game #00327551911: Hold'em No Limit ($50/$100 USD) - 2022/04/30 12:00:18 ET
Table 'Hold'em (Min 25KMax 10K)    69' 6-max Seat #3 is the button
Seat 1: Lucifer999 ($34268.11 in chips) 
Seat 3: Mpr@59  ($15564.06 in chips) 
Seat 4: Coco98 ($10292.8 in chips) 
Seat 5: tabby20 ($32725.54 in chips) 
Seat 6: manny007 ($2450 in chips) 
Coco98: posts small blind $50
tabby20: posts big blind $100
*** HOLE CARDS ***
Dealt to Lucifer999 [3h 4c]
manny007: calls $100
Lucifer999: folds
Mpr@59 : calls $100
Coco98: calls $50
tabby20: checks
*** FLOP *** [Th Jh Kh]
Coco98: checks
tabby20: bets $300
manny007: folds
Mpr@59 : folds
Coco98: folds
Uncalled bet ($300) returned to tabby20
tabby20: doesn't show hand
tabby20 collected $382.4 from pot
*** SUMMARY ***
Total pot $400.00 | Rake $17.6
Board [Th Jh Kh]
Seat 1: Lucifer999 folded before Flop (didn't bet)
Seat 3: Mpr@59  (button) folded on the Flop
Seat 4: Coco98 (small blind) folded on the Flop
Seat 5: tabby20 (big blind) collected ($382.4)
Seat 6: manny007 folded on the Flop



PokerStars Game #00327551923: Hold'em No Limit ($10/$25 USD) - 2022/04/30 12:00:21 ET
Table 'Hold'em (Min 500Max 2500)  1282' 6-max Seat #5 is the button
Seat 1: JaspritBumrah786 ($2300.6 in chips) 
Seat 2: jas8k ($2463.41 in chips) 
Seat 5: Lucifer999 ($8577.41 in chips) 
Seat 6: devi7 ($5880.26 in chips) 
devi7: posts small blind $10
JaspritBumrah786: posts big blind $25
*** HOLE CARDS ***
Dealt to Lucifer999 [5h 4h]
jas8k: folds
Lucifer999: raises $55.00 to $80
devi7: folds
JaspritBumrah786: folds
Uncalled bet ($55) returned to Lucifer999
Lucifer999: doesn't show hand
Lucifer999 collected $60 from pot
*** SUMMARY ***
Total pot $60.00 | Rake $0
Board []
Seat 1: JaspritBumrah786 (big blind) folded before Flop
Seat 2: jas8k folded before Flop (didn't bet)
Seat 5: Lucifer999 (button) collected ($60)
Seat 6: devi7 (small blind) folded before Flop



PokerStars Game #00327551982: Hold'em No Limit ($25/$50 USD) - 2022/04/30 12:00:44 ET
Table 'Hold'em (Min 1K Max 5K)   216' 6-max Seat #2 is the button
Seat 1: Lucifer999 ($14957.39 in chips) 
Seat 2: rahulh1 ($2535.88 in chips) 
Seat 4: TheWay ($2616.64 in chips) 
Seat 6: Pablit0 ($750 in chips) 
TheWay: posts small blind $25
Pablit0: posts big blind $50
*** HOLE CARDS ***
Dealt to Lucifer999 [4c 3h]
Lucifer999: folds
rahulh1: raises $100.70 to $150.7
TheWay: calls $125.7
Pablit0: folds
*** FLOP *** [8d Ac Jd]
TheWay: bets $166.92
rahulh1: calls $166.92
*** TURN *** [8d Ac Jd] [6h]
TheWay: checks
rahulh1: bets $196.43
TheWay: calls $196.43
*** RIVER *** [8d Ac Jd 6h] [2c]
TheWay: bets $575
rahulh1: calls $575
*** SHOW DOWN ***
TheWay: shows [3d Qd] (High card, A)
rahulh1: shows [7c Ad] (Pair, AA)
rahulh1 collected $2116.7 from pot
*** SUMMARY ***
Total pot $2228.10 | Rake $111.4
Board [8d Ac Jd 6h 2c]
Seat 1: Lucifer999 folded before Flop (didn't bet)
Seat 2: rahulh1  (button) showed [7c Ad] and won ($2116.7) with Pair, AA
Seat 4: TheWay (small blind) showed [3d Qd] and lost with High card, A
Seat 6: Pablit0 (big blind) folded before Flop



PokerStars Game #00327551986: Hold'em No Limit ($10/$25 USD) - 2022/04/30 12:00:45 ET
Table 'Hold'em (Min 500Max 2500) 1001' 6-max Seat #3 is the button
Seat 1: Mastkalandar ($2748.53 in chips) 
Seat 2: movetome ($1850 in chips) 
Seat 3: KehKeLungaAA ($1455.06 in chips) 
Seat 4: devi7 ($2180.28 in chips) 
Seat 5: Lucifer999 ($3407.52 in chips) 
Seat 6: spidy02 ($4569.97 in chips) 
devi7: posts small blind $10
Lucifer999: posts big blind $25
*** HOLE CARDS ***
Dealt to Lucifer999 [4h 5s]
spidy02: folds
Mastkalandar: raises $50.00 to $75
movetome: raises $150.00 to $225
KehKeLungaAA: calls $225
devi7: folds
Lucifer999: folds
Mastkalandar: raises $475.00 to $700
movetome: raises $1150.00 to $1850
KehKeLungaAA: folds
Mastkalandar: calls $1150
*** FLOP *** [9h Qd Jc]
*** TURN *** [9h Qd Jc] [Th]
*** RIVER *** [9h Qd Jc Th] [Ad]
*** SHOW DOWN ***
Mastkalandar: shows [As Kc] (Straight, A-T)
movetome: shows [Ac Qc] (Two pairs, AAQQ)
Mastkalandar collected $3756 from pot
*** SUMMARY ***
Total pot $3960.00 | Rake $204
Board [9h Qd Jc Th Ad]
Seat 1: Mastkalandar  showed [As Kc] and won ($3756) with Straight, A-T
Seat 2: movetome showed [Ac Qc] and lost with Two pairs, AAQQ
Seat 3: KehKeLungaAA (button) folded before Flop
Seat 4: devi7 (small blind) folded before Flop
Seat 5: Lucifer999 (big blind) folded before Flop
Seat 6: spidy02 folded before Flop (didn't bet)



PokerStars Game #00327552014: Hold'em No Limit ($50/$100 USD) - 2022/04/30 12:00:53 ET
Table 'Hold'em (Min 25KMax 10K)    69' 6-max Seat #4 is the button
Seat 1: Lucifer999 ($34268.11 in chips) 
Seat 3: Mpr@59  ($15464.06 in chips) 
Seat 4: Coco98 ($10192.8 in chips) 
Seat 5: tabby20 ($33007.94 in chips) 
Seat 6: manny007 ($2350 in chips) 
tabby20: posts small blind $50
manny007: posts big blind $100
*** HOLE CARDS ***
Dealt to Lucifer999 [Jc 6h]
Lucifer999: folds
Mpr@59 : calls $100
Coco98: folds
tabby20: calls $50
manny007: checks
*** FLOP *** [9c Qc 4h]
tabby20: bets $286.8
manny007: folds
Mpr@59 : calls $286.8
*** TURN *** [9c Qc 4h] [Tc]
tabby20: checks
Mpr@59 : checks
*** RIVER *** [9c Qc 4h Tc] [Ac]
tabby20: bets $600
Mpr@59 : folds
Uncalled bet ($600) returned to tabby20
tabby20: doesn't show hand
tabby20 collected $835.19 from pot
*** SUMMARY ***
Total pot $873.60 | Rake $38.41
Board [9c Qc 4h Tc Ac]
Seat 1: Lucifer999 folded before Flop (didn't bet)
Seat 3: Mpr@59  folded on the River
Seat 4: Coco98 (button) folded before Flop (didn't bet)
Seat 5: tabby20 (small blind) collected ($835.19)
Seat 6: manny007 (big blind) folded on the Flop



PokerStars Game #00327552023: Hold'em No Limit ($10/$25 USD) - 2022/04/30 12:00:57 ET
Table 'Hold'em (Min 500Max 2500)  1282' 6-max Seat #6 is the button
Seat 1: JaspritBumrah786 ($2275.6 in chips) 
Seat 2: jas8k ($2463.41 in chips) 
Seat 5: Lucifer999 ($8612.41 in chips) 
Seat 6: devi7 ($5870.26 in chips) 
JaspritBumrah786: posts small blind $10
jas8k: posts big blind $25
*** HOLE CARDS ***
Dealt to Lucifer999 [7d 6d]
Lucifer999: raises $37.50 to $62.5
devi7: folds
JaspritBumrah786: folds
jas8k: calls $37.5
*** FLOP *** [Qs 4s Ks]
jas8k: checks
Lucifer999: bets $63.97
jas8k: folds
Uncalled bet ($63.97) returned to Lucifer999
Lucifer999: doesn't show hand
Lucifer999 collected $126.92 from pot
*** SUMMARY ***
Total pot $135.00 | Rake $8.08
Board [Qs 4s Ks]
Seat 1: JaspritBumrah786 (small blind) folded before Flop
Seat 2: jas8k (big blind) folded on the Flop
Seat 5: Lucifer999 collected ($126.92)
Seat 6: devi7 (button) folded before Flop (didn't bet)



PokerStars Game #00327552130: Hold'em No Limit ($25/$50 USD) - 2022/04/30 12:01:28 ET
Table 'Hold'em (Min 1K Max 5K)   216' 6-max Seat #4 is the button
Seat 1: Lucifer999 ($14957.39 in chips) 
Seat 2: rahulh1 ($3563.53 in chips) 
Seat 4: TheWay ($1527.59 in chips) 
Seat 6: Pablit0 ($700 in chips) 
Pablit0: posts small blind $25
Lucifer999: posts big blind $50
*** HOLE CARDS ***
Dealt to Lucifer999 [As Th]
rahulh1: calls $50
TheWay: raises $475.00 to $525
Pablit0: folds
Lucifer999: folds
rahulh1: folds
Uncalled bet ($475) returned to TheWay
TheWay: doesn't show hand
TheWay collected $175 from pot
*** SUMMARY ***
Total pot $175.00 | Rake $0
Board []
Seat 1: Lucifer999 (big blind) folded before Flop
Seat 2: rahulh1 folded before Flop
Seat 4: TheWay (button) collected ($175)
Seat 6: Pablit0 (small blind) folded before Flop



PokerStars Game #00327552216: Hold'em No Limit ($10/$25 USD) - 2022/04/30 12:01:51 ET
Table 'Hold'em (Min 500Max 2500)  1282' 6-max Seat #1 is the button
Seat 1: JaspritBumrah786 ($2265.6 in chips) 
Seat 2: jas8k ($2400.91 in chips) 
Seat 5: Lucifer999 ($8676.83 in chips) 
Seat 6: devi7 ($5870.26 in chips) 
jas8k: posts small blind $10
Lucifer999: posts big blind $25
*** HOLE CARDS ***
Dealt to Lucifer999 [4h 5h]
devi7: raises $50.00 to $75
JaspritBumrah786: folds
jas8k: folds
Lucifer999: folds
Uncalled bet ($50) returned to devi7
devi7: doesn't show hand
devi7 collected $60 from pot
*** SUMMARY ***
Total pot $60.00 | Rake $0
Board []
Seat 1: JaspritBumrah786 (button) folded before Flop (didn't bet)
Seat 2: jas8k (small blind) folded before Flop
Seat 5: Lucifer999 (big blind) folded before Flop
Seat 6: devi7 collected ($60)



PokerStars Game #00327552162: Hold'em No Limit ($10/$25 USD) - 2022/04/30 12:01:38 ET
Table 'Hold'em (Min 500Max 2500) 1001' 6-max Seat #4 is the button
Seat 1: Mastkalandar ($4654.53 in chips) 
Seat 2: movetome ($510 in chips) 
Seat 3: KehKeLungaAA ($1230.06 in chips) 
Seat 4: devi7 ($2170.28 in chips) 
Seat 5: Lucifer999 ($3382.52 in chips) 
Seat 6: spidy02 ($4569.97 in chips) 
Lucifer999: posts small blind $10
spidy02: posts big blind $25
*** HOLE CARDS ***
Dealt to Lucifer999 [As 4h]
Mastkalandar: folds
KehKeLungaAA: folds
devi7: folds
Lucifer999: raises $55.00 to $80
spidy02: calls $55
*** FLOP *** [Qc Jh 3d]
Lucifer999: bets $110
spidy02: folds
Uncalled bet ($110) returned to Lucifer999
Lucifer999: doesn't show hand
Lucifer999 collected $150.6 from pot
*** SUMMARY ***
Total pot $160.00 | Rake $9.4
Board [Qc Jh 3d]
Seat 1: Mastkalandar folded before Flop (didn't bet)
Seat 3: KehKeLungaAA folded before Flop (didn't bet)
Seat 4: devi7 (button) folded before Flop (didn't bet)
Seat 5: Lucifer999 (small blind) collected ($150.6)
Seat 6: spidy02 (big blind) folded on the Flop



PokerStars Game #00327552286: Hold'em No Limit ($25/$50 USD) - 2022/04/30 12:02:08 ET
Table 'Hold'em (Min 1K Max 5K)   216' 6-max Seat #6 is the button
Seat 1: Lucifer999 ($14907.39 in chips) 
Seat 2: rahulh1 ($3513.53 in chips) 
Seat 4: TheWay ($1652.59 in chips) 
Seat 6: Pablit0 ($675 in chips) 
Lucifer999: posts small blind $25
rahulh1: posts big blind $50
*** HOLE CARDS ***
Dealt to Lucifer999 [6s Kc]
TheWay: raises $225.00 to $275
Pablit0: folds
Lucifer999: folds
rahulh1: folds
Uncalled bet ($225) returned to TheWay
TheWay: doesn't show hand
TheWay collected $125 from pot
*** SUMMARY ***
Total pot $125.00 | Rake $0
Board []
Seat 1: Lucifer999 (small blind) folded before Flop
Seat 2: rahulh1 (big blind) folded before Flop
Seat 4: TheWay collected ($125)
Seat 6: Pablit0 (button) folded before Flop (didn't bet)



PokerStars Game #00327552330: Hold'em No Limit ($10/$25 USD) - 2022/04/30 12:02:20 ET
Table 'Hold'em (Min 500Max 2500)  1282' 6-max Seat #2 is the button
Seat 1: JaspritBumrah786 ($2265.6 in chips) 
Seat 2: jas8k ($2390.91 in chips) 
Seat 5: Lucifer999 ($8651.83 in chips) 
Seat 6: devi7 ($5905.26 in chips) 
Lucifer999: posts small blind $10
devi7: posts big blind $25
*** HOLE CARDS ***
Dealt to Lucifer999 [5h 7s]
JaspritBumrah786: folds
jas8k: raises $25.00 to $50
Lucifer999: folds
devi7: folds
Uncalled bet ($25) returned to jas8k
jas8k: doesn't show hand
jas8k collected $60 from pot
*** SUMMARY ***
Total pot $60.00 | Rake $0
Board []
Seat 1: JaspritBumrah786 folded before Flop (didn't bet)
Seat 2: jas8k (button) collected ($60)
Seat 5: Lucifer999 (small blind) folded before Flop
Seat 6: devi7 (big blind) folded before Flop



PokerStars Game #00327552188: Hold'em No Limit ($50/$100 USD) - 2022/04/30 12:01:44 ET
Table 'Hold'em (Min 25KMax 10K)    69' 6-max Seat #5 is the button
Seat 1: Lucifer999 ($34268.11 in chips) 
Seat 3: Mpr@59  ($15077.26 in chips) 
Seat 4: Coco98 ($10192.8 in chips) 
Seat 5: tabby20 ($33456.33 in chips) 
Seat 6: manny007 ($2250 in chips) 
manny007: posts small blind $50
Lucifer999: posts big blind $100
*** HOLE CARDS ***
Dealt to Lucifer999 [9d 5d]
Mpr@59 : folds
Coco98: folds
tabby20: folds
manny007: calls $50
Lucifer999: raises $250.00 to $350
manny007: calls $250
*** FLOP *** [5h 7h Th]
manny007: bets $100
Lucifer999: calls $100
*** TURN *** [5h 7h Th] [2d]
manny007: bets $100
Lucifer999: raises $500.00 to $600
manny007: calls $500
*** RIVER *** [5h 7h Th 2d] [Kd]
manny007: bets $100
Lucifer999: folds
Uncalled bet ($100) returned to manny007
manny007: doesn't show hand
manny007 collected $2007.6 from pot
*** SUMMARY ***
Total pot $2100.00 | Rake $92.4
Board [5h 7h Th 2d Kd]
Seat 1: Lucifer999 (big blind) folded on the River
Seat 3: Mpr@59  folded before Flop (didn't bet)
Seat 4: Coco98 folded before Flop (didn't bet)
Seat 5: tabby20 (button) folded before Flop (didn't bet)
Seat 6: manny007 (small blind) collected ($2007.6)



PokerStars Game #00327552338: Hold'em No Limit ($10/$25 USD) - 2022/04/30 12:02:23 ET
Table 'Hold'em (Min 500Max 2500) 1001' 6-max Seat #5 is the button
Seat 1: Mastkalandar ($7154.53 in chips) 
Seat 2: smoker player  ($510 in chips) 
Seat 3: KehKeLungaAA ($1230.06 in chips) 
Seat 4: devi7 ($2170.28 in chips) 
Seat 5: Lucifer999 ($3453.12 in chips) 
Seat 6: spidy02 ($4489.97 in chips) 
spidy02: posts small blind $10
smoker player : posts big blind $25
*** HOLE CARDS ***
Dealt to Lucifer999 [Qh 3d]
KehKeLungaAA: folds
devi7: raises $50.00 to $75
Lucifer999: folds
spidy02: folds
smoker player : folds
Uncalled bet ($50) returned to devi7
devi7: doesn't show hand
devi7 collected $60 from pot
*** SUMMARY ***
Total pot $60.00 | Rake $0
Board []
Seat 2: smoker player  (big blind) folded before Flop
Seat 3: KehKeLungaAA folded before Flop (didn't bet)
Seat 4: devi7 collected ($60)
Seat 5: Lucifer999 (button) folded before Flop (didn't bet)
Seat 6: spidy02 (small blind) folded before Flop



PokerStars Game #00327552368: Hold'em No Limit ($25/$50 USD) - 2022/04/30 12:02:33 ET
Table 'Hold'em (Min 1K Max 5K)   216' 6-max Seat #1 is the button
Seat 1: Lucifer999 ($14882.39 in chips) 
Seat 2: rahulh1 ($3463.53 in chips) 
Seat 4: TheWay ($1727.59 in chips) 
Seat 6: Pablit0 ($675 in chips) 
rahulh1: posts small blind $25
TheWay: posts big blind $50
*** HOLE CARDS ***
Dealt to Lucifer999 [Kd Qd]
Pablit0: folds
Lucifer999: folds
rahulh1: folds
Uncalled bet ($25) returned to TheWay
TheWay: doesn't show hand
TheWay collected $50 from pot
*** SUMMARY ***
Total pot $50.00 | Rake $0
Board []
Seat 1: Lucifer999 (button) folded before Flop (didn't bet)
Seat 2: rahulh1 (small blind) folded before Flop
Seat 4: TheWay (big blind) collected ($50)
Seat 6: Pablit0 folded before Flop (didn't bet)



PokerStars Game #00327552404: Hold'em No Limit ($10/$25 USD) - 2022/04/30 12:02:41 ET
Table 'Hold'em (Min 500Max 2500)  1282' 6-max Seat #5 is the button
Seat 1: JaspritBumrah786 ($2265.6 in chips) 
Seat 2: jas8k ($2425.91 in chips) 
Seat 5: Lucifer999 ($8641.83 in chips) 
Seat 6: devi7 ($5880.26 in chips) 
devi7: posts small blind $10
JaspritBumrah786: posts big blind $25
*** HOLE CARDS ***
Dealt to Lucifer999 [9s Qd]
jas8k: folds
Lucifer999: raises $55.00 to $80
devi7: folds
JaspritBumrah786: folds
Uncalled bet ($55) returned to Lucifer999
Lucifer999: doesn't show hand
Lucifer999 collected $60 from pot
*** SUMMARY ***
Total pot $60.00 | Rake $0
Board []
Seat 1: JaspritBumrah786 (big blind) folded before Flop
Seat 2: jas8k folded before Flop (didn't bet)
Seat 5: Lucifer999 (button) collected ($60)
Seat 6: devi7 (small blind) folded before Flop



PokerStars Game #00327552439: Hold'em No Limit ($10/$25 USD) - 2022/04/30 12:02:52 ET
Table 'Hold'em (Min 500Max 2500) 1001' 6-max Seat #6 is the button
Seat 1: golden585 ($2500 in chips) 
Seat 2: smoker player  ($485 in chips) 
Seat 4: devi7 ($2205.28 in chips) 
Seat 5: Lucifer999 ($3453.12 in chips) 
Seat 6: spidy02 ($4479.97 in chips) 
smoker player : posts small blind $10
devi7: posts big blind $25
*** HOLE CARDS ***
Dealt to Lucifer999 [4c 9h]
Lucifer999: folds
spidy02: raises $45.00 to $70
smoker player : folds
devi7: folds
Uncalled bet ($45) returned to spidy02
spidy02: doesn't show hand
spidy02 collected $60 from pot
*** SUMMARY ***
Total pot $60.00 | Rake $0
Board []
Seat 2: smoker player  (small blind) folded before Flop
Seat 4: devi7 (big blind) folded before Flop
Seat 5: Lucifer999 folded before Flop (didn't bet)
Seat 6: spidy02 (button) collected ($60)



PokerStars Game #00327552416: Hold'em No Limit ($50/$100 USD) - 2022/04/30 12:02:46 ET
Table 'Hold'em (Min 25KMax 10K)    69' 6-max Seat #6 is the button
Seat 1: Lucifer999 ($33218.11 in chips) 
Seat 3: Mpr@59  ($15077.26 in chips) 
Seat 4: Coco98 ($10192.8 in chips) 
Seat 5: tabby20 ($33456.33 in chips) 
Seat 6: manny007 ($3207.6 in chips) 
Lucifer999: posts small blind $50
Mpr@59 : posts big blind $100
*** HOLE CARDS ***
Dealt to Lucifer999 [7s Td]
Coco98: folds
tabby20: folds
manny007: folds
Lucifer999: folds
Uncalled bet ($50) returned to Mpr@59 
Mpr@59 : doesn't show hand
Mpr@59  collected $100 from pot
*** SUMMARY ***
Total pot $100.00 | Rake $0
Board []
Seat 1: Lucifer999 (small blind) folded before Flop
Seat 3: Mpr@59  (big blind) collected ($100)
Seat 4: Coco98 folded before Flop (didn't bet)
Seat 5: tabby20 folded before Flop (didn't bet)
Seat 6: manny007 (button) folded before Flop (didn't bet)



PokerStars Game #00327552525: Hold'em No Limit ($10/$25 USD) - 2022/04/30 12:03:17 ET
Table 'Hold'em (Min 500Max 2500)  1282' 6-max Seat #6 is the button
Seat 1: JaspritBumrah786 ($2240.6 in chips) 
Seat 2: jas8k ($2425.91 in chips) 
Seat 5: Lucifer999 ($8676.83 in chips) 
Seat 6: devi7 ($5870.26 in chips) 
JaspritBumrah786: posts small blind $10
jas8k: posts big blind $25
*** HOLE CARDS ***
Dealt to Lucifer999 [2s Qc]
Lucifer999: folds
devi7: folds
JaspritBumrah786: folds
Uncalled bet ($15) returned to jas8k
jas8k: doesn't show hand
jas8k collected $20 from pot
*** SUMMARY ***
Total pot $20.00 | Rake $0
Board []
Seat 1: JaspritBumrah786 (small blind) folded before Flop
Seat 2: jas8k (big blind) collected ($20)
Seat 5: Lucifer999 folded before Flop (didn't bet)
Seat 6: devi7 (button) folded before Flop (didn't bet)



PokerStars Game #00327552573: Hold'em No Limit ($10/$25 USD) - 2022/04/30 12:03:31 ET
Table 'Hold'em (Min 500Max 2500)  1282' 6-max Seat #1 is the button
Seat 1: JaspritBumrah786 ($2230.6 in chips) 
Seat 2: jas8k ($2435.91 in chips) 
Seat 5: Lucifer999 ($8676.83 in chips) 
Seat 6: devi7 ($5870.26 in chips) 
jas8k: posts small blind $10
Lucifer999: posts big blind $25
*** HOLE CARDS ***
Dealt to Lucifer999 [Qh Ad]
devi7: folds
JaspritBumrah786: folds
jas8k: folds
Uncalled bet ($15) returned to Lucifer999
Lucifer999: doesn't show hand
Lucifer999 collected $20 from pot
*** SUMMARY ***
Total pot $20.00 | Rake $0
Board []
Seat 1: JaspritBumrah786 (button) folded before Flop (didn't bet)
Seat 2: jas8k (small blind) folded before Flop
Seat 5: Lucifer999 (big blind) collected ($20)
Seat 6: devi7 folded before Flop (didn't bet)



PokerStars Game #00327552454: Hold'em No Limit ($25/$50 USD) - 2022/04/30 12:02:57 ET
Table 'Hold'em (Min 1K Max 5K)   216' 6-max Seat #2 is the button
Seat 1: Lucifer999 ($14882.39 in chips) 
Seat 2: rahulh1 ($3438.53 in chips) 
Seat 4: TheWay ($1752.59 in chips) 
Seat 6: Pablit0 ($675 in chips) 
TheWay: posts small blind $25
Pablit0: posts big blind $50
*** HOLE CARDS ***
Dealt to Lucifer999 [2c 4d]
Lucifer999: folds
rahulh1: folds
TheWay: calls $25
Pablit0: checks
*** FLOP *** [Ac Ts Ah]
TheWay: checks
Pablit0: bets $50
TheWay: folds
Uncalled bet ($50) returned to Pablit0
Pablit0: doesn't show hand
Pablit0 collected $95 from pot
*** SUMMARY ***
Total pot $100.00 | Rake $5
Board [Ac Ts Ah]
Seat 1: Lucifer999 folded before Flop (didn't bet)
Seat 2: rahulh1 (button) folded before Flop (didn't bet)
Seat 4: TheWay (small blind) folded on the Flop
Seat 6: Pablit0 (big blind) collected ($95)



PokerStars Game #00327552535: Hold'em No Limit ($10/$25 USD) - 2022/04/30 12:03:19 ET
Table 'Hold'em (Min 500Max 2500) 1001' 6-max Seat #2 is the button
Seat 1: golden585 ($2500 in chips) 
Seat 2: smoker player  ($475 in chips) 
Seat 3: movetome ($500 in chips) 
Seat 4: devi7 ($2180.28 in chips) 
Seat 5: Lucifer999 ($3453.12 in chips) 
Seat 6: spidy02 ($4514.97 in chips) 
devi7: posts small blind $10
Lucifer999: posts big blind $25
*** HOLE CARDS ***
Dealt to Lucifer999 [9h Ad]
spidy02: calls $25
smoker player : raises $25.00 to $50
devi7: folds
Lucifer999: calls $25
spidy02: calls $25
*** FLOP *** [6s 5h 4h]
Lucifer999: checks
spidy02: bets $112.95
smoker player : raises $312.05 to $425
Lucifer999: folds
spidy02: calls $312.05
*** TURN *** [6s 5h 4h] [As]
*** RIVER *** [6s 5h 4h As] [4d]
*** SHOW DOWN ***
smoker player : shows [Th Jh] (Pair, 44)
spidy02: shows [3c 3d] (Two pairs, 4433)
spidy02 collected $951.98 from pot
*** SUMMARY ***
Total pot $1010.00 | Rake $58.02
Board [6s 5h 4h As 4d]
Seat 2: smoker player  (button) showed [Th Jh] and lost with Pair, 44
Seat 4: devi7 (small blind) folded before Flop
Seat 5: Lucifer999 (big blind) folded on the Flop
Seat 6: spidy02  showed [3c 3d] and won ($951.98) with Two pairs, 4433



PokerStars Game #00327552639: Hold'em No Limit ($10/$25 USD) - 2022/04/30 12:03:46 ET
Table 'Hold'em (Min 500Max 2500)  1282' 6-max Seat #2 is the button
Seat 1: JaspritBumrah786 ($2230.6 in chips) 
Seat 2: jas8k ($2425.91 in chips) 
Seat 5: Lucifer999 ($8686.83 in chips) 
Seat 6: devi7 ($5870.26 in chips) 
Lucifer999: posts small blind $10
devi7: posts big blind $25
*** HOLE CARDS ***
Dealt to Lucifer999 [4d 6h]
JaspritBumrah786: folds
jas8k: folds
Lucifer999: folds
Uncalled bet ($15) returned to devi7
devi7: doesn't show hand
devi7 collected $20 from pot
*** SUMMARY ***
Total pot $20.00 | Rake $0
Board []
Seat 1: JaspritBumrah786 folded before Flop (didn't bet)
Seat 2: jas8k (button) folded before Flop (didn't bet)
Seat 5: Lucifer999 (small blind) folded before Flop
Seat 6: devi7 (big blind) collected ($20)



PokerStars Game #00327552548: Hold'em No Limit ($50/$100 USD) - 2022/04/30 12:03:23 ET
Table 'Hold'em (Min 25KMax 10K)    69' 6-max Seat #1 is the button
Seat 1: Lucifer999 ($33168.11 in chips) 
Seat 3: Mpr@59  ($15127.26 in chips) 
Seat 4: Coco98 ($10192.8 in chips) 
Seat 5: tabby20 ($33456.33 in chips) 
Seat 6: manny007 ($3207.6 in chips) 
Mpr@59 : posts small blind $50
tabby20: posts big blind $100
*** HOLE CARDS ***
Dealt to Lucifer999 [4c Ks]
manny007: folds
Lucifer999: folds
Mpr@59 : calls $50
tabby20: checks
*** FLOP *** [Kd 7d 9h]
Mpr@59 : checks
tabby20: bets $100
Mpr@59 : calls $100
*** TURN *** [Kd 7d 9h] [4d]
Mpr@59 : checks
tabby20: bets $300
Mpr@59 : calls $300
*** RIVER *** [Kd 7d 9h 4d] [Jh]
Mpr@59 : checks
tabby20: bets $478
Mpr@59 : folds
Uncalled bet ($478) returned to tabby20
tabby20: doesn't show hand
tabby20 collected $956 from pot
*** SUMMARY ***
Total pot $1000.00 | Rake $44
Board [Kd 7d 9h 4d Jh]
Seat 1: Lucifer999 (button) folded before Flop (didn't bet)
Seat 3: Mpr@59  (small blind) folded on the River
Seat 5: tabby20 (big blind) collected ($956)
Seat 6: manny007 folded before Flop (didn't bet)



PokerStars Game #00327552721: Hold'em No Limit ($10/$25 USD) - 2022/04/30 12:04:09 ET
Table 'Hold'em (Min 500Max 2500) 1001' 6-max Seat #4 is the button
Seat 3: movetome ($500 in chips) 
Seat 4: devi7 ($2170.28 in chips) 
Seat 5: Lucifer999 ($3403.12 in chips) 
Seat 6: spidy02 ($4991.95 in chips) 
Lucifer999: posts small blind $10
spidy02: posts big blind $25
*** HOLE CARDS ***
Dealt to Lucifer999 [4s 2s]
devi7: folds
Lucifer999: folds
Uncalled bet ($15) returned to spidy02
spidy02: doesn't show hand
spidy02 collected $20 from pot
*** SUMMARY ***
Total pot $20.00 | Rake $0
Board []
Seat 4: devi7 (button) folded before Flop (didn't bet)
Seat 5: Lucifer999 (small blind) folded before Flop
Seat 6: spidy02 (big blind) collected ($20)



PokerStars Game #00327552649: Hold'em No Limit ($25/$50 USD) - 2022/04/30 12:03:48 ET
Table 'Hold'em (Min 1K Max 5K)   216' 6-max Seat #4 is the button
Seat 1: Lucifer999 ($14882.39 in chips) 
Seat 2: rahulh1 ($3438.53 in chips) 
Seat 4: TheWay ($1702.59 in chips) 
Seat 6: Pablit0 ($720 in chips) 
Pablit0: posts small blind $25
Lucifer999: posts big blind $50
*** HOLE CARDS ***
Dealt to Lucifer999 [Qh Qs]
rahulh1: folds
TheWay: raises $50.00 to $100
Pablit0: calls $75
Lucifer999: raises $375.00 to $475
TheWay: folds
Pablit0: raises $245.00 to $720
Lucifer999: calls $245
*** FLOP *** [4d Ts 7s]
*** FLOP *** [5s Td 3h]
*** TURN *** [4d Ts 7s] [Qd]
*** TURN *** [4d Ts 7s] [8s]
*** RIVER *** [4d Ts 7s Qd] [2c]
*** RIVER *** [4d Ts 7s Qd] [Ks]
*** SHOW DOWN ***
Lucifer999: shows [Qh Qs] (Pair, QQ)
Pablit0: shows [As 8d] (Pair, 88)
Lucifer999 collected $731.5 from pot
Lucifer999 collected $731.5 from pot
*** SUMMARY ***
Total pot $1540.00 | Rake $77
Board [4d Ts 7s Qd 2c]
Seat 1: Lucifer999  (big blind) showed [Qh Qs] and won ($731.5) with Pair, QQ
Seat 2: rahulh1 folded before Flop (didn't bet)
Seat 4: TheWay (button) folded before Flop
Seat 6: Pablit0 (small blind) showed [As 8d] and lost with Pair, 88



PokerStars Game #00327552735: Hold'em No Limit ($10/$25 USD) - 2022/04/30 12:04:12 ET
Table 'Hold'em (Min 500Max 2500)  1282' 6-max Seat #5 is the button
Seat 1: JaspritBumrah786 ($2230.6 in chips) 
Seat 2: jas8k ($2425.91 in chips) 
Seat 5: Lucifer999 ($8676.83 in chips) 
Seat 6: devi7 ($5880.26 in chips) 
devi7: posts small blind $10
JaspritBumrah786: posts big blind $25
*** HOLE CARDS ***
Dealt to Lucifer999 [Qh Qs]
Lucifer999: folds
devi7: raises $55.00 to $80
JaspritBumrah786: folds
Uncalled bet ($55) returned to devi7
devi7: doesn't show hand
devi7 collected $50 from pot
*** SUMMARY ***
Total pot $50.00 | Rake $0
Board []
Seat 1: JaspritBumrah786 (big blind) folded before Flop
Seat 5: Lucifer999 (button) folded before Flop (didn't bet)
Seat 6: devi7 (small blind) collected ($50)



PokerStars Game #00327552737: Hold'em No Limit ($50/$100 USD) - 2022/04/30 12:04:13 ET
Table 'Hold'em (Min 25KMax 10K)    69' 6-max Seat #3 is the button
Seat 1: Lucifer999 ($33168.11 in chips) 
Seat 3: Mpr@59  ($14627.26 in chips) 
Seat 5: tabby20 ($33912.33 in chips) 
Seat 6: manny007 ($3207.6 in chips) 
tabby20: posts small blind $50
manny007: posts big blind $100
*** HOLE CARDS ***
Dealt to Lucifer999 [6d 9h]
Lucifer999: folds
Mpr@59 : raises $100.00 to $200
tabby20: folds
manny007: folds
Uncalled bet ($100) returned to Mpr@59 
Mpr@59 : doesn't show hand
Mpr@59  collected $250 from pot
*** SUMMARY ***
Total pot $250.00 | Rake $0
Board []
Seat 1: Lucifer999 folded before Flop (didn't bet)
Seat 3: Mpr@59  (button) collected ($250)
Seat 5: tabby20 (small blind) folded before Flop
Seat 6: manny007 (big blind) folded before Flop



PokerStars Game #00327552841: Hold'em No Limit ($50/$100 USD) - 2022/04/30 12:04:41 ET
Table 'Hold'em (Min 25KMax 10K)    69' 6-max Seat #5 is the button
Seat 1: Lucifer999 ($33168.11 in chips) 
Seat 3: Mpr@59  ($14777.26 in chips) 
Seat 5: tabby20 ($33862.33 in chips) 
Seat 6: manny007 ($3107.6 in chips) 
manny007: posts small blind $50
Lucifer999: posts big blind $100
*** HOLE CARDS ***
Dealt to Lucifer999 [5c Qd]
Mpr@59 : raises $100.00 to $200
tabby20: folds
manny007: folds
Lucifer999: folds
Uncalled bet ($100) returned to Mpr@59 
Mpr@59 : doesn't show hand
Mpr@59  collected $250 from pot
*** SUMMARY ***
Total pot $250.00 | Rake $0
Board []
Seat 1: Lucifer999 (big blind) folded before Flop
Seat 3: Mpr@59  collected ($250)
Seat 5: tabby20 (button) folded before Flop (didn't bet)
Seat 6: manny007 (small blind) folded before Flop



PokerStars Game #00327552837: Hold'em No Limit ($10/$25 USD) - 2022/04/30 12:04:41 ET
Table 'Hold'em (Min 500Max 2500)  1282' 6-max Seat #6 is the button
Seat 1: JaspritBumrah786 ($2205.6 in chips) 
Seat 2: jas8k ($2425.91 in chips) 
Seat 5: Lucifer999 ($8676.83 in chips) 
Seat 6: devi7 ($5905.26 in chips) 
JaspritBumrah786: posts small blind $10
jas8k: posts big blind $25
*** HOLE CARDS ***
Dealt to Lucifer999 [8d 2d]
Lucifer999: folds
devi7: folds
JaspritBumrah786: folds
Uncalled bet ($15) returned to jas8k
jas8k: doesn't show hand
jas8k collected $20 from pot
*** SUMMARY ***
Total pot $20.00 | Rake $0
Board []
Seat 1: JaspritBumrah786 (small blind) folded before Flop
Seat 2: jas8k (big blind) collected ($20)
Seat 5: Lucifer999 folded before Flop (didn't bet)
Seat 6: devi7 (button) folded before Flop (didn't bet)



PokerStars Game #00327552803: Hold'em No Limit ($10/$25 USD) - 2022/04/30 12:04:31 ET
Table 'Hold'em (Min 500Max 2500) 1001' 6-max Seat #5 is the button
Seat 3: movetome ($500 in chips) 
Seat 4: devi7 ($2170.28 in chips) 
Seat 5: Lucifer999 ($3393.12 in chips) 
Seat 6: spidy02 ($5001.95 in chips) 
spidy02: posts small blind $10
movetome: posts big blind $25
*** HOLE CARDS ***
Dealt to Lucifer999 [8h 3s]
devi7: folds
Lucifer999: folds
spidy02: calls $15
movetome: raises $100.00 to $125
spidy02: folds
Uncalled bet ($100) returned to movetome
movetome: doesn't show hand
movetome collected $50 from pot
*** SUMMARY ***
Total pot $50.00 | Rake $0
Board []
Seat 3: movetome (big blind) collected ($50)
Seat 4: devi7 folded before Flop (didn't bet)
Seat 5: Lucifer999 (button) folded before Flop (didn't bet)
Seat 6: spidy02 (small blind) folded before Flop



PokerStars Game #00327552885: Hold'em No Limit ($50/$100 USD) - 2022/04/30 12:04:55 ET
Table 'Hold'em (Min 25KMax 10K)    69' 6-max Seat #6 is the button
Seat 1: Lucifer999 ($33068.11 in chips) 
Seat 3: Mpr@59  ($14927.26 in chips) 
Seat 5: tabby20 ($33862.33 in chips) 
Seat 6: manny007 ($3057.6 in chips) 
Lucifer999: posts small blind $50
Mpr@59 : posts big blind $100
*** HOLE CARDS ***
Dealt to Lucifer999 [Ad 8d]
tabby20: folds
manny007: calls $100
Lucifer999: raises $350.00 to $450
Mpr@59 : folds
manny007: calls $350
*** FLOP *** [Kh Qs Td]
Lucifer999: bets $600
manny007: folds
Uncalled bet ($600) returned to Lucifer999
Lucifer999: doesn't show hand
Lucifer999 collected $956 from pot
*** SUMMARY ***
Total pot $1000.00 | Rake $44
Board [Kh Qs Td]
Seat 1: Lucifer999 (small blind) collected ($956)
Seat 3: Mpr@59  (big blind) folded before Flop
Seat 5: tabby20 folded before Flop (didn't bet)
Seat 6: manny007 (button) folded on the Flop



PokerStars Game #00327552946: Hold'em No Limit ($10/$25 USD) - 2022/04/30 12:05:09 ET
Table 'Hold'em (Min 500Max 2500) 1001' 6-max Seat #6 is the button
Seat 3: movetome ($525 in chips) 
Seat 4: devi7 ($2170.28 in chips) 
Seat 5: Lucifer999 ($3393.12 in chips) 
Seat 6: spidy02 ($4976.95 in chips) 
movetome: posts small blind $10
devi7: posts big blind $25
*** HOLE CARDS ***
Dealt to Lucifer999 [8s Ah]
Lucifer999: folds
spidy02: folds
movetome: folds
Uncalled bet ($15) returned to devi7
devi7: doesn't show hand
devi7 collected $20 from pot
*** SUMMARY ***
Total pot $20.00 | Rake $0
Board []
Seat 3: movetome (small blind) folded before Flop
Seat 4: devi7 (big blind) collected ($20)
Seat 5: Lucifer999 folded before Flop (didn't bet)
Seat 6: spidy02 (button) folded before Flop (didn't bet)



PokerStars Game #00327552820: Hold'em No Limit ($25/$50 USD) - 2022/04/30 12:04:36 ET
Table 'Hold'em (Min 1K Max 5K)   216' 6-max Seat #1 is the button
Seat 1: Lucifer999 ($15625.39 in chips) 
Seat 2: rahulh1 ($3438.53 in chips) 
Seat 3: Millie ($5000 in chips) 
Seat 4: TheWay ($1602.59 in chips) 
Seat 6: Pablit0 ($1000 in chips) 
rahulh1: posts small blind $25
Millie: posts big blind $50
*** HOLE CARDS ***
Dealt to Lucifer999 [6h Tc]
TheWay: folds
Lucifer999: folds
rahulh1: calls $25
Millie: checks
*** FLOP *** [Qs 8d 7d]
rahulh1: checks
Millie: checks
*** TURN *** [Qs 8d 7d] [Kc]
rahulh1: checks
Millie: checks
*** RIVER *** [Qs 8d 7d Kc] [8c]
rahulh1: checks
Millie: checks
*** SHOW DOWN ***
rahulh1: shows [2d Ac] (Pair, 88)
Millie: doesn't show hand
rahulh1 collected $95 from pot
*** SUMMARY ***
Total pot $100.00 | Rake $5
Board [Qs 8d 7d Kc 8c]
Seat 1: Lucifer999 (button) folded before Flop (didn't bet)
Seat 2: rahulh1  (small blind) showed [2d Ac] and won ($95) with Pair, 88
Seat 3: Millie (big blind) mucked
Seat 4: TheWay folded before Flop (didn't bet)



PokerStars Game #00327553017: Hold'em No Limit ($10/$25 USD) - 2022/04/30 12:05:30 ET
Table 'Hold'em (Min 500Max 2500) 1001' 6-max Seat #3 is the button
Seat 3: movetome ($2025 in chips) 
Seat 4: devi7 ($2180.28 in chips) 
Seat 5: Lucifer999 ($3393.12 in chips) 
Seat 6: spidy02 ($4976.95 in chips) 
devi7: posts small blind $10
Lucifer999: posts big blind $25
*** HOLE CARDS ***
Dealt to Lucifer999 [4d 3h]
spidy02: folds
movetome: folds
devi7: raises $55.00 to $80
Lucifer999: folds
Uncalled bet ($55) returned to devi7
devi7: doesn't show hand
devi7 collected $50 from pot
*** SUMMARY ***
Total pot $50.00 | Rake $0
Board []
Seat 3: movetome (button) folded before Flop (didn't bet)
Seat 4: devi7 (small blind) collected ($50)
Seat 5: Lucifer999 (big blind) folded before Flop
Seat 6: spidy02 folded before Flop (didn't bet)



PokerStars Game #00327553001: Hold'em No Limit ($50/$100 USD) - 2022/04/30 12:05:26 ET
Table 'Hold'em (Min 25KMax 10K)    69' 6-max Seat #1 is the button
Seat 1: Lucifer999 ($33574.11 in chips) 
Seat 3: Mpr@59  ($14827.26 in chips) 
Seat 5: tabby20 ($33862.33 in chips) 
Seat 6: manny007 ($2607.6 in chips) 
Mpr@59 : posts small blind $50
tabby20: posts big blind $100
*** HOLE CARDS ***
Dealt to Lucifer999 [Qc 5h]
manny007: calls $100
Lucifer999: folds
Mpr@59 : folds
tabby20: checks
*** FLOP *** [6d 6c 5s]
tabby20: bets $200
manny007: calls $200
*** TURN *** [6d 6c 5s] [4d]
tabby20: checks
manny007: checks
*** RIVER *** [6d 6c 5s 4d] [4s]
tabby20: checks
manny007: checks
*** SHOW DOWN ***
tabby20: shows [Tc Jd] (Two pairs, 6644)
manny007: doesn't show hand
tabby20 collected $621.4 from pot
*** SUMMARY ***
Total pot $650.00 | Rake $28.6
Board [6d 6c 5s 4d 4s]
Seat 1: Lucifer999 (button) folded before Flop (didn't bet)
Seat 3: Mpr@59  (small blind) folded before Flop
Seat 5: tabby20  (big blind) showed [Tc Jd] and won ($621.4) with Two pairs, 6644
Seat 6: manny007 mucked



PokerStars Game #00327553079: Hold'em No Limit ($10/$25 USD) - 2022/04/30 12:05:49 ET
Table 'Hold'em (Min 500Max 2500) 1001' 6-max Seat #4 is the button
Seat 3: movetome ($2025 in chips) 
Seat 4: devi7 ($2205.28 in chips) 
Seat 5: Lucifer999 ($3368.12 in chips) 
Seat 6: spidy02 ($4976.95 in chips) 
Lucifer999: posts small blind $10
spidy02: posts big blind $25
*** HOLE CARDS ***
Dealt to Lucifer999 [9s 6h]
movetome: folds
devi7: folds
Lucifer999: folds
Uncalled bet ($15) returned to spidy02
spidy02: doesn't show hand
spidy02 collected $20 from pot
*** SUMMARY ***
Total pot $20.00 | Rake $0
Board []
Seat 3: movetome folded before Flop (didn't bet)
Seat 4: devi7 (button) folded before Flop (didn't bet)
Seat 5: Lucifer999 (small blind) folded before Flop
Seat 6: spidy02 (big blind) collected ($20)



PokerStars Game #00327552925: Hold'em No Limit ($10/$25 USD) - 2022/04/30 12:05:04 ET
Table 'Hold'em (Min 500Max 2500)  1282' 6-max Seat #1 is the button
Seat 1: JaspritBumrah786 ($2195.6 in chips) 
Seat 2: jas8k ($2435.91 in chips) 
Seat 4: spidy02 ($2500 in chips) 
Seat 5: Lucifer999 ($8676.83 in chips) 
Seat 6: devi7 ($5905.26 in chips) 
jas8k: posts small blind $10
spidy02: posts big blind $25
*** HOLE CARDS ***
Dealt to Lucifer999 [6s 2h]
Lucifer999: folds
devi7: folds
JaspritBumrah786: folds
jas8k: calls $15
spidy02: checks
*** FLOP *** [Tc 4h Ac]
jas8k: checks
spidy02: bets $31.59
jas8k: calls $31.59
*** TURN *** [Tc 4h Ac] [4s]
jas8k: checks
spidy02: bets $79.69
jas8k: calls $79.69
*** RIVER *** [Tc 4h Ac 4s] [5s]
jas8k: checks
spidy02: checks
*** SHOW DOWN ***
spidy02: shows [Th 3h] (Two pairs, TT44)
jas8k: shows [Ad 3c] (Two pairs, AA44)
jas8k collected $256.28 from pot
*** SUMMARY ***
Total pot $272.56 | Rake $16.28
Board [Tc 4h Ac 4s 5s]
Seat 1: JaspritBumrah786 (button) folded before Flop (didn't bet)
Seat 2: jas8k  (small blind) showed [Ad 3c] and won ($256.28) with Two pairs, AA44
Seat 4: spidy02 (big blind) showed [Th 3h] and lost with Two pairs, TT44
Seat 5: Lucifer999 folded before Flop (didn't bet)
Seat 6: devi7 folded before Flop (didn't bet)



PokerStars Game #00327553121: Hold'em No Limit ($50/$100 USD) - 2022/04/30 12:05:59 ET
Table 'Hold'em (Min 25KMax 10K)    69' 6-max Seat #3 is the button
Seat 1: Lucifer999 ($33574.11 in chips) 
Seat 3: Mpr@59  ($14777.26 in chips) 
Seat 5: tabby20 ($34183.73 in chips) 
Seat 6: manny007 ($2307.6 in chips) 
tabby20: posts small blind $50
manny007: posts big blind $100
*** HOLE CARDS ***
Dealt to Lucifer999 [6d Qs]
Lucifer999: folds
Mpr@59 : calls $100
tabby20: calls $50
manny007: raises $300.00 to $400
Mpr@59 : calls $300
tabby20: folds
*** FLOP *** [Ac 6h 3d]
manny007: bets $1907.6
Mpr@59 : folds
Uncalled bet ($1907.6) returned to manny007
manny007: doesn't show hand
manny007 collected $860.4 from pot
*** SUMMARY ***
Total pot $900.00 | Rake $39.6
Board [Ac 6h 3d]
Seat 1: Lucifer999 folded before Flop (didn't bet)
Seat 3: Mpr@59  (button) folded on the Flop
Seat 5: tabby20 (small blind) folded before Flop
Seat 6: manny007 (big blind) collected ($860.4)



PokerStars Game #00327553184: Hold'em No Limit ($10/$25 USD) - 2022/04/30 12:06:18 ET
Table 'Hold'em (Min 500Max 2500)  1282' 6-max Seat #2 is the button
Seat 1: JaspritBumrah786 ($2195.6 in chips) 
Seat 2: jas8k ($2555.91 in chips) 
Seat 4: spidy02 ($2363.72 in chips) 
Seat 5: Lucifer999 ($8676.83 in chips) 
Seat 6: devi7 ($5905.26 in chips) 
spidy02: posts small blind $10
Lucifer999: posts big blind $25
*** HOLE CARDS ***
Dealt to Lucifer999 [2d Tc]
devi7: folds
JaspritBumrah786: folds
jas8k: folds
spidy02: raises $50.00 to $75
Lucifer999: folds
Uncalled bet ($50) returned to spidy02
spidy02: doesn't show hand
spidy02 collected $50 from pot
*** SUMMARY ***
Total pot $50.00 | Rake $0
Board []
Seat 1: JaspritBumrah786 folded before Flop (didn't bet)
Seat 2: jas8k (button) folded before Flop (didn't bet)
Seat 4: spidy02 (small blind) collected ($50)
Seat 5: Lucifer999 (big blind) folded before Flop
Seat 6: devi7 folded before Flop (didn't bet)



PokerStars Game #00327553035: Hold'em No Limit ($25/$50 USD) - 2022/04/30 12:05:37 ET
Table 'Hold'em (Min 1K Max 5K)   216' 6-max Seat #2 is the button
Seat 1: Lucifer999 ($15625.39 in chips) 
Seat 2: rahulh1 ($3483.53 in chips) 
Seat 3: Millie ($5000 in chips) 
Seat 4: TheWay ($1602.59 in chips) 
Seat 5: No username ($4100 in chips) 
Seat 6: Pablit0 ($1000 in chips) 
Millie: posts small blind $25
TheWay: posts big blind $50
*** HOLE CARDS ***
Dealt to Lucifer999 [Ah 8d]
Pablit0: folds
Lucifer999: folds
rahulh1: folds
Millie: calls $25
TheWay: raises $300.00 to $350
Millie: calls $300
*** FLOP *** [Kh Td 6d]
Millie: checks
TheWay: bets $75
Millie: calls $75
*** TURN *** [Kh Td 6d] [Ts]
Millie: checks
TheWay: bets $250
Millie: calls $250
*** RIVER *** [Kh Td 6d Ts] [6s]
Millie: bets $250
TheWay: folds
Uncalled bet ($250) returned to Millie
Millie: doesn't show hand
Millie collected $1282.5 from pot
*** SUMMARY ***
Total pot $1350.00 | Rake $67.5
Board [Kh Td 6d Ts 6s]
Seat 1: Lucifer999 folded before Flop (didn't bet)
Seat 2: rahulh1 (button) folded before Flop (didn't bet)
Seat 3: Millie (small blind) collected ($1282.5)
Seat 4: TheWay (big blind) folded on the River
Seat 6: Pablit0 folded before Flop (didn't bet)



PokerStars Game #00327553166: Hold'em No Limit ($10/$25 USD) - 2022/04/30 12:06:12 ET
Table 'Hold'em (Min 500Max 2500) 1001' 6-max Seat #5 is the button
Seat 3: movetome ($2025 in chips) 
Seat 4: devi7 ($2205.28 in chips) 
Seat 5: Lucifer999 ($3358.12 in chips) 
Seat 6: spidy02 ($4986.95 in chips) 
spidy02: posts small blind $10
movetome: posts big blind $25
*** HOLE CARDS ***
Dealt to Lucifer999 [Qh Ks]
devi7: folds
Lucifer999: raises $55.00 to $80
spidy02: calls $70
movetome: folds
*** FLOP *** [5s Kd Tc]
spidy02: checks
Lucifer999: bets $130
spidy02: calls $130
*** TURN *** [5s Kd Tc] [6c]
spidy02: checks
Lucifer999: bets $360
spidy02: folds
Uncalled bet ($360) returned to Lucifer999
Lucifer999: doesn't show hand
Lucifer999 collected $417.64 from pot
*** SUMMARY ***
Total pot $445.00 | Rake $27.36
Board [5s Kd Tc 6c]
Seat 3: movetome (big blind) folded before Flop
Seat 4: devi7 folded before Flop (didn't bet)
Seat 5: Lucifer999 (button) collected ($417.64)
Seat 6: spidy02 (small blind) folded on the Turn



PokerStars Game #00327553232: Hold'em No Limit ($50/$100 USD) - 2022/04/30 12:06:33 ET
Table 'Hold'em (Min 25KMax 10K)    69' 6-max Seat #5 is the button
Seat 1: Lucifer999 ($33574.11 in chips) 
Seat 3: Mpr@59  ($14377.26 in chips) 
Seat 5: tabby20 ($34083.73 in chips) 
Seat 6: manny007 ($2768 in chips) 
manny007: posts small blind $50
Lucifer999: posts big blind $100
*** HOLE CARDS ***
Dealt to Lucifer999 [Kc Qc]
Mpr@59 : folds
tabby20: folds
manny007: raises $200.00 to $300
Lucifer999: calls $200
*** FLOP *** [5s 6d Js]
manny007: checks
Lucifer999: checks
*** TURN *** [5s 6d Js] [6h]
manny007: checks
Lucifer999: checks
*** RIVER *** [5s 6d Js 6h] [Th]
manny007: checks
Lucifer999: checks
*** SHOW DOWN ***
manny007: shows [Tc 9c] (Two pairs, TT66)
Lucifer999: doesn't show hand
manny007 collected $573.6 from pot
*** SUMMARY ***
Total pot $600.00 | Rake $26.4
Board [5s 6d Js 6h Th]
Seat 1: Lucifer999 (big blind) mucked
Seat 3: Mpr@59  folded before Flop (didn't bet)
Seat 5: tabby20 (button) folded before Flop (didn't bet)
Seat 6: manny007  (small blind) showed [Tc 9c] and won ($573.6) with Two pairs, TT66



PokerStars Game #00327553281: Hold'em No Limit ($25/$50 USD) - 2022/04/30 12:06:44 ET
Table 'Hold'em (Min 1K Max 5K)   216' 6-max Seat #3 is the button
Seat 1: Lucifer999 ($15625.39 in chips) 
Seat 2: rahulh1 ($3483.53 in chips) 
Seat 3: Millie ($5607.5 in chips) 
Seat 4: TheWay ($927.59 in chips) 
Seat 5: No username ($4100 in chips) 
Seat 6: Pablit0 ($1000 in chips) 
TheWay: posts small blind $25
No username: posts big blind $50
*** HOLE CARDS ***
Dealt to Lucifer999 [Th 4d]
Pablit0: folds
Lucifer999: folds
rahulh1: folds
Millie: folds
TheWay: calls $25
No username: raises $125.00 to $175
TheWay: calls $125
*** FLOP *** [3c 6s 5d]
TheWay: bets $752.59
No username: folds
Uncalled bet ($752.59) returned to TheWay
TheWay: doesn't show hand
TheWay collected $332.5 from pot
*** SUMMARY ***
Total pot $350.00 | Rake $17.5
Board [3c 6s 5d]
Seat 1: Lucifer999 folded before Flop (didn't bet)
Seat 2: rahulh1 folded before Flop (didn't bet)
Seat 3: Millie (button) folded before Flop (didn't bet)
Seat 4: TheWay (small blind) collected ($332.5)
Seat 5: No username (big blind) folded on the Flop
Seat 6: Pablit0 folded before Flop (didn't bet)



PokerStars Game #00327553278: Hold'em No Limit ($10/$25 USD) - 2022/04/30 12:06:43 ET
Table 'Hold'em (Min 500Max 2500)  1282' 6-max Seat #4 is the button
Seat 1: JaspritBumrah786 ($2195.6 in chips) 
Seat 2: jas8k ($2555.91 in chips) 
Seat 4: spidy02 ($2388.72 in chips) 
Seat 5: Lucifer999 ($8651.83 in chips) 
Seat 6: devi7 ($5905.26 in chips) 
Lucifer999: posts small blind $10
devi7: posts big blind $25
*** HOLE CARDS ***
Dealt to Lucifer999 [3d 7c]
JaspritBumrah786: raises $50.00 to $75
jas8k: calls $75
spidy02: folds
Lucifer999: folds
devi7: folds
*** FLOP *** [2s 7d 6c]
JaspritBumrah786: checks
jas8k: bets $25
JaspritBumrah786: calls $25
*** TURN *** [2s 7d 6c] [Jd]
JaspritBumrah786: bets $150
jas8k: folds
Uncalled bet ($150) returned to JaspritBumrah786
JaspritBumrah786: doesn't show hand
JaspritBumrah786 collected $220.67 from pot
*** SUMMARY ***
Total pot $235.00 | Rake $14.33
Board [2s 7d 6c Jd]
Seat 1: JaspritBumrah786 collected ($220.67)
Seat 2: jas8k folded on the Turn
Seat 4: spidy02 (button) folded before Flop (didn't bet)
Seat 5: Lucifer999 (small blind) folded before Flop
Seat 6: devi7 (big blind) folded before Flop



PokerStars Game #00327553402: Hold'em No Limit ($50/$100 USD) - 2022/04/30 12:07:19 ET
Table 'Hold'em (Min 25KMax 10K)    69' 6-max Seat #6 is the button
Seat 1: Lucifer999 ($33274.11 in chips) 
Seat 3: Mpr@59  ($14377.26 in chips) 
Seat 5: tabby20 ($34083.73 in chips) 
Seat 6: manny007 ($3041.6 in chips) 
Lucifer999: posts small blind $50
Mpr@59 : posts big blind $100
*** HOLE CARDS ***
Dealt to Lucifer999 [8h 9c]
tabby20: folds
manny007: raises $250.00 to $350
Lucifer999: folds
Mpr@59 : folds
Uncalled bet ($250) returned to manny007
manny007: doesn't show hand
manny007 collected $250 from pot
*** SUMMARY ***
Total pot $250.00 | Rake $0
Board []
Seat 1: Lucifer999 (small blind) folded before Flop
Seat 3: Mpr@59  (big blind) folded before Flop
Seat 5: tabby20 folded before Flop (didn't bet)
Seat 6: manny007 (button) collected ($250)



PokerStars Game #00327553368: Hold'em No Limit ($10/$25 USD) - 2022/04/30 12:07:11 ET
Table 'Hold'em (Min 500Max 2500) 1001' 6-max Seat #6 is the button
Seat 3: movetome ($2000 in chips) 
Seat 4: devi7 ($2205.28 in chips) 
Seat 5: Lucifer999 ($3565.76 in chips) 
Seat 6: spidy02 ($4776.95 in chips) 
movetome: posts small blind $10
devi7: posts big blind $25
*** HOLE CARDS ***
Dealt to Lucifer999 [8d 3d]
Lucifer999: folds
spidy02: folds
movetome: raises $50.00 to $75
devi7: calls $50
*** FLOP *** [2c Ad 8s]
movetome: checks
devi7: checks
*** TURN *** [2c Ad 8s] [7c]
movetome: bets $100
devi7: folds
Uncalled bet ($100) returned to movetome
movetome: doesn't show hand
movetome collected $141.13 from pot
*** SUMMARY ***
Total pot $150.00 | Rake $8.87
Board [2c Ad 8s 7c]
Seat 3: movetome (small blind) collected ($141.13)
Seat 4: devi7 (big blind) folded on the Turn
Seat 5: Lucifer999 folded before Flop (didn't bet)
Seat 6: spidy02 (button) folded before Flop (didn't bet)



PokerStars Game #00327553417: Hold'em No Limit ($25/$50 USD) - 2022/04/30 12:07:23 ET
Table 'Hold'em (Min 1K Max 5K)   216' 6-max Seat #4 is the button
Seat 1: Lucifer999 ($15625.39 in chips) 
Seat 2: rahulh1 ($3483.53 in chips) 
Seat 3: Millie ($5607.5 in chips) 
Seat 4: TheWay ($1085.09 in chips) 
Seat 5: No username ($3925 in chips) 
Seat 6: Pablit0 ($1000 in chips) 
No username: posts small blind $25
Pablit0: posts big blind $50
*** HOLE CARDS ***
Dealt to Lucifer999 [4d Qs]
Lucifer999: folds
rahulh1: calls $50
Millie: folds
TheWay: raises $175.00 to $225
No username: calls $200
Pablit0: folds
rahulh1: calls $175
*** FLOP *** [8c 6h 8h]
No username: checks
rahulh1: checks
TheWay: bets $688.75
No username: calls $688.75
rahulh1: folds
*** TURN *** [8c 6h 8h] [2c]
No username: bets $1498.05
TheWay: calls $171.34
Uncalled bet ($1326.71) returned to No username
*** RIVER *** [8c 6h 8h 2c] [5d]
*** RIVER *** [8c 6h 8h 2c] [2h]
*** SHOW DOWN ***
TheWay: shows [Qh 7h] (Flush, Q high)
No username: shows [7s 7c] (Two pairs, 8877)
No username collected $1161.47 from pot
TheWay collected $1161.46 from pot
*** SUMMARY ***
Total pot $2445.18 | Rake $122.25
Board [8c 6h 8h 2c 5d]
Seat 1: Lucifer999 folded before Flop (didn't bet)
Seat 2: rahulh1 folded on the Flop
Seat 3: Millie folded before Flop (didn't bet)
Seat 4: TheWay  (button) showed [Qh 7h] and won ($1161.46) with Flush, Q high
Seat 5: No username  (small blind) showed [7s 7c] and won ($1161.47) with Two pairs, 8877
Seat 6: Pablit0 (big blind) folded before Flop



PokerStars Game #00327553493: Hold'em No Limit ($50/$100 USD) - 2022/04/30 12:07:43 ET
Table 'Hold'em (Min 25KMax 10K)    69' 6-max Seat #1 is the button
Seat 1: Lucifer999 ($33224.11 in chips) 
Seat 3: Mpr@59  ($14277.26 in chips) 
Seat 5: tabby20 ($34083.73 in chips) 
Seat 6: manny007 ($3191.6 in chips) 
Mpr@59 : posts small blind $50
tabby20: posts big blind $100
*** HOLE CARDS ***
Dealt to Lucifer999 [Ks 8h]
manny007: folds
Lucifer999: folds
Mpr@59 : calls $50
tabby20: checks
*** FLOP *** [9s Js Td]
Mpr@59 : checks
tabby20: checks
*** TURN *** [9s Js Td] [4s]
Mpr@59 : checks
tabby20: bets $100
Mpr@59 : folds
Uncalled bet ($100) returned to tabby20
tabby20: doesn't show hand
tabby20 collected $191.2 from pot
*** SUMMARY ***
Total pot $200.00 | Rake $8.8
Board [9s Js Td 4s]
Seat 1: Lucifer999 (button) folded before Flop (didn't bet)
Seat 3: Mpr@59  (small blind) folded on the Turn
Seat 5: tabby20 (big blind) collected ($191.2)
Seat 6: manny007 folded before Flop (didn't bet)



PokerStars Game #00327553512: Hold'em No Limit ($10/$25 USD) - 2022/04/30 12:07:50 ET
Table 'Hold'em (Min 500Max 2500) 1001' 6-max Seat #3 is the button
Seat 3: movetome ($2101.13 in chips) 
Seat 4: devi7 ($2130.28 in chips) 
Seat 5: Lucifer999 ($3565.76 in chips) 
Seat 6: spidy02 ($4776.95 in chips) 
devi7: posts small blind $10
Lucifer999: posts big blind $25
*** HOLE CARDS ***
Dealt to Lucifer999 [6h 2d]
spidy02: folds
movetome: raises $50.00 to $75
devi7: calls $65
Lucifer999: folds
*** FLOP *** [6s 5d 3h]
devi7: checks
movetome: bets $125
devi7: raises $250.00 to $375
movetome: folds
Uncalled bet ($250) returned to devi7
devi7: doesn't show hand
devi7 collected $398.69 from pot
*** SUMMARY ***
Total pot $425.00 | Rake $26.31
Board [6s 5d 3h]
Seat 3: movetome (button) folded on the Flop
Seat 4: devi7 (small blind) collected ($398.69)
Seat 5: Lucifer999 (big blind) folded before Flop
Seat 6: spidy02 folded before Flop (didn't bet)



PokerStars Game #00327553461: Hold'em No Limit ($10/$25 USD) - 2022/04/30 12:07:36 ET
Table 'Hold'em (Min 500Max 2500)  1282' 6-max Seat #5 is the button
Seat 1: JaspritBumrah786 ($2395.67 in chips) 
Seat 2: jas8k ($2455.91 in chips) 
Seat 3: smoker player  ($500 in chips) 
Seat 4: spidy02 ($2388.72 in chips) 
Seat 5: Lucifer999 ($8641.83 in chips) 
Seat 6: devi7 ($5880.26 in chips) 
devi7: posts small blind $10
JaspritBumrah786: posts big blind $25
smoker player : posts big blind $25
*** HOLE CARDS ***
Dealt to Lucifer999 [8s 7d]
jas8k: raises $45.00 to $70
smoker player : folds
spidy02: folds
Lucifer999: folds
devi7: calls $60
JaspritBumrah786: folds
*** FLOP *** [5c 7h Ad]
devi7: checks
jas8k: bets $89.52
devi7: calls $89.52
*** TURN *** [5c 7h Ad] [3s]
devi7: checks
jas8k: bets $173.34
devi7: raises $260.01 to $433.35
jas8k: raises $1863.04 to $2296.39
devi7: calls $1863.04
*** RIVER *** [5c 7h Ad 3s] [Kh]
*** SHOW DOWN ***
jas8k: shows [Jd As] (Pair, AA)
devi7: shows [7s 7c] (Three of a kind, 777)
devi7 collected $4757.82 from pot
*** SUMMARY ***
Total pot $4961.82 | Rake $204
Board [5c 7h Ad 3s Kh]
Seat 1: JaspritBumrah786 (big blind) folded before Flop
Seat 2: jas8k showed [Jd As] and lost with Pair, AA
Seat 3: smoker player  folded before Flop
Seat 4: spidy02 folded before Flop (didn't bet)
Seat 5: Lucifer999 (button) folded before Flop (didn't bet)
Seat 6: devi7  (small blind) showed [7s 7c] and won ($4757.82) with Three of a kind, 777



PokerStars Game #00327553651: Hold'em No Limit ($50/$100 USD) - 2022/04/30 12:08:24 ET
Table 'Hold'em (Min 25KMax 10K)    69' 6-max Seat #3 is the button
Seat 1: Lucifer999 ($33224.11 in chips) 
Seat 3: Mpr@59  ($14177.26 in chips) 
Seat 5: tabby20 ($34174.93 in chips) 
Seat 6: manny007 ($3191.6 in chips) 
tabby20: posts small blind $50
manny007: posts big blind $100
*** HOLE CARDS ***
Dealt to Lucifer999 [5c Kc]
Lucifer999: folds
Mpr@59 : folds
tabby20: folds
Uncalled bet ($50) returned to manny007
manny007: doesn't show hand
manny007 collected $100 from pot
*** SUMMARY ***
Total pot $100.00 | Rake $0
Board []
Seat 1: Lucifer999 folded before Flop (didn't bet)
Seat 3: Mpr@59  (button) folded before Flop (didn't bet)
Seat 5: tabby20 (small blind) folded before Flop
Seat 6: manny007 (big blind) collected ($100)



PokerStars Game #00327553708: Hold'em No Limit ($10/$25 USD) - 2022/04/30 12:08:40 ET
Table 'Hold'em (Min 500Max 2500)  1282' 6-max Seat #6 is the button
Seat 1: JaspritBumrah786 ($2370.67 in chips) 
Seat 3: smoker player  ($475 in chips) 
Seat 4: spidy02 ($2388.72 in chips) 
Seat 5: Lucifer999 ($8641.83 in chips) 
Seat 6: devi7 ($8182.17 in chips) 
JaspritBumrah786: posts small blind $10
smoker player : posts big blind $25
*** HOLE CARDS ***
Dealt to Lucifer999 [4s 3c]
spidy02: folds
Lucifer999: folds
devi7: folds
JaspritBumrah786: folds
Uncalled bet ($15) returned to smoker player 
smoker player : doesn't show hand
smoker player  collected $20 from pot
*** SUMMARY ***
Total pot $20.00 | Rake $0
Board []
Seat 1: JaspritBumrah786 (small blind) folded before Flop
Seat 3: smoker player  (big blind) collected ($20)
Seat 4: spidy02 folded before Flop (didn't bet)
Seat 5: Lucifer999 folded before Flop (didn't bet)
Seat 6: devi7 (button) folded before Flop (didn't bet)



PokerStars Game #00327553676: Hold'em No Limit ($10/$25 USD) - 2022/04/30 12:08:32 ET
Table 'Hold'em (Min 500Max 2500) 1001' 6-max Seat #4 is the button
Seat 3: movetome ($2025 in chips) 
Seat 4: devi7 ($2328.97 in chips) 
Seat 5: Lucifer999 ($3540.76 in chips) 
Seat 6: spidy02 ($4776.95 in chips) 
Lucifer999: posts small blind $10
spidy02: posts big blind $25
*** HOLE CARDS ***
Dealt to Lucifer999 [2s Jh]
movetome: folds
devi7: raises $50.00 to $75
Lucifer999: folds
spidy02: calls $50
*** FLOP *** [3h 5h Qs]
spidy02: checks
devi7: bets $75
spidy02: folds
Uncalled bet ($75) returned to devi7
devi7: doesn't show hand
devi7 collected $150.6 from pot
*** SUMMARY ***
Total pot $160.00 | Rake $9.4
Board [3h 5h Qs]
Seat 3: movetome folded before Flop (didn't bet)
Seat 4: devi7 (button) collected ($150.6)
Seat 5: Lucifer999 (small blind) folded before Flop
Seat 6: spidy02 (big blind) folded on the Flop



PokerStars Game #00327553619: Hold'em No Limit ($25/$50 USD) - 2022/04/30 12:08:15 ET
Table 'Hold'em (Min 1K Max 5K)   216' 6-max Seat #5 is the button
Seat 1: Lucifer999 ($15625.39 in chips) 
Seat 2: rahulh1 ($3258.53 in chips) 
Seat 3: Millie ($5607.5 in chips) 
Seat 4: TheWay ($1161.46 in chips) 
Seat 5: No username ($4001.38 in chips) 
Seat 6: Pablit0 ($950 in chips) 
Pablit0: posts small blind $25
Lucifer999: posts big blind $50
*** HOLE CARDS ***
Dealt to Lucifer999 [Kd Th]
rahulh1: folds
Millie: folds
TheWay: calls $50
No username: raises $118.75 to $168.75
Pablit0: folds
Lucifer999: calls $118.75
TheWay: calls $118.75
*** FLOP *** [Jc 9s 5h]
Lucifer999: checks
TheWay: checks
No username: bets $180.81
Lucifer999: calls $180.81
TheWay: calls $180.81
*** TURN *** [Jc 9s 5h] [3h]
Lucifer999: checks
TheWay: checks
No username: checks
*** RIVER *** [Jc 9s 5h 3h] [Ah]
Lucifer999: bets $650
TheWay: folds
No username: folds
Uncalled bet ($650) returned to Lucifer999
Lucifer999: doesn't show hand
Lucifer999 collected $1020.03 from pot
*** SUMMARY ***
Total pot $1073.68 | Rake $53.65
Board [Jc 9s 5h 3h Ah]
Seat 1: Lucifer999 (big blind) collected ($1020.03)
Seat 2: rahulh1 folded before Flop (didn't bet)
Seat 3: Millie folded before Flop (didn't bet)
Seat 4: TheWay folded on the River
Seat 5: No username (button) folded on the River
Seat 6: Pablit0 (small blind) folded before Flop



PokerStars Game #00327553734: Hold'em No Limit ($50/$100 USD) - 2022/04/30 12:08:47 ET
Table 'Hold'em (Min 25KMax 10K)    69' 6-max Seat #5 is the button
Seat 1: Lucifer999 ($33224.11 in chips) 
Seat 3: Mpr@59  ($14177.26 in chips) 
Seat 5: tabby20 ($34124.93 in chips) 
Seat 6: manny007 ($3241.6 in chips) 
manny007: posts small blind $50
Lucifer999: posts big blind $100
*** HOLE CARDS ***
Dealt to Lucifer999 [3h Tc]
Mpr@59 : calls $100
tabby20: raises $350.00 to $450
manny007: folds
Lucifer999: folds
Mpr@59 : folds
Uncalled bet ($350) returned to tabby20
tabby20: doesn't show hand
tabby20 collected $350 from pot
*** SUMMARY ***
Total pot $350.00 | Rake $0
Board []
Seat 1: Lucifer999 (big blind) folded before Flop
Seat 3: Mpr@59  folded before Flop
Seat 5: tabby20 (button) collected ($350)
Seat 6: manny007 (small blind) folded before Flop



PokerStars Game #00327553800: Hold'em No Limit ($10/$25 USD) - 2022/04/30 12:09:05 ET
Table 'Hold'em (Min 500Max 2500)  1282' 6-max Seat #1 is the button
Seat 1: JaspritBumrah786 ($2360.67 in chips) 
Seat 3: smoker player  ($485 in chips) 
Seat 4: spidy02 ($2388.72 in chips) 
Seat 5: Lucifer999 ($8641.83 in chips) 
Seat 6: devi7 ($8182.17 in chips) 
smoker player : posts small blind $10
spidy02: posts big blind $25
*** HOLE CARDS ***
Dealt to Lucifer999 [2d 6s]
Lucifer999: folds
devi7: folds
JaspritBumrah786: folds
smoker player : raises $25.00 to $50
spidy02: calls $25
*** FLOP *** [9d 6h 8s]
smoker player : bets $45
spidy02: calls $45
*** TURN *** [9d 6h 8s] [Ad]
smoker player : bets $85
spidy02: calls $85
*** RIVER *** [9d 6h 8s Ad] [Th]
smoker player : bets $169.05
spidy02: folds
Uncalled bet ($169.05) returned to smoker player 
smoker player : doesn't show hand
smoker player  collected $338.1 from pot
*** SUMMARY ***
Total pot $360.00 | Rake $21.9
Board [9d 6h 8s Ad Th]
Seat 1: JaspritBumrah786 (button) folded before Flop (didn't bet)
Seat 3: smoker player  (small blind) collected ($338.1)
Seat 4: spidy02 (big blind) folded on the River
Seat 5: Lucifer999 folded before Flop (didn't bet)
Seat 6: devi7 folded before Flop (didn't bet)



PokerStars Game #00327553813: Hold'em No Limit ($10/$25 USD) - 2022/04/30 12:09:08 ET
Table 'Hold'em (Min 500Max 2500) 1001' 6-max Seat #5 is the button
Seat 3: movetome ($2025 in chips) 
Seat 4: devi7 ($2404.57 in chips) 
Seat 5: Lucifer999 ($3530.76 in chips) 
Seat 6: spidy02 ($4701.95 in chips) 
spidy02: posts small blind $10
movetome: posts big blind $25
*** HOLE CARDS ***
Dealt to Lucifer999 [8d Qc]
devi7: folds
Lucifer999: folds
spidy02: calls $15
movetome: checks
*** FLOP *** [Qs 6h Th]
spidy02: checks
movetome: checks
*** TURN *** [Qs 6h Th] [9c]
spidy02: checks
movetome: bets $25
spidy02: folds
Uncalled bet ($25) returned to movetome
movetome: doesn't show hand
movetome collected $47.38 from pot
*** SUMMARY ***
Total pot $50.00 | Rake $2.62
Board [Qs 6h Th 9c]
Seat 3: movetome (big blind) collected ($47.38)
Seat 4: devi7 folded before Flop (didn't bet)
Seat 5: Lucifer999 (button) folded before Flop (didn't bet)
Seat 6: spidy02 (small blind) folded on the Turn



PokerStars Game #00327553935: Hold'em No Limit ($50/$100 USD) - 2022/04/30 12:09:45 ET
Table 'Hold'em (Min 25KMax 10K)    69' 6-max Seat #6 is the button
Seat 1: Lucifer999 ($33124.11 in chips) 
Seat 3: Mpr@59  ($14077.26 in chips) 
Seat 5: tabby20 ($34374.93 in chips) 
Seat 6: manny007 ($3191.6 in chips) 
Lucifer999: posts small blind $50
Mpr@59 : posts big blind $100
*** HOLE CARDS ***
Dealt to Lucifer999 [Ks 8s]
tabby20: folds
manny007: calls $100
Lucifer999: calls $50
Mpr@59 : checks
*** FLOP *** [9h 3d 3s]
Lucifer999: checks
Mpr@59 : checks
manny007: bets $163.42
Lucifer999: folds
Mpr@59 : folds
Uncalled bet ($163.42) returned to manny007
manny007: doesn't show hand
manny007 collected $286.8 from pot
*** SUMMARY ***
Total pot $300.00 | Rake $13.2
Board [9h 3d 3s]
Seat 1: Lucifer999 (small blind) folded on the Flop
Seat 3: Mpr@59  (big blind) folded on the Flop
Seat 5: tabby20 folded before Flop (didn't bet)
Seat 6: manny007 (button) collected ($286.8)



PokerStars Game #00327554008: Hold'em No Limit ($10/$25 USD) - 2022/04/30 12:10:03 ET
Table 'Hold'em (Min 500Max 2500)  1282' 6-max Seat #3 is the button
Seat 1: JaspritBumrah786 ($2360.67 in chips) 
Seat 3: smoker player  ($643.1 in chips) 
Seat 4: spidy02 ($2208.72 in chips) 
Seat 5: Lucifer999 ($8641.83 in chips) 
Seat 6: devi7 ($8182.17 in chips) 
spidy02: posts small blind $10
Lucifer999: posts big blind $25
*** HOLE CARDS ***
Dealt to Lucifer999 [8d Tc]
devi7: folds
JaspritBumrah786: folds
smoker player : folds
spidy02: calls $15
Lucifer999: raises $55.00 to $80
spidy02: folds
Uncalled bet ($55) returned to Lucifer999
Lucifer999: doesn't show hand
Lucifer999 collected $50 from pot
*** SUMMARY ***
Total pot $50.00 | Rake $0
Board []
Seat 1: JaspritBumrah786 folded before Flop (didn't bet)
Seat 3: smoker player  (button) folded before Flop (didn't bet)
Seat 4: spidy02 (small blind) folded before Flop
Seat 5: Lucifer999 (big blind) collected ($50)
Seat 6: devi7 folded before Flop (didn't bet)



PokerStars Game #00327554017: Hold'em No Limit ($10/$25 USD) - 2022/04/30 12:10:05 ET
Table 'Hold'em (Min 500Max 2500) 1001' 6-max Seat #6 is the button
Seat 2: gangster100 ($1056.98 in chips) 
Seat 3: movetome ($2097.38 in chips) 
Seat 4: devi7 ($2404.57 in chips) 
Seat 5: Lucifer999 ($3530.76 in chips) 
Seat 6: spidy02 ($4676.95 in chips) 
movetome: posts small blind $10
devi7: posts big blind $25
*** HOLE CARDS ***
Dealt to Lucifer999 [5h 4h]
Lucifer999: raises $55.00 to $80
spidy02: folds
movetome: folds
devi7: raises $265.00 to $345
Lucifer999: folds
Uncalled bet ($265) returned to devi7
devi7: doesn't show hand
devi7 collected $170 from pot
*** SUMMARY ***
Total pot $170.00 | Rake $0
Board []
Seat 3: movetome (small blind) folded before Flop
Seat 4: devi7 (big blind) collected ($170)
Seat 5: Lucifer999 folded before Flop
Seat 6: spidy02 (button) folded before Flop (didn't bet)



PokerStars Game #00327554066: Hold'em No Limit ($50/$100 USD) - 2022/04/30 12:10:20 ET
Table 'Hold'em (Min 25KMax 10K)    69' 6-max Seat #1 is the button
Seat 1: Lucifer999 ($33024.11 in chips) 
Seat 3: Mpr@59  ($13977.26 in chips) 
Seat 5: tabby20 ($34374.93 in chips) 
Seat 6: manny007 ($3378.4 in chips) 
Mpr@59 : posts small blind $50
tabby20: posts big blind $100
*** HOLE CARDS ***
Dealt to Lucifer999 [6h Ah]
manny007: folds
Lucifer999: raises $200.00 to $300
Mpr@59 : folds
tabby20: folds
Uncalled bet ($200) returned to Lucifer999
Lucifer999: doesn't show hand
Lucifer999 collected $250 from pot
*** SUMMARY ***
Total pot $250.00 | Rake $0
Board []
Seat 1: Lucifer999 (button) collected ($250)
Seat 3: Mpr@59  (small blind) folded before Flop
Seat 5: tabby20 (big blind) folded before Flop
Seat 6: manny007 folded before Flop (didn't bet)



PokerStars Game #00327554145: Hold'em No Limit ($10/$25 USD) - 2022/04/30 12:10:37 ET
Table 'Hold'em (Min 500Max 2500) 1001' 6-max Seat #3 is the button
Seat 2: gangster100 ($1056.98 in chips) 
Seat 3: movetome ($2087.38 in chips) 
Seat 4: devi7 ($2494.57 in chips) 
Seat 5: Lucifer999 ($3450.76 in chips) 
Seat 6: spidy02 ($4676.95 in chips) 
devi7: posts small blind $10
Lucifer999: posts big blind $25
gangster100: posts big blind $25
*** HOLE CARDS ***
Dealt to Lucifer999 [Td 5s]
spidy02: folds
gangster100: checks
movetome: folds
devi7: raises $75.00 to $100
Lucifer999: folds
gangster100: raises $956.98 to $1056.98
devi7: folds
Uncalled bet ($956.98) returned to gangster100
gangster100: doesn't show hand
gangster100 collected $225 from pot
*** SUMMARY ***
Total pot $225.00 | Rake $0
Board []
Seat 2: gangster100 collected ($225)
Seat 3: movetome (button) folded before Flop (didn't bet)
Seat 4: devi7 (small blind) folded before Flop
Seat 5: Lucifer999 (big blind) folded before Flop
Seat 6: spidy02 folded before Flop (didn't bet)



PokerStars Game #00327553871: Hold'em No Limit ($25/$50 USD) - 2022/04/30 12:09:24 ET
Table 'Hold'em (Min 1K Max 5K)   216' 6-max Seat #6 is the button
Seat 1: Lucifer999 ($16295.86 in chips) 
Seat 2: rahulh1 ($3258.53 in chips) 
Seat 3: Millie ($5607.5 in chips) 
Seat 4: TheWay ($811.9 in chips) 
Seat 5: No username ($3651.82 in chips) 
Seat 6: Pablit0 ($925 in chips) 
Lucifer999: posts small blind $25
rahulh1: posts big blind $50
*** HOLE CARDS ***
Dealt to Lucifer999 [6c Jc]
Millie: calls $50
TheWay: folds
No username: raises $175.00 to $225
Pablit0: folds
Lucifer999: folds
rahulh1: calls $175
Millie: calls $175
*** FLOP *** [7h 3s 7s]
rahulh1: checks
Millie: bets $200
No username: calls $200
rahulh1: folds
*** TURN *** [7h 3s 7s] [6h]
Millie: checks
No username: bets $365.96
Millie: calls $365.96
*** RIVER *** [7h 3s 7s 6h] [Jh]
Millie: checks
No username: bets $1176.37
Millie: calls $1176.37
*** SHOW DOWN ***
No username: shows [Kc Qd] (Pair, 77)
Millie: shows [3h Ks] (Two pairs, 7733)
Millie collected $3975.46 from pot
*** SUMMARY ***
Total pot $4184.66 | Rake $209.2
Board [7h 3s 7s 6h Jh]
Seat 1: Lucifer999 (small blind) folded before Flop
Seat 2: rahulh1 (big blind) folded on the Flop
Seat 3: Millie  showed [3h Ks] and won ($3975.46) with Two pairs, 7733
Seat 4: TheWay folded before Flop (didn't bet)
Seat 5: No username showed [Kc Qd] and lost with Pair, 77
Seat 6: Pablit0 (button) folded before Flop (didn't bet)



PokerStars Game #00327554138: Hold'em No Limit ($10/$25 USD) - 2022/04/30 12:10:35 ET
Table 'Hold'em (Min 500Max 2500)  1282' 6-max Seat #4 is the button
Seat 1: JaspritBumrah786 ($2360.67 in chips) 
Seat 3: smoker player  ($643.1 in chips) 
Seat 4: spidy02 ($2183.72 in chips) 
Seat 5: Lucifer999 ($8666.83 in chips) 
Seat 6: devi7 ($8182.17 in chips) 
Lucifer999: posts small blind $10
JaspritBumrah786: posts big blind $25
*** HOLE CARDS ***
Dealt to Lucifer999 [Ad Ts]
smoker player : calls $25
spidy02: folds
Lucifer999: raises $85.00 to $110
JaspritBumrah786: calls $85
smoker player : folds
*** FLOP *** [2c 6c Kh]
Lucifer999: checks
JaspritBumrah786: checks
*** TURN *** [2c 6c Kh] [8d]
Lucifer999: bets $200
JaspritBumrah786: calls $200
*** RIVER *** [2c 6c Kh 8d] [8s]
Lucifer999: checks
JaspritBumrah786: checks
*** SHOW DOWN ***
Lucifer999: shows [Ad Ts] (Pair, 88)
JaspritBumrah786: shows [Kd 3d] (Two pairs, KK88)
JaspritBumrah786 collected $606.14 from pot
*** SUMMARY ***
Total pot $645.00 | Rake $38.86
Board [2c 6c Kh 8d 8s]
Seat 1: JaspritBumrah786  (big blind) showed [Kd 3d] and won ($606.14) with Two pairs, KK88
Seat 3: smoker player  folded before Flop
Seat 4: spidy02 (button) folded before Flop (didn't bet)
Seat 5: Lucifer999 (small blind) showed [Ad Ts] and lost with Pair, 88



PokerStars Game #00327554173: Hold'em No Limit ($50/$100 USD) - 2022/04/30 12:10:46 ET
Table 'Hold'em (Min 25KMax 10K)    69' 6-max Seat #3 is the button
Seat 1: Lucifer999 ($33174.11 in chips) 
Seat 3: Mpr@59  ($13927.26 in chips) 
Seat 5: tabby20 ($34274.93 in chips) 
Seat 6: manny007 ($3378.4 in chips) 
tabby20: posts small blind $50
manny007: posts big blind $100
*** HOLE CARDS ***
Dealt to Lucifer999 [Qh 2c]
Lucifer999: folds
Mpr@59 : calls $100
tabby20: calls $50
manny007: checks
*** FLOP *** [8d 9d 6c]
tabby20: checks
manny007: bets $143.4
Mpr@59 : calls $143.4
tabby20: folds
*** TURN *** [8d 9d 6c] [5s]
manny007: bets $100
Mpr@59 : calls $100
*** RIVER *** [8d 9d 6c 5s] [6h]
manny007: bets $100
Mpr@59 : calls $100
*** SHOW DOWN ***
manny007: shows [Jd 9c] (Two pairs, 9966)
Mpr@59 : shows [7h Ac] (Straight, 9-5)
Mpr@59  collected $943.42 from pot
*** SUMMARY ***
Total pot $986.80 | Rake $43.38
Board [8d 9d 6c 5s 6h]
Seat 1: Lucifer999 folded before Flop (didn't bet)
Seat 3: Mpr@59   (button) showed [7h Ac] and won ($943.42) with Straight, 9-5
Seat 5: tabby20 (small blind) folded on the Flop
Seat 6: manny007 (big blind) showed [Jd 9c] and lost with Two pairs, 9966



PokerStars Game #00327554329: Hold'em No Limit ($50/$100 USD) - 2022/04/30 12:11:29 ET
Table 'Hold'em (Min 25KMax 10K)    69' 6-max Seat #5 is the button
Seat 1: Lucifer999 ($33174.11 in chips) 
Seat 3: Mpr@59  ($14427.28 in chips) 
Seat 5: tabby20 ($34174.93 in chips) 
Seat 6: manny007 ($2935 in chips) 
manny007: posts small blind $50
Lucifer999: posts big blind $100
*** HOLE CARDS ***
Dealt to Lucifer999 [5s 6d]
Mpr@59 : folds
tabby20: raises $200.00 to $300
manny007: folds
Lucifer999: folds
Uncalled bet ($200) returned to tabby20
tabby20: doesn't show hand
tabby20 collected $250 from pot
*** SUMMARY ***
Total pot $250.00 | Rake $0
Board []
Seat 1: Lucifer999 (big blind) folded before Flop
Seat 3: Mpr@59  folded before Flop (didn't bet)
Seat 5: tabby20 (button) collected ($250)
Seat 6: manny007 (small blind) folded before Flop



PokerStars Game #00327554317: Hold'em No Limit ($10/$25 USD) - 2022/04/30 12:11:26 ET
Table 'Hold'em (Min 500Max 2500)  1282' 6-max Seat #5 is the button
Seat 1: JaspritBumrah786 ($2656.81 in chips) 
Seat 3: smoker player  ($618.1 in chips) 
Seat 4: spidy02 ($2183.72 in chips) 
Seat 5: Lucifer999 ($8356.83 in chips) 
JaspritBumrah786: posts small blind $10
smoker player : posts big blind $25
*** HOLE CARDS ***
Dealt to Lucifer999 [8s 6h]
spidy02: folds
Lucifer999: folds
JaspritBumrah786: folds
Uncalled bet ($15) returned to smoker player 
smoker player : doesn't show hand
smoker player  collected $20 from pot
*** SUMMARY ***
Total pot $20.00 | Rake $0
Board []
Seat 1: JaspritBumrah786 (small blind) folded before Flop
Seat 3: smoker player  (big blind) collected ($20)
Seat 4: spidy02 folded before Flop (didn't bet)
Seat 5: Lucifer999 (button) folded before Flop (didn't bet)



PokerStars Game #00327554264: Hold'em No Limit ($10/$25 USD) - 2022/04/30 12:11:12 ET
Table 'Hold'em (Min 500Max 2500) 1001' 6-max Seat #4 is the button
Seat 2: gangster100 ($1181.98 in chips) 
Seat 3: movetome ($2087.38 in chips) 
Seat 4: devi7 ($2394.57 in chips) 
Seat 5: Lucifer999 ($3425.76 in chips) 
Seat 6: spidy02 ($4676.95 in chips) 
Lucifer999: posts small blind $10
spidy02: posts big blind $25
*** HOLE CARDS ***
Dealt to Lucifer999 [Ac Qh]
gangster100: folds
movetome: folds
devi7: raises $50.00 to $75
Lucifer999: calls $65
spidy02: folds
*** FLOP *** [9s 3s 7c]
Lucifer999: checks
devi7: bets $108.78
Lucifer999: folds
Uncalled bet ($108.78) returned to devi7
devi7: doesn't show hand
devi7 collected $164.82 from pot
*** SUMMARY ***
Total pot $175.00 | Rake $10.18
Board [9s 3s 7c]
Seat 2: gangster100 folded before Flop (didn't bet)
Seat 3: movetome folded before Flop (didn't bet)
Seat 4: devi7 (button) collected ($164.82)
Seat 5: Lucifer999 (small blind) folded on the Flop
Seat 6: spidy02 (big blind) folded before Flop



PokerStars Game #00327554263: Hold'em No Limit ($25/$50 USD) - 2022/04/30 12:11:11 ET
Table 'Hold'em (Min 1K Max 5K)   216' 6-max Seat #1 is the button
Seat 1: Lucifer999 ($16270.86 in chips) 
Seat 3: Millie ($7615.63 in chips) 
Seat 4: TheWay ($811.9 in chips) 
Seat 5: No username ($1684.49 in chips) 
Seat 6: Pablit0 ($925 in chips) 
Millie: posts small blind $25
No username: posts big blind $50
*** HOLE CARDS ***
Dealt to Lucifer999 [8c Ac]
Pablit0: folds
Lucifer999: folds
Millie: folds
Uncalled bet ($25) returned to No username
No username: doesn't show hand
No username collected $50 from pot
*** SUMMARY ***
Total pot $50.00 | Rake $0
Board []
Seat 1: Lucifer999 (button) folded before Flop (didn't bet)
Seat 3: Millie (small blind) folded before Flop
Seat 5: No username (big blind) collected ($50)
Seat 6: Pablit0 folded before Flop (didn't bet)



PokerStars Game #00327554393: Hold'em No Limit ($50/$100 USD) - 2022/04/30 12:11:44 ET
Table 'Hold'em (Min 25KMax 10K)    69' 6-max Seat #6 is the button
Seat 1: Lucifer999 ($33074.11 in chips) 
Seat 3: Mpr@59  ($14427.28 in chips) 
Seat 5: tabby20 ($34324.93 in chips) 
Seat 6: manny007 ($2885 in chips) 
Lucifer999: posts small blind $50
Mpr@59 : posts big blind $100
*** HOLE CARDS ***
Dealt to Lucifer999 [6c 4h]
tabby20: folds
manny007: calls $100
Lucifer999: folds
Mpr@59 : checks
*** FLOP *** [3h 7s Ah]
Mpr@59 : checks
manny007: bets $179.25
Mpr@59 : folds
Uncalled bet ($179.25) returned to manny007
manny007: doesn't show hand
manny007 collected $239 from pot
*** SUMMARY ***
Total pot $250.00 | Rake $11
Board [3h 7s Ah]
Seat 1: Lucifer999 (small blind) folded before Flop
Seat 3: Mpr@59  (big blind) folded on the Flop
Seat 5: tabby20 folded before Flop (didn't bet)
Seat 6: manny007 (button) collected ($239)



PokerStars Game #00327554418: Hold'em No Limit ($10/$25 USD) - 2022/04/30 12:11:49 ET
Table 'Hold'em (Min 500Max 2500)  1282' 6-max Seat #1 is the button
Seat 1: JaspritBumrah786 ($2646.81 in chips) 
Seat 3: smoker player  ($628.1 in chips) 
Seat 4: spidy02 ($2183.72 in chips) 
Seat 5: Lucifer999 ($8356.83 in chips) 
smoker player : posts small blind $10
spidy02: posts big blind $25
*** HOLE CARDS ***
Dealt to Lucifer999 [Qs 2s]
Lucifer999: folds
JaspritBumrah786: raises $50.00 to $75
smoker player : folds
spidy02: folds
Uncalled bet ($50) returned to JaspritBumrah786
JaspritBumrah786: doesn't show hand
JaspritBumrah786 collected $60 from pot
*** SUMMARY ***
Total pot $60.00 | Rake $0
Board []
Seat 1: JaspritBumrah786 (button) collected ($60)
Seat 3: smoker player  (small blind) folded before Flop
Seat 4: spidy02 (big blind) folded before Flop
Seat 5: Lucifer999 folded before Flop (didn't bet)



PokerStars Game #00327554502: Hold'em No Limit ($10/$25 USD) - 2022/04/30 12:12:12 ET
Table 'Hold'em (Min 500Max 2500)  1282' 6-max Seat #3 is the button
Seat 1: JaspritBumrah786 ($2681.81 in chips) 
Seat 3: smoker player  ($618.1 in chips) 
Seat 4: spidy02 ($2158.72 in chips) 
Seat 5: Lucifer999 ($8356.83 in chips) 
spidy02: posts small blind $10
Lucifer999: posts big blind $25
*** HOLE CARDS ***
Dealt to Lucifer999 [Kc 4h]
JaspritBumrah786: folds
smoker player : folds
spidy02: folds
Uncalled bet ($15) returned to Lucifer999
Lucifer999: doesn't show hand
Lucifer999 collected $20 from pot
*** SUMMARY ***
Total pot $20.00 | Rake $0
Board []
Seat 1: JaspritBumrah786 folded before Flop (didn't bet)
Seat 3: smoker player  (button) folded before Flop (didn't bet)
Seat 4: spidy02 (small blind) folded before Flop
Seat 5: Lucifer999 (big blind) collected ($20)



PokerStars Game #00327554474: Hold'em No Limit ($50/$100 USD) - 2022/04/30 12:12:04 ET
Table 'Hold'em (Min 25KMax 10K)    69' 6-max Seat #1 is the button
Seat 1: Lucifer999 ($33024.11 in chips) 
Seat 3: Mpr@59  ($14327.28 in chips) 
Seat 5: tabby20 ($34324.93 in chips) 
Seat 6: manny007 ($3024 in chips) 
Mpr@59 : posts small blind $50
tabby20: posts big blind $100
*** HOLE CARDS ***
Dealt to Lucifer999 [8d 2c]
manny007: calls $100
Lucifer999: folds
Mpr@59 : folds
tabby20: checks
*** FLOP *** [9h 9s 6d]
tabby20: bets $200
manny007: folds
Uncalled bet ($200) returned to tabby20
tabby20: doesn't show hand
tabby20 collected $239 from pot
*** SUMMARY ***
Total pot $250.00 | Rake $11
Board [9h 9s 6d]
Seat 1: Lucifer999 (button) folded before Flop (didn't bet)
Seat 3: Mpr@59  (small blind) folded before Flop
Seat 5: tabby20 (big blind) collected ($239)
Seat 6: manny007 folded on the Flop



PokerStars Game #00327554532: Hold'em No Limit ($10/$25 USD) - 2022/04/30 12:12:20 ET
Table 'Hold'em (Min 500Max 2500)  1282' 6-max Seat #4 is the button
Seat 1: JaspritBumrah786 ($2681.81 in chips) 
Seat 3: smoker player  ($618.1 in chips) 
Seat 4: spidy02 ($2148.72 in chips) 
Seat 5: Lucifer999 ($8366.83 in chips) 
Lucifer999: posts small blind $10
JaspritBumrah786: posts big blind $25
*** HOLE CARDS ***
Dealt to Lucifer999 [Ad 6h]
smoker player : calls $25
spidy02: folds
Lucifer999: raises $75.00 to $100
JaspritBumrah786: folds
smoker player : folds
Uncalled bet ($75) returned to Lucifer999
Lucifer999: doesn't show hand
Lucifer999 collected $75 from pot
*** SUMMARY ***
Total pot $75.00 | Rake $0
Board []
Seat 1: JaspritBumrah786 (big blind) folded before Flop
Seat 3: smoker player  folded before Flop
Seat 4: spidy02 (button) folded before Flop (didn't bet)
Seat 5: Lucifer999 (small blind) collected ($75)



PokerStars Game #00327554430: Hold'em No Limit ($10/$25 USD) - 2022/04/30 12:11:54 ET
Table 'Hold'em (Min 500Max 2500) 1001' 6-max Seat #5 is the button
Seat 1: Mastkalandar ($520 in chips) 
Seat 2: gangster100 ($1181.98 in chips) 
Seat 3: movetome ($2087.38 in chips) 
Seat 4: devi7 ($2484.39 in chips) 
Seat 5: Lucifer999 ($3350.76 in chips) 
Seat 6: spidy02 ($4651.95 in chips) 
spidy02: posts small blind $10
gangster100: posts big blind $25
*** HOLE CARDS ***
Dealt to Lucifer999 [4c 3h]
movetome: raises $50.00 to $75
devi7: folds
Lucifer999: folds
spidy02: raises $115.00 to $190
gangster100: folds
movetome: calls $115
*** FLOP *** [2s 9h 6c]
spidy02: checks
movetome: checks
*** TURN *** [2s 9h 6c] [Kc]
spidy02: bets $245.81
movetome: folds
Uncalled bet ($245.81) returned to spidy02
spidy02: doesn't show hand
spidy02 collected $379.74 from pot
*** SUMMARY ***
Total pot $405.00 | Rake $25.26
Board [2s 9h 6c Kc]
Seat 2: gangster100 (big blind) folded before Flop
Seat 3: movetome folded on the Turn
Seat 4: devi7 folded before Flop (didn't bet)
Seat 5: Lucifer999 (button) folded before Flop (didn't bet)
Seat 6: spidy02 (small blind) collected ($379.74)



PokerStars Game #00327554551: Hold'em No Limit ($50/$100 USD) - 2022/04/30 12:12:25 ET
Table 'Hold'em (Min 25KMax 10K)    69' 6-max Seat #3 is the button
Seat 1: Lucifer999 ($33024.11 in chips) 
Seat 3: Mpr@59  ($14277.28 in chips) 
Seat 5: tabby20 ($34463.93 in chips) 
Seat 6: manny007 ($2924 in chips) 
tabby20: posts small blind $50
manny007: posts big blind $100
*** HOLE CARDS ***
Dealt to Lucifer999 [Ks Qd]
Lucifer999: raises $200.00 to $300
Mpr@59 : folds
tabby20: folds
manny007: folds
Uncalled bet ($200) returned to Lucifer999
Lucifer999: doesn't show hand
Lucifer999 collected $250 from pot
*** SUMMARY ***
Total pot $250.00 | Rake $0
Board []
Seat 1: Lucifer999 collected ($250)
Seat 3: Mpr@59  (button) folded before Flop (didn't bet)
Seat 5: tabby20 (small blind) folded before Flop
Seat 6: manny007 (big blind) folded before Flop



PokerStars Game #00327554610: Hold'em No Limit ($10/$25 USD) - 2022/04/30 12:12:42 ET
Table 'Hold'em (Min 500Max 2500)  1282' 6-max Seat #5 is the button
Seat 1: JaspritBumrah786 ($2656.81 in chips) 
Seat 3: smoker player  ($593.1 in chips) 
Seat 4: spidy02 ($2148.72 in chips) 
Seat 5: Lucifer999 ($8416.83 in chips) 
JaspritBumrah786: posts small blind $10
smoker player : posts big blind $25
*** HOLE CARDS ***
Dealt to Lucifer999 [8c 5h]
spidy02: folds
Lucifer999: folds
JaspritBumrah786: folds
Uncalled bet ($15) returned to smoker player 
smoker player : doesn't show hand
smoker player  collected $20 from pot
*** SUMMARY ***
Total pot $20.00 | Rake $0
Board []
Seat 1: JaspritBumrah786 (small blind) folded before Flop
Seat 3: smoker player  (big blind) collected ($20)
Seat 4: spidy02 folded before Flop (didn't bet)
Seat 5: Lucifer999 (button) folded before Flop (didn't bet)



PokerStars Game #00327554413: Hold'em No Limit ($25/$50 USD) - 2022/04/30 12:11:49 ET
Table 'Hold'em (Min 1K Max 5K)   216' 6-max Seat #3 is the button
Seat 1: Lucifer999 ($16270.86 in chips) 
Seat 3: Millie ($7590.63 in chips) 
Seat 5: No username ($1709.49 in chips) 
Seat 6: Pablit0 ($925 in chips) 
No username: posts small blind $25
Pablit0: posts big blind $50
*** HOLE CARDS ***
Dealt to Lucifer999 [5s 7h]
Lucifer999: folds
Millie: calls $50
No username: calls $25
Pablit0: checks
*** FLOP *** [2c 3h Ad]
No username: checks
Pablit0: checks
Millie: checks
*** TURN *** [2c 3h Ad] [Js]
No username: checks
Pablit0: checks
Millie: checks
*** RIVER *** [2c 3h Ad Js] [Qs]
No username: checks
Pablit0: checks
Millie: checks
*** SHOW DOWN ***
No username: shows [6d 7c] (High card, A)
Pablit0: shows [Ts 8d] (High card, A)
Millie: shows [9h Ks] (High card, A)
Millie collected $142.5 from pot
*** SUMMARY ***
Total pot $150.00 | Rake $7.5
Board [2c 3h Ad Js Qs]
Seat 1: Lucifer999 folded before Flop (didn't bet)
Seat 3: Millie  (button) showed [9h Ks] and won ($142.5) with High card, A
Seat 5: No username (small blind) showed [6d 7c] and lost with High card, A
Seat 6: Pablit0 (big blind) showed [Ts 8d] and lost with High card, A



PokerStars Game #00327554642: Hold'em No Limit ($50/$100 USD) - 2022/04/30 12:12:51 ET
Table 'Hold'em (Min 25KMax 10K)    69' 6-max Seat #5 is the button
Seat 1: Lucifer999 ($33174.11 in chips) 
Seat 3: Mpr@59  ($14277.28 in chips) 
Seat 5: tabby20 ($34413.93 in chips) 
Seat 6: manny007 ($2824 in chips) 
manny007: posts small blind $50
Lucifer999: posts big blind $100
*** HOLE CARDS ***
Dealt to Lucifer999 [Ac 2h]
Mpr@59 : calls $100
tabby20: folds
manny007: folds
Lucifer999: raises $300.00 to $400
Mpr@59 : calls $300
*** FLOP *** [6s Js Ad]
Lucifer999: bets $800
Mpr@59 : folds
Uncalled bet ($800) returned to Lucifer999
Lucifer999: doesn't show hand
Lucifer999 collected $812.6 from pot
*** SUMMARY ***
Total pot $850.00 | Rake $37.4
Board [6s Js Ad]
Seat 1: Lucifer999 (big blind) collected ($812.6)
Seat 3: Mpr@59  folded on the Flop
Seat 5: tabby20 (button) folded before Flop (didn't bet)
Seat 6: manny007 (small blind) folded before Flop



PokerStars Game #00327554694: Hold'em No Limit ($10/$25 USD) - 2022/04/30 12:13:04 ET
Table 'Hold'em (Min 500Max 2500)  1282' 6-max Seat #1 is the button
Seat 1: JaspritBumrah786 ($2646.81 in chips) 
Seat 3: smoker player  ($603.1 in chips) 
Seat 4: spidy02 ($2148.72 in chips) 
Seat 5: Lucifer999 ($8416.83 in chips) 
smoker player : posts small blind $10
spidy02: posts big blind $25
*** HOLE CARDS ***
Dealt to Lucifer999 [7s 6s]
Lucifer999: raises $55.00 to $80
JaspritBumrah786: folds
smoker player : folds
spidy02: folds
Uncalled bet ($55) returned to Lucifer999
Lucifer999: doesn't show hand
Lucifer999 collected $60 from pot
*** SUMMARY ***
Total pot $60.00 | Rake $0
Board []
Seat 1: JaspritBumrah786 (button) folded before Flop (didn't bet)
Seat 3: smoker player  (small blind) folded before Flop
Seat 4: spidy02 (big blind) folded before Flop
Seat 5: Lucifer999 collected ($60)



PokerStars Game #00327554623: Hold'em No Limit ($10/$25 USD) - 2022/04/30 12:12:47 ET
Table 'Hold'em (Min 500Max 2500) 1001' 6-max Seat #6 is the button
Seat 1: shykko60 ($520 in chips) 
Seat 2: gangster100 ($1156.98 in chips) 
Seat 3: movetome ($2025 in chips) 
Seat 4: devi7 ($2484.39 in chips) 
Seat 5: Lucifer999 ($3350.76 in chips) 
Seat 6: spidy02 ($4841.69 in chips) 
gangster100: posts small blind $10
movetome: posts big blind $25
*** HOLE CARDS ***
Dealt to Lucifer999 [Td Kh]
devi7: folds
Lucifer999: raises $55.00 to $80
spidy02: calls $80
gangster100: calls $70
movetome: folds
*** FLOP *** [8c Kc 5s]
gangster100: checks
Lucifer999: checks
spidy02: checks
*** TURN *** [8c Kc 5s] [Jd]
gangster100: bets $186.82
Lucifer999: calls $186.82
spidy02: folds
*** RIVER *** [8c Kc 5s Jd] [7s]
gangster100: bets $300.08
Lucifer999: calls $300.08
*** SHOW DOWN ***
gangster100: shows [Js Ks] (Two pairs, KKJJ)
Lucifer999: doesn't show hand
gangster100 collected $1168.81 from pot
*** SUMMARY ***
Total pot $1238.80 | Rake $69.99
Board [8c Kc 5s Jd 7s]
Seat 2: gangster100  (small blind) showed [Js Ks] and won ($1168.81) with Two pairs, KKJJ
Seat 3: movetome (big blind) folded before Flop
Seat 4: devi7 folded before Flop (didn't bet)
Seat 5: Lucifer999 mucked
Seat 6: spidy02 (button) folded on the Turn



PokerStars Game #00327554799: Hold'em No Limit ($50/$100 USD) - 2022/04/30 12:13:34 ET
Table 'Hold'em (Min 25KMax 10K)    69' 6-max Seat #6 is the button
Seat 1: Lucifer999 ($33586.71 in chips) 
Seat 3: Mpr@59  ($13877.28 in chips) 
Seat 5: tabby20 ($34413.93 in chips) 
Seat 6: manny007 ($2774 in chips) 
Lucifer999: posts small blind $50
Mpr@59 : posts big blind $100
*** HOLE CARDS ***
Dealt to Lucifer999 [3d 7c]
tabby20: folds
manny007: folds
Lucifer999: folds
Uncalled bet ($50) returned to Mpr@59 
Mpr@59 : doesn't show hand
Mpr@59  collected $100 from pot
*** SUMMARY ***
Total pot $100.00 | Rake $0
Board []
Seat 1: Lucifer999 (small blind) folded before Flop
Seat 3: Mpr@59  (big blind) collected ($100)
Seat 5: tabby20 folded before Flop (didn't bet)
Seat 6: manny007 (button) folded before Flop (didn't bet)



PokerStars Game #00327554735: Hold'em No Limit ($25/$50 USD) - 2022/04/30 12:13:16 ET
Table 'Hold'em (Min 1K Max 5K)   216' 6-max Seat #5 is the button
Seat 1: Lucifer999 ($16270.86 in chips) 
Seat 3: Millie ($7683.13 in chips) 
Seat 5: No username ($1659.49 in chips) 
Seat 6: Pablit0 ($875 in chips) 
Pablit0: posts small blind $25
Lucifer999: posts big blind $50
*** HOLE CARDS ***
Dealt to Lucifer999 [Kd 5d]
No username: folds
Pablit0: calls $25
Lucifer999: raises $150.00 to $200
Pablit0: calls $150
*** FLOP *** [4d 4s 6c]
Pablit0: checks
Lucifer999: bets $150
Pablit0: calls $150
*** TURN *** [4d 4s 6c] [Jh]
Pablit0: checks
Lucifer999: bets $700
Pablit0: calls $525
Uncalled bet ($175) returned to Lucifer999
*** RIVER *** [4d 4s 6c Jh] [Ts]
*** RIVER *** [4d 4s 6c Jh] [2d]
*** SHOW DOWN ***
Lucifer999: shows [Kd 5d] (Pair, 44)
Pablit0: shows [4h Ad] (Three of a kind, 444)
Pablit0 collected $831.25 from pot
Pablit0 collected $831.25 from pot
*** SUMMARY ***
Total pot $1750.00 | Rake $87.5
Board [4d 4s 6c Jh Ts]
Seat 1: Lucifer999 (big blind) showed [Kd 5d] and lost with Pair, 44
Seat 5: No username (button) folded before Flop (didn't bet)
Seat 6: Pablit0  (small blind) showed [4h Ad] and won ($831.25) with Three of a kind, 444



PokerStars Game #00327554813: Hold'em No Limit ($10/$25 USD) - 2022/04/30 12:13:38 ET
Table 'Hold'em (Min 500Max 2500)  1282' 6-max Seat #3 is the button
Seat 1: JaspritBumrah786 ($2646.81 in chips) 
Seat 3: smoker player  ($593.1 in chips) 
Seat 4: spidy02 ($2123.72 in chips) 
Seat 5: Lucifer999 ($8451.83 in chips) 
spidy02: posts small blind $10
Lucifer999: posts big blind $25
*** HOLE CARDS ***
Dealt to Lucifer999 [Jd Ac]
JaspritBumrah786: raises $50.00 to $75
smoker player : folds
spidy02: folds
Lucifer999: calls $50
*** FLOP *** [5c 3c Ks]
Lucifer999: checks
JaspritBumrah786: bets $125
Lucifer999: folds
Uncalled bet ($125) returned to JaspritBumrah786
JaspritBumrah786: doesn't show hand
JaspritBumrah786 collected $150.6 from pot
*** SUMMARY ***
Total pot $160.00 | Rake $9.4
Board [5c 3c Ks]
Seat 1: JaspritBumrah786 collected ($150.6)
Seat 3: smoker player  (button) folded before Flop (didn't bet)
Seat 4: spidy02 (small blind) folded before Flop
Seat 5: Lucifer999 (big blind) folded on the Flop



PokerStars Game #00327554874: Hold'em No Limit ($50/$100 USD) - 2022/04/30 12:13:57 ET
Table 'Hold'em (Min 25KMax 10K)    69' 6-max Seat #1 is the button
Seat 1: Lucifer999 ($33536.71 in chips) 
Seat 3: Mpr@59  ($13927.28 in chips) 
Seat 5: tabby20 ($34413.93 in chips) 
Seat 6: manny007 ($2774 in chips) 
Mpr@59 : posts small blind $50
tabby20: posts big blind $100
*** HOLE CARDS ***
Dealt to Lucifer999 [4c Kd]
manny007: calls $100
Lucifer999: folds
Mpr@59 : calls $50
tabby20: checks
*** FLOP *** [9c 8d Qh]
Mpr@59 : checks
tabby20: bets $286.8
manny007: calls $286.8
Mpr@59 : folds
*** TURN *** [9c 8d Qh] [9s]
tabby20: bets $600
manny007: folds
Uncalled bet ($600) returned to tabby20
tabby20: doesn't show hand
tabby20 collected $835.19 from pot
*** SUMMARY ***
Total pot $873.60 | Rake $38.41
Board [9c 8d Qh 9s]
Seat 1: Lucifer999 (button) folded before Flop (didn't bet)
Seat 3: Mpr@59  (small blind) folded on the Flop
Seat 5: tabby20 (big blind) collected ($835.19)
Seat 6: manny007 folded on the Turn



PokerStars Game #00327554865: Hold'em No Limit ($10/$25 USD) - 2022/04/30 12:13:54 ET
Table 'Hold'em (Min 500Max 2500) 1001' 6-max Seat #2 is the button
Seat 1: shykko60 ($520 in chips) 
Seat 2: gangster100 ($1758.89 in chips) 
Seat 3: movetome ($2000 in chips) 
Seat 4: devi7 ($2484.39 in chips) 
Seat 5: Lucifer999 ($2783.86 in chips) 
Seat 6: spidy02 ($4761.69 in chips) 
movetome: posts small blind $10
devi7: posts big blind $25
shykko60: posts big blind $25
*** HOLE CARDS ***
Dealt to Lucifer999 [5d 7h]
Lucifer999: folds
spidy02: raises $57.50 to $82.5
shykko60: folds
gangster100: calls $82.5
movetome: folds
devi7: folds
*** FLOP *** [2h 7d Tc]
spidy02: bets $105.6
gangster100: raises $158.40 to $264
spidy02: calls $158.4
*** TURN *** [2h 7d Tc] [5h]
spidy02: checks
gangster100: bets $437.02
spidy02: folds
Uncalled bet ($437.02) returned to gangster100
gangster100: doesn't show hand
gangster100 collected $708.47 from pot
*** SUMMARY ***
Total pot $753.00 | Rake $44.53
Board [2h 7d Tc 5h]
Seat 1: shykko60 folded before Flop
Seat 2: gangster100 (button) collected ($708.47)
Seat 3: movetome (small blind) folded before Flop
Seat 4: devi7 (big blind) folded before Flop
Seat 5: Lucifer999 folded before Flop (didn't bet)
Seat 6: spidy02 folded on the Turn



PokerStars Game #00327554927: Hold'em No Limit ($25/$50 USD) - 2022/04/30 12:14:10 ET
Table 'Hold'em (Min 1K Max 5K)   216' 6-max Seat #6 is the button
Seat 1: Lucifer999 ($15395.86 in chips) 
Seat 3: Millie ($7683.13 in chips) 
Seat 5: No username ($1659.49 in chips) 
Seat 6: Pablit0 ($1662.5 in chips) 
Lucifer999: posts small blind $25
No username: posts big blind $50
*** HOLE CARDS ***
Dealt to Lucifer999 [5h 4c]
Pablit0: calls $50
Lucifer999: folds
No username: checks
*** FLOP *** [3d Jc 8h]
No username: checks
Pablit0: checks
*** TURN *** [3d Jc 8h] [Qd]
No username: bets $59.38
Pablit0: calls $59.38
*** RIVER *** [3d Jc 8h Qd] [Td]
No username: bets $50
Pablit0: raises $331.61 to $381.61
No username: folds
Uncalled bet ($331.61) returned to Pablit0
Pablit0: doesn't show hand
Pablit0 collected $326.61 from pot
*** SUMMARY ***
Total pot $343.76 | Rake $17.15
Board [3d Jc 8h Qd Td]
Seat 1: Lucifer999 (small blind) folded before Flop
Seat 5: No username (big blind) folded on the River
Seat 6: Pablit0 (button) collected ($326.61)



PokerStars Game #00327554982: Hold'em No Limit ($10/$25 USD) - 2022/04/30 12:14:24 ET
Table 'Hold'em (Min 500Max 2500)  1282' 6-max Seat #4 is the button
Seat 1: JaspritBumrah786 ($2722.41 in chips) 
Seat 3: smoker player  ($593.1 in chips) 
Seat 4: spidy02 ($2113.72 in chips) 
Seat 5: Lucifer999 ($8376.83 in chips) 
Lucifer999: posts small blind $10
JaspritBumrah786: posts big blind $25
*** HOLE CARDS ***
Dealt to Lucifer999 [7d Js]
smoker player : calls $25
spidy02: calls $25
Lucifer999: folds
JaspritBumrah786: checks
*** FLOP *** [6s 2h 5s]
JaspritBumrah786: bets $50
smoker player : folds
spidy02: folds
Uncalled bet ($50) returned to JaspritBumrah786
JaspritBumrah786: doesn't show hand
JaspritBumrah786 collected $80.54 from pot
*** SUMMARY ***
Total pot $85.00 | Rake $4.46
Board [6s 2h 5s]
Seat 1: JaspritBumrah786 (big blind) collected ($80.54)
Seat 3: smoker player  folded on the Flop
Seat 4: spidy02 (button) folded on the Flop
Seat 5: Lucifer999 (small blind) folded before Flop



PokerStars Game #00327555063: Hold'em No Limit ($10/$25 USD) - 2022/04/30 12:14:45 ET
Table 'Hold'em (Min 500Max 2500) 1001' 6-max Seat #3 is the button
Seat 1: shykko60 ($495 in chips) 
Seat 2: gangster100 ($2120.86 in chips) 
Seat 3: movetome ($2025 in chips) 
Seat 4: devi7 ($2459.39 in chips) 
Seat 5: Lucifer999 ($2783.86 in chips) 
Seat 6: spidy02 ($4415.19 in chips) 
devi7: posts small blind $10
Lucifer999: posts big blind $25
*** HOLE CARDS ***
Dealt to Lucifer999 [6s Kd]
spidy02: folds
shykko60: folds
gangster100: raises $31.67 to $56.67
movetome: folds
devi7: folds
Lucifer999: folds
Uncalled bet ($31.67) returned to gangster100
gangster100: doesn't show hand
gangster100 collected $60 from pot
*** SUMMARY ***
Total pot $60.00 | Rake $0
Board []
Seat 1: shykko60 folded before Flop (didn't bet)
Seat 2: gangster100 collected ($60)
Seat 3: movetome (button) folded before Flop (didn't bet)
Seat 4: devi7 (small blind) folded before Flop
Seat 5: Lucifer999 (big blind) folded before Flop
Seat 6: spidy02 folded before Flop (didn't bet)



PokerStars Game #00327555085: Hold'em No Limit ($25/$50 USD) - 2022/04/30 12:14:51 ET
Table 'Hold'em (Min 1K Max 5K)   216' 6-max Seat #1 is the button
Seat 1: Lucifer999 ($15370.86 in chips) 
Seat 3: Millie ($7683.13 in chips) 
Seat 5: No username ($1500.11 in chips) 
Seat 6: Pablit0 ($1829.73 in chips) 
No username: posts small blind $25
Pablit0: posts big blind $50
*** HOLE CARDS ***
Dealt to Lucifer999 [Tc 3s]
Lucifer999: folds
No username: raises $100.00 to $150
Pablit0: folds
Uncalled bet ($100) returned to No username
No username: doesn't show hand
No username collected $100 from pot
*** SUMMARY ***
Total pot $100.00 | Rake $0
Board []
Seat 1: Lucifer999 (button) folded before Flop (didn't bet)
Seat 5: No username (small blind) collected ($100)
Seat 6: Pablit0 (big blind) folded before Flop



PokerStars Game #00327555018: Hold'em No Limit ($50/$100 USD) - 2022/04/30 12:14:33 ET
Table 'Hold'em (Min 25KMax 10K)    69' 6-max Seat #3 is the button
Seat 1: Lucifer999 ($33536.71 in chips) 
Seat 3: Mpr@59  ($13827.28 in chips) 
Seat 4: MSTHEBOSS ($5000 in chips) 
Seat 5: tabby20 ($34862.32 in chips) 
Seat 6: manny007 ($2387.2 in chips) 
tabby20: posts small blind $50
manny007: posts big blind $100
*** HOLE CARDS ***
Dealt to Lucifer999 [3c 8s]
Lucifer999: folds
Mpr@59 : calls $100
tabby20: calls $50
manny007: checks
*** FLOP *** [2c 4s Kh]
tabby20: checks
manny007: checks
Mpr@59 : checks
*** TURN *** [2c 4s Kh] [7d]
tabby20: bets $200
manny007: folds
Mpr@59 : calls $200
*** RIVER *** [2c 4s Kh 7d] [9d]
tabby20: bets $300
Mpr@59 : calls $300
*** SHOW DOWN ***
tabby20: shows [Th 6d] (High card, K)
Mpr@59 : shows [Qd 7c] (Pair, 77)
Mpr@59  collected $1242.8 from pot
*** SUMMARY ***
Total pot $1300.00 | Rake $57.2
Board [2c 4s Kh 7d 9d]
Seat 1: Lucifer999 folded before Flop (didn't bet)
Seat 3: Mpr@59   (button) showed [Qd 7c] and won ($1242.8) with Pair, 77
Seat 5: tabby20 (small blind) showed [Th 6d] and lost with High card, K
Seat 6: manny007 (big blind) folded on the Turn



PokerStars Game #00327555125: Hold'em No Limit ($10/$25 USD) - 2022/04/30 12:15:02 ET
Table 'Hold'em (Min 500Max 2500)  1282' 6-max Seat #5 is the button
Seat 1: JaspritBumrah786 ($2777.95 in chips) 
Seat 3: smoker player  ($568.1 in chips) 
Seat 4: spidy02 ($2088.72 in chips) 
Seat 5: Lucifer999 ($8366.83 in chips) 
JaspritBumrah786: posts small blind $10
smoker player : posts big blind $25
*** HOLE CARDS ***
Dealt to Lucifer999 [4c 5c]
spidy02: raises $60.00 to $85
Lucifer999: calls $85
JaspritBumrah786: folds
smoker player : folds
*** FLOP *** [Jh Ah 5d]
spidy02: bets $144.18
Lucifer999: folds
Uncalled bet ($144.18) returned to spidy02
spidy02: doesn't show hand
spidy02 collected $192.24 from pot
*** SUMMARY ***
Total pot $205.00 | Rake $12.76
Board [Jh Ah 5d]
Seat 1: JaspritBumrah786 (small blind) folded before Flop
Seat 3: smoker player  (big blind) folded before Flop
Seat 4: spidy02 collected ($192.24)
Seat 5: Lucifer999 (button) folded on the Flop



PokerStars Game #00327555199: Hold'em No Limit ($50/$100 USD) - 2022/04/30 12:15:22 ET
Table 'Hold'em (Min 25KMax 10K)    69' 6-max Seat #5 is the button
Seat 1: Lucifer999 ($33536.71 in chips) 
Seat 3: Mpr@59  ($14470.08 in chips) 
Seat 4: MSTHEBOSS ($5000 in chips) 
Seat 5: tabby20 ($34262.32 in chips) 
Seat 6: manny007 ($2287.2 in chips) 
manny007: posts small blind $50
Lucifer999: posts big blind $100
MSTHEBOSS: posts big blind $100
*** HOLE CARDS ***
Dealt to Lucifer999 [4d Qc]
Mpr@59 : folds
MSTHEBOSS: raises $250.00 to $350
tabby20: folds
manny007: calls $300
Lucifer999: folds
*** FLOP *** [9c 8h 5c]
manny007: bets $764.8
MSTHEBOSS: raises $3885.20 to $4650
manny007: calls $1172.4
Uncalled bet ($2712.8) returned to MSTHEBOSS
*** TURN *** [9c 8h 5c] [6h]
*** TURN *** [9c 8h 5c] [3d]
*** RIVER *** [9c 8h 5c 6h] [2c]
*** RIVER *** [9c 8h 5c 6h] [4c]
*** SHOW DOWN ***
MSTHEBOSS: shows [Th Qh] (High card, Q)
manny007: shows [Jh 9s] (Pair, 99)
manny007 collected $2234.38 from pot
manny007 collected $2234.37 from pot
*** SUMMARY ***
Total pot $4674.40 | Rake $205.65
Board [9c 8h 5c 6h 2c]
Seat 1: Lucifer999 (big blind) folded before Flop
Seat 3: Mpr@59  folded before Flop (didn't bet)
Seat 4: MSTHEBOSS showed [Th Qh] and lost with High card, Q
Seat 5: tabby20 (button) folded before Flop (didn't bet)
Seat 6: manny007  (small blind) showed [Jh 9s] and won ($2234.37) with Pair, 99



PokerStars Game #00327555194: Hold'em No Limit ($25/$50 USD) - 2022/04/30 12:15:20 ET
Table 'Hold'em (Min 1K Max 5K)   216' 6-max Seat #5 is the button
Seat 1: Lucifer999 ($15370.86 in chips) 
Seat 3: Millie ($7683.13 in chips) 
Seat 5: No username ($1550.11 in chips) 
Seat 6: Pablit0 ($1779.73 in chips) 
Pablit0: posts small blind $25
Lucifer999: posts big blind $50
*** HOLE CARDS ***
Dealt to Lucifer999 [Qs 7h]
No username: raises $66.67 to $116.67
Pablit0: calls $91.67
Lucifer999: folds
*** FLOP *** [Jc 3c Th]
Pablit0: checks
No username: bets $134.6
Pablit0: raises $201.90 to $336.5
No username: raises $565.37 to $901.87
Pablit0: raises $761.19 to $1663.06
No username: calls $531.57
Uncalled bet ($229.62) returned to Pablit0
*** TURN *** [Jc 3c Th] [Tc]
*** TURN *** [Jc 3c Th] [7c]
*** RIVER *** [Jc 3c Th Tc] [5c]
*** RIVER *** [Jc 3c Th Tc] [Kh]
*** SHOW DOWN ***
No username: shows [Js Ts] (Two pairs, JJTT)
Pablit0: shows [Td 8d] (Pair, TT)
No username collected $1496.36 from pot
No username collected $1496.36 from pot
*** SUMMARY ***
Total pot $3150.22 | Rake $157.5
Board [Jc 3c Th Tc 5c]
Seat 1: Lucifer999 (big blind) folded before Flop
Seat 5: No username  (button) showed [Js Ts] and won ($1496.36) with Two pairs, JJTT
Seat 6: Pablit0 (small blind) showed [Td 8d] and lost with Pair, TT



PokerStars Game #00327555343: Hold'em No Limit ($50/$100 USD) - 2022/04/30 12:15:58 ET
Table 'Hold'em (Min 25KMax 10K)    69' 6-max Seat #6 is the button
Seat 1: Lucifer999 ($33436.71 in chips) 
Seat 3: Mpr@59  ($14470.08 in chips) 
Seat 4: MSTHEBOSS ($2712.8 in chips) 
Seat 5: tabby20 ($34262.32 in chips) 
Seat 6: manny007 ($4468.75 in chips) 
Lucifer999: posts small blind $50
Mpr@59 : posts big blind $100
*** HOLE CARDS ***
Dealt to Lucifer999 [6s Jh]
MSTHEBOSS: folds
tabby20: folds
manny007: folds
Lucifer999: folds
Uncalled bet ($50) returned to Mpr@59 
Mpr@59 : doesn't show hand
Mpr@59  collected $100 from pot
*** SUMMARY ***
Total pot $100.00 | Rake $0
Board []
Seat 1: Lucifer999 (small blind) folded before Flop
Seat 3: Mpr@59  (big blind) collected ($100)
Seat 4: MSTHEBOSS folded before Flop (didn't bet)
Seat 5: tabby20 folded before Flop (didn't bet)
Seat 6: manny007 (button) folded before Flop (didn't bet)



PokerStars Game #00327555171: Hold'em No Limit ($10/$25 USD) - 2022/04/30 12:15:13 ET
Table 'Hold'em (Min 500Max 2500) 1001' 6-max Seat #4 is the button
Seat 1: shykko60 ($495 in chips) 
Seat 2: gangster100 ($2155.86 in chips) 
Seat 3: movetome ($2025 in chips) 
Seat 4: devi7 ($2449.39 in chips) 
Seat 5: Lucifer999 ($2758.86 in chips) 
Seat 6: spidy02 ($4415.19 in chips) 
Lucifer999: posts small blind $10
spidy02: posts big blind $25
*** HOLE CARDS ***
Dealt to Lucifer999 [Js 8s]
shykko60: folds
gangster100: raises $45.46 to $70.46
movetome: calls $70.46
devi7: folds
Lucifer999: folds
spidy02: calls $45.46
*** FLOP *** [Kh 3h Ks]
spidy02: checks
gangster100: bets $103.89
movetome: calls $103.89
spidy02: raises $207.78 to $311.67
gangster100: folds
movetome: calls $207.78
*** TURN *** [Kh 3h Ks] [Ad]
spidy02: bets $446.92
movetome: folds
Uncalled bet ($446.92) returned to spidy02
spidy02: doesn't show hand
spidy02 collected $893.84 from pot
*** SUMMARY ***
Total pot $948.61 | Rake $54.77
Board [Kh 3h Ks Ad]
Seat 1: shykko60 folded before Flop (didn't bet)
Seat 2: gangster100 folded on the Flop
Seat 3: movetome folded on the Turn
Seat 4: devi7 (button) folded before Flop (didn't bet)
Seat 5: Lucifer999 (small blind) folded before Flop
Seat 6: spidy02 (big blind) collected ($893.84)



PokerStars Game #00327555401: Hold'em No Limit ($25/$50 USD) - 2022/04/30 12:16:14 ET
Table 'Hold'em (Min 1K Max 5K)   216' 6-max Seat #6 is the button
Seat 1: Lucifer999 ($15320.86 in chips) 
Seat 3: Millie ($7683.13 in chips) 
Seat 5: No username ($2992.72 in chips) 
Seat 6: Pablit0 ($229.62 in chips) 
Lucifer999: posts small blind $25
No username: posts big blind $50
*** HOLE CARDS ***
Dealt to Lucifer999 [Th 4h]
Lucifer999: folds
No username: raises $275.00 to $325
Pablit0: calls $129.62
Uncalled bet ($95.38) returned to No username
*** FLOP *** [Qs 5h 5s]
*** FLOP *** [8d 4c Jh]
*** TURN *** [Qs 5h 5s] [5d]
*** TURN *** [Qs 5h 5s] [Jd]
*** RIVER *** [Qs 5h 5s 5d] [2s]
*** RIVER *** [Qs 5h 5s 5d] [7h]
*** SHOW DOWN ***
No username: shows [6h 6s] (Two pairs, JJ66)
Pablit0: shows [Ac Td] (Pair, JJ)
No username collected $230.02 from pot
No username collected $230.02 from pot
*** SUMMARY ***
Total pot $484.24 | Rake $24.2
Board [Qs 5h 5s 5d 2s]
Seat 1: Lucifer999 (small blind) folded before Flop
Seat 5: No username  (big blind) showed [6h 6s] and won ($230.02) with Two pairs, JJ66
Seat 6: Pablit0 (button) showed [Ac Td] and lost with Pair, JJ



PokerStars Game #00327555249: Hold'em No Limit ($10/$25 USD) - 2022/04/30 12:15:36 ET
Table 'Hold'em (Min 500Max 2500)  1282' 6-max Seat #1 is the button
Seat 1: JaspritBumrah786 ($2767.95 in chips) 
Seat 3: smoker player  ($543.1 in chips) 
Seat 4: spidy02 ($2195.96 in chips) 
Seat 5: Lucifer999 ($8281.83 in chips) 
Seat 6: jas8k ($1000 in chips) 
smoker player : posts small blind $10
spidy02: posts big blind $25
jas8k: posts big blind $25
*** HOLE CARDS ***
Dealt to Lucifer999 [Ah 2h]
Lucifer999: folds
jas8k: checks
JaspritBumrah786: folds
smoker player : calls $15
spidy02: checks
*** FLOP *** [Qh 5h 5s]
smoker player : checks
spidy02: checks
jas8k: checks
*** TURN *** [Qh 5h 5s] [2d]
smoker player : checks
spidy02: checks
jas8k: checks
*** RIVER *** [Qh 5h 5s 2d] [5c]
smoker player : checks
spidy02: checks
jas8k: bets $71.07
smoker player : folds
spidy02: folds
Uncalled bet ($71.07) returned to jas8k
jas8k: doesn't show hand
jas8k collected $71.07 from pot
*** SUMMARY ***
Total pot $75.00 | Rake $3.93
Board [Qh 5h 5s 2d 5c]
Seat 1: JaspritBumrah786 (button) folded before Flop (didn't bet)
Seat 3: smoker player  (small blind) folded on the River
Seat 4: spidy02 (big blind) folded on the River
Seat 5: Lucifer999 folded before Flop (didn't bet)
Seat 6: jas8k collected ($71.07)



PokerStars Game #00327555431: Hold'em No Limit ($50/$100 USD) - 2022/04/30 12:16:22 ET
Table 'Hold'em (Min 25KMax 10K)    69' 6-max Seat #1 is the button
Seat 1: Lucifer999 ($33386.71 in chips) 
Seat 3: Mpr@59  ($14520.08 in chips) 
Seat 4: MSTHEBOSS ($2782.8 in chips) 
Seat 5: tabby20 ($34262.32 in chips) 
Seat 6: manny007 ($4468.75 in chips) 
Mpr@59 : posts small blind $50
MSTHEBOSS: posts big blind $100
*** HOLE CARDS ***
Dealt to Lucifer999 [Kh 8c]
tabby20: folds
manny007: folds
Lucifer999: folds
Mpr@59 : calls $50
MSTHEBOSS: checks
*** FLOP *** [Qh 7h 6c]
Mpr@59 : checks
MSTHEBOSS: checks
*** TURN *** [Qh 7h 6c] [Th]
Mpr@59 : checks
MSTHEBOSS: checks
*** RIVER *** [Qh 7h 6c Th] [5c]
Mpr@59 : bets $100
MSTHEBOSS: calls $100
*** SHOW DOWN ***
Mpr@59 : shows [Ah 5d] (Pair, 55)
MSTHEBOSS: doesn't show hand
Mpr@59  collected $382.4 from pot
*** SUMMARY ***
Total pot $400.00 | Rake $17.6
Board [Qh 7h 6c Th 5c]
Seat 1: Lucifer999 (button) folded before Flop (didn't bet)
Seat 3: Mpr@59   (small blind) showed [Ah 5d] and won ($382.4) with Pair, 55
Seat 4: MSTHEBOSS (big blind) mucked
Seat 5: tabby20 folded before Flop (didn't bet)
Seat 6: manny007 folded before Flop (didn't bet)



PokerStars Game #00327555436: Hold'em No Limit ($10/$25 USD) - 2022/04/30 12:16:22 ET
Table 'Hold'em (Min 500Max 2500) 1001' 6-max Seat #5 is the button
Seat 1: shykko60 ($495 in chips) 
Seat 2: gangster100 ($1981.51 in chips) 
Seat 3: movetome ($1713.33 in chips) 
Seat 4: devi7 ($2449.39 in chips) 
Seat 5: Lucifer999 ($2748.86 in chips) 
Seat 6: spidy02 ($4926.9 in chips) 
spidy02: posts small blind $10
shykko60: posts big blind $25
*** HOLE CARDS ***
Dealt to Lucifer999 [Ah 4d]
gangster100: folds
movetome: folds
devi7: raises $50.00 to $75
Lucifer999: folds
spidy02: folds
shykko60: calls $50
*** FLOP *** [3h 4s Kh]
shykko60: checks
devi7: checks
*** TURN *** [3h 4s Kh] [Qc]
shykko60: checks
devi7: checks
*** RIVER *** [3h 4s Kh Qc] [9s]
shykko60: checks
devi7: checks
*** SHOW DOWN ***
devi7: shows [6c 6d] (Pair, 66)
shykko60: shows [7h 9c] (Pair, 99)
shykko60 collected $150.6 from pot
*** SUMMARY ***
Total pot $160.00 | Rake $9.4
Board [3h 4s Kh Qc 9s]
Seat 1: shykko60  (big blind) showed [7h 9c] and won ($150.6) with Pair, 99
Seat 2: gangster100 folded before Flop (didn't bet)
Seat 3: movetome folded before Flop (didn't bet)
Seat 4: devi7 showed [6c 6d] and lost with Pair, 66
Seat 5: Lucifer999 (button) folded before Flop (didn't bet)
Seat 6: spidy02 (small blind) folded before Flop



PokerStars Game #00327555560: Hold'em No Limit ($10/$25 USD) - 2022/04/30 12:16:54 ET
Table 'Hold'em (Min 500Max 2500)  1282' 6-max Seat #3 is the button
Seat 1: JaspritBumrah786 ($2767.95 in chips) 
Seat 3: smoker player  ($518.1 in chips) 
Seat 4: spidy02 ($2170.96 in chips) 
Seat 5: Lucifer999 ($8281.83 in chips) 
Seat 6: jas8k ($1046.07 in chips) 
spidy02: posts small blind $10
Lucifer999: posts big blind $25
*** HOLE CARDS ***
Dealt to Lucifer999 [3h Ts]
jas8k: folds
JaspritBumrah786: folds
smoker player : raises $25.00 to $50
spidy02: raises $83.75 to $133.75
Lucifer999: folds
smoker player : folds
Uncalled bet ($83.75) returned to spidy02
spidy02: doesn't show hand
spidy02 collected $125 from pot
*** SUMMARY ***
Total pot $125.00 | Rake $0
Board []
Seat 1: JaspritBumrah786 folded before Flop (didn't bet)
Seat 3: smoker player  (button) folded before Flop
Seat 4: spidy02 (small blind) collected ($125)
Seat 5: Lucifer999 (big blind) folded before Flop
Seat 6: jas8k folded before Flop (didn't bet)



PokerStars Game #00327555590: Hold'em No Limit ($50/$100 USD) - 2022/04/30 12:17:01 ET
Table 'Hold'em (Min 25KMax 10K)    69' 6-max Seat #3 is the button
Seat 1: Lucifer999 ($33386.71 in chips) 
Seat 3: Mpr@59  ($14702.48 in chips) 
Seat 4: MSTHEBOSS ($2582.8 in chips) 
Seat 5: tabby20 ($34262.32 in chips) 
Seat 6: manny007 ($4468.75 in chips) 
MSTHEBOSS: posts small blind $50
tabby20: posts big blind $100
*** HOLE CARDS ***
Dealt to Lucifer999 [2s Jh]
manny007: folds
Lucifer999: folds
Mpr@59 : calls $100
MSTHEBOSS: raises $300.00 to $400
tabby20: folds
Mpr@59 : calls $300
*** FLOP *** [3s 4c 3h]
MSTHEBOSS: bets $2182.8
Mpr@59 : calls $2182.8
*** TURN *** [3s 4c 3h] [7s]
*** TURN *** [3s 4c 3h] [Ad]
*** RIVER *** [3s 4c 3h 7s] [Qd]
*** RIVER *** [3s 4c 3h 7s] [6c]
*** SHOW DOWN ***
Mpr@59 : shows [4h 4s] (Full house, 44433)
MSTHEBOSS: shows [Ac Th] (Two pairs, AA33)
Mpr@59  collected $2516.97 from pot
Mpr@59  collected $2516.97 from pot
*** SUMMARY ***
Total pot $5265.60 | Rake $231.66
Board [3s 4c 3h 7s Qd]
Seat 1: Lucifer999 folded before Flop (didn't bet)
Seat 3: Mpr@59   (button) showed [4h 4s] and won ($2516.97) with Full house, 44433
Seat 4: MSTHEBOSS (small blind) showed [Ac Th] and lost with Two pairs, AA33
Seat 5: tabby20 (big blind) folded before Flop
Seat 6: manny007 folded before Flop (didn't bet)



PokerStars Game #00327555666: Hold'em No Limit ($10/$25 USD) - 2022/04/30 12:17:21 ET
Table 'Hold'em (Min 500Max 2500)  1282' 6-max Seat #4 is the button
Seat 1: JaspritBumrah786 ($2767.95 in chips) 
Seat 3: smoker player  ($468.1 in chips) 
Seat 4: spidy02 ($2245.96 in chips) 
Seat 5: Lucifer999 ($8256.83 in chips) 
Seat 6: jas8k ($1046.07 in chips) 
Lucifer999: posts small blind $10
jas8k: posts big blind $25
*** HOLE CARDS ***
Dealt to Lucifer999 [Ks 2s]
JaspritBumrah786: folds
smoker player : folds
spidy02: calls $25
Lucifer999: calls $15
jas8k: checks
*** FLOP *** [Jh 6c 5h]
Lucifer999: checks
jas8k: bets $25
spidy02: folds
Lucifer999: folds
Uncalled bet ($25) returned to jas8k
jas8k: doesn't show hand
jas8k collected $71.07 from pot
*** SUMMARY ***
Total pot $75.00 | Rake $3.93
Board [Jh 6c 5h]
Seat 1: JaspritBumrah786 folded before Flop (didn't bet)
Seat 3: smoker player  folded before Flop (didn't bet)
Seat 4: spidy02 (button) folded on the Flop
Seat 5: Lucifer999 (small blind) folded on the Flop
Seat 6: jas8k (big blind) collected ($71.07)



PokerStars Game #00327555728: Hold'em No Limit ($50/$100 USD) - 2022/04/30 12:17:40 ET
Table 'Hold'em (Min 25KMax 10K)    69' 6-max Seat #5 is the button
Seat 1: Lucifer999 ($33386.71 in chips) 
Seat 3: Mpr@59  ($17153.62 in chips) 
Seat 5: tabby20 ($34162.32 in chips) 
Seat 6: manny007 ($4468.75 in chips) 
manny007: posts small blind $50
Lucifer999: posts big blind $100
*** HOLE CARDS ***
Dealt to Lucifer999 [8d 8h]
Mpr@59 : folds
tabby20: raises $200.00 to $300
manny007: folds
Lucifer999: calls $200
*** FLOP *** [8s 9c Ts]
Lucifer999: checks
tabby20: checks
*** TURN *** [8s 9c Ts] [7h]
Lucifer999: bets $400
tabby20: folds
Uncalled bet ($400) returned to Lucifer999
Lucifer999: doesn't show hand
Lucifer999 collected $621.4 from pot
*** SUMMARY ***
Total pot $650.00 | Rake $28.6
Board [8s 9c Ts 7h]
Seat 1: Lucifer999 (big blind) collected ($621.4)
Seat 3: Mpr@59  folded before Flop (didn't bet)
Seat 5: tabby20 (button) folded on the Turn
Seat 6: manny007 (small blind) folded before Flop



PokerStars Game #00327555658: Hold'em No Limit ($10/$25 USD) - 2022/04/30 12:17:20 ET
Table 'Hold'em (Min 500Max 2500) 1001' 6-max Seat #6 is the button
Seat 1: shykko60 ($570.6 in chips) 
Seat 2: gangster100 ($1981.51 in chips) 
Seat 3: movetome ($2025 in chips) 
Seat 4: devi7 ($2374.39 in chips) 
Seat 5: Lucifer999 ($2748.86 in chips) 
Seat 6: spidy02 ($4916.9 in chips) 
shykko60: posts small blind $10
gangster100: posts big blind $25
*** HOLE CARDS ***
Dealt to Lucifer999 [7s Th]
movetome: folds
devi7: folds
Lucifer999: folds
spidy02: folds
shykko60: calls $15
gangster100: raises $50.00 to $75
shykko60: calls $50
*** FLOP *** [Jh 5s Qs]
shykko60: checks
gangster100: bets $70.57
shykko60: calls $70.57
*** TURN *** [Jh 5s Qs] [7h]
shykko60: checks
gangster100: checks
*** RIVER *** [Jh 5s Qs 7h] [3d]
shykko60: checks
gangster100: checks
*** SHOW DOWN ***
gangster100: shows [Kc Ac] (High card, A)
shykko60: doesn't show hand
gangster100 collected $273.87 from pot
*** SUMMARY ***
Total pot $291.14 | Rake $17.27
Board [Jh 5s Qs 7h 3d]
Seat 1: shykko60 (small blind) mucked
Seat 2: gangster100  (big blind) showed [Kc Ac] and won ($273.87) with High card, A
Seat 3: movetome folded before Flop (didn't bet)
Seat 4: devi7 folded before Flop (didn't bet)
Seat 5: Lucifer999 folded before Flop (didn't bet)
Seat 6: spidy02 (button) folded before Flop (didn't bet)



PokerStars Game #00327555800: Hold'em No Limit ($10/$25 USD) - 2022/04/30 12:18:01 ET
Table 'Hold'em (Min 500Max 2500)  1282' 6-max Seat #5 is the button
Seat 1: JaspritBumrah786 ($2767.95 in chips) 
Seat 3: smoker player  ($468.1 in chips) 
Seat 4: spidy02 ($2220.96 in chips) 
Seat 5: Lucifer999 ($8231.83 in chips) 
Seat 6: jas8k ($1092.14 in chips) 
jas8k: posts small blind $10
JaspritBumrah786: posts big blind $25
*** HOLE CARDS ***
Dealt to Lucifer999 [5h 3h]
smoker player : calls $25
spidy02: folds
Lucifer999: folds
jas8k: calls $15
JaspritBumrah786: raises $100.00 to $125
smoker player : raises $343.10 to $468.1
jas8k: folds
JaspritBumrah786: calls $343.1
*** FLOP *** [8c 2s 5c]
*** TURN *** [8c 2s 5c] [Th]
*** RIVER *** [8c 2s 5c Th] [2c]
*** SHOW DOWN ***
JaspritBumrah786: shows [Qc Kc] (Flush, K high)
smoker player : shows [Ks Qs] (Pair, 22)
JaspritBumrah786 collected $905.75 from pot
*** SUMMARY ***
Total pot $961.20 | Rake $55.45
Board [8c 2s 5c Th 2c]
Seat 1: JaspritBumrah786  (big blind) showed [Qc Kc] and won ($905.75) with Flush, K high
Seat 3: smoker player  showed [Ks Qs] and lost with Pair, 22
Seat 4: spidy02 folded before Flop (didn't bet)
Seat 5: Lucifer999 (button) folded before Flop (didn't bet)
Seat 6: jas8k (small blind) folded before Flop



PokerStars Game #00327555915: Hold'em No Limit ($10/$25 USD) - 2022/04/30 12:18:29 ET
Table 'Hold'em (Min 500Max 2500) 1001' 6-max Seat #1 is the button
Seat 1: shykko60 ($425.03 in chips) 
Seat 2: gangster100 ($2109.81 in chips) 
Seat 3: movetome ($2025 in chips) 
Seat 4: devi7 ($2374.39 in chips) 
Seat 5: Lucifer999 ($2748.86 in chips) 
Seat 6: spidy02 ($4916.9 in chips) 
gangster100: posts small blind $10
movetome: posts big blind $25
*** HOLE CARDS ***
Dealt to Lucifer999 [2d 5d]
devi7: folds
Lucifer999: folds
spidy02: folds
shykko60: folds
gangster100: folds
Uncalled bet ($15) returned to movetome
movetome: doesn't show hand
movetome collected $20 from pot
*** SUMMARY ***
Total pot $20.00 | Rake $0
Board []
Seat 1: shykko60 (button) folded before Flop (didn't bet)
Seat 2: gangster100 (small blind) folded before Flop
Seat 3: movetome (big blind) collected ($20)
Seat 4: devi7 folded before Flop (didn't bet)
Seat 5: Lucifer999 folded before Flop (didn't bet)
Seat 6: spidy02 folded before Flop (didn't bet)



PokerStars Game #00327555857: Hold'em No Limit ($50/$100 USD) - 2022/04/30 12:18:16 ET
Table 'Hold'em (Min 25KMax 10K)    69' 6-max Seat #6 is the button
Seat 1: Lucifer999 ($33708.11 in chips) 
Seat 3: Mpr@59  ($17153.62 in chips) 
Seat 5: tabby20 ($33862.32 in chips) 
Seat 6: manny007 ($4418.75 in chips) 
Lucifer999: posts small blind $50
Mpr@59 : posts big blind $100
*** HOLE CARDS ***
Dealt to Lucifer999 [Ks Kc]
tabby20: folds
manny007: calls $100
Lucifer999: raises $350.00 to $450
Mpr@59 : folds
manny007: calls $350
*** FLOP *** [Ts 4d Td]
Lucifer999: bets $700
manny007: calls $700
*** TURN *** [Ts 4d Td] [7d]
Lucifer999: checks
manny007: bets $1318.93
Lucifer999: folds
Uncalled bet ($1318.93) returned to manny007
manny007: doesn't show hand
manny007 collected $2294.4 from pot
*** SUMMARY ***
Total pot $2400.00 | Rake $105.6
Board [Ts 4d Td 7d]
Seat 1: Lucifer999 (small blind) folded on the Turn
Seat 3: Mpr@59  (big blind) folded before Flop
Seat 5: tabby20 folded before Flop (didn't bet)
Seat 6: manny007 (button) collected ($2294.4)



PokerStars Game #00327555922: Hold'em No Limit ($10/$25 USD) - 2022/04/30 12:18:32 ET
Table 'Hold'em (Min 500Max 2500)  1282' 6-max Seat #6 is the button
Seat 1: JaspritBumrah786 ($3205.6 in chips) 
Seat 4: spidy02 ($2220.96 in chips) 
Seat 5: Lucifer999 ($8231.83 in chips) 
Seat 6: jas8k ($1067.14 in chips) 
JaspritBumrah786: posts small blind $10
spidy02: posts big blind $25
*** HOLE CARDS ***
Dealt to Lucifer999 [8s Js]
Lucifer999: folds
jas8k: folds
JaspritBumrah786: folds
Uncalled bet ($15) returned to spidy02
spidy02: doesn't show hand
spidy02 collected $20 from pot
*** SUMMARY ***
Total pot $20.00 | Rake $0
Board []
Seat 1: JaspritBumrah786 (small blind) folded before Flop
Seat 4: spidy02 (big blind) collected ($20)
Seat 5: Lucifer999 folded before Flop (didn't bet)
Seat 6: jas8k (button) folded before Flop (didn't bet)



PokerStars Game #00327555991: Hold'em No Limit ($10/$25 USD) - 2022/04/30 12:18:53 ET
Table 'Hold'em (Min 500Max 2500) 1001' 6-max Seat #2 is the button
Seat 1: shykko60 ($425.03 in chips) 
Seat 2: gangster100 ($2099.81 in chips) 
Seat 3: movetome ($2035 in chips) 
Seat 4: devi7 ($2374.39 in chips) 
Seat 5: Lucifer999 ($2748.86 in chips) 
Seat 6: spidy02 ($4916.9 in chips) 
movetome: posts small blind $10
devi7: posts big blind $25
*** HOLE CARDS ***
Dealt to Lucifer999 [9c 5c]
Lucifer999: folds
spidy02: calls $25
shykko60: folds
gangster100: folds
movetome: raises $75.00 to $100
devi7: calls $75
spidy02: folds
*** FLOP *** [2d 3d 6h]
movetome: checks
devi7: checks
*** TURN *** [2d 3d 6h] [Kd]
movetome: checks
devi7: checks
*** RIVER *** [2d 3d 6h Kd] [As]
movetome: bets $150
devi7: calls $150
*** SHOW DOWN ***
movetome: shows [Ks Jh] (Pair, KK)
devi7: shows [Ac Jc] (Pair, AA)
devi7 collected $492.44 from pot
*** SUMMARY ***
Total pot $525.00 | Rake $32.56
Board [2d 3d 6h Kd As]
Seat 1: shykko60 folded before Flop (didn't bet)
Seat 2: gangster100 (button) folded before Flop (didn't bet)
Seat 3: movetome (small blind) showed [Ks Jh] and lost with Pair, KK
Seat 4: devi7  (big blind) showed [Ac Jc] and won ($492.44) with Pair, AA
Seat 5: Lucifer999 folded before Flop (didn't bet)
Seat 6: spidy02 folded before Flop



PokerStars Game #00327556032: Hold'em No Limit ($50/$100 USD) - 2022/04/30 12:19:02 ET
Table 'Hold'em (Min 25KMax 10K)    69' 6-max Seat #1 is the button
Seat 1: Lucifer999 ($32558.11 in chips) 
Seat 3: Mpr@59  ($17053.62 in chips) 
Seat 5: tabby20 ($33862.32 in chips) 
Seat 6: manny007 ($5563.15 in chips) 
Mpr@59 : posts small blind $50
tabby20: posts big blind $100
*** HOLE CARDS ***
Dealt to Lucifer999 [Qh 8s]
manny007: folds
Lucifer999: folds
Mpr@59 : calls $50
tabby20: checks
*** FLOP *** [Tc Kc Jc]
Mpr@59 : checks
tabby20: bets $100
Mpr@59 : calls $100
*** TURN *** [Tc Kc Jc] [7h]
Mpr@59 : checks
tabby20: bets $191.2
Mpr@59 : calls $191.2
*** RIVER *** [Tc Kc Jc 7h] [Qs]
Mpr@59 : bets $748
tabby20: folds
Uncalled bet ($748) returned to Mpr@59 
Mpr@59 : doesn't show hand
Mpr@59  collected $748 from pot
*** SUMMARY ***
Total pot $782.40 | Rake $34.4
Board [Tc Kc Jc 7h Qs]
Seat 1: Lucifer999 (button) folded before Flop (didn't bet)
Seat 3: Mpr@59  (small blind) collected ($748)
Seat 5: tabby20 (big blind) folded on the River
Seat 6: manny007 folded before Flop (didn't bet)



PokerStars Game #00327556043: Hold'em No Limit ($10/$25 USD) - 2022/04/30 12:19:07 ET
Table 'Hold'em (Min 500Max 2500)  1282' 6-max Seat #1 is the button
Seat 1: JaspritBumrah786 ($3195.6 in chips) 
Seat 2: Miss_Jammer ($2500 in chips) 
Seat 4: spidy02 ($2230.96 in chips) 
Seat 5: Lucifer999 ($8231.83 in chips) 
Seat 6: jas8k ($1067.14 in chips) 
spidy02: posts small blind $10
Lucifer999: posts big blind $25
*** HOLE CARDS ***
Dealt to Lucifer999 [9c 9s]
jas8k: raises $25.00 to $50
JaspritBumrah786: folds
spidy02: calls $40
Lucifer999: calls $25
*** FLOP *** [5c Kh 2s]
spidy02: checks
Lucifer999: checks
jas8k: bets $105.85
spidy02: folds
Lucifer999: calls $105.85
*** TURN *** [5c Kh 2s] [2c]
Lucifer999: checks
jas8k: bets $254.81
Lucifer999: calls $254.81
*** RIVER *** [5c Kh 2s 2c] [6h]
Lucifer999: checks
jas8k: bets $656.48
Lucifer999: calls $656.48
*** SHOW DOWN ***
Lucifer999: shows [9c 9s] (Two pairs, 9922)
jas8k: shows [Ad Ac] (Two pairs, AA22)
jas8k collected $2064.62 from pot
*** SUMMARY ***
Total pot $2184.28 | Rake $119.66
Board [5c Kh 2s 2c 6h]
Seat 1: JaspritBumrah786 (button) folded before Flop (didn't bet)
Seat 4: spidy02 (small blind) folded on the Flop
Seat 5: Lucifer999 (big blind) showed [9c 9s] and lost with Two pairs, 9922
Seat 6: jas8k  showed [Ad Ac] and won ($2064.62) with Two pairs, AA22



PokerStars Game #00327556265: Hold'em No Limit ($10/$25 USD) - 2022/04/30 12:20:10 ET
Table 'Hold'em (Min 500Max 2500)  1282' 6-max Seat #4 is the button
Seat 1: JaspritBumrah786 ($3195.6 in chips) 
Seat 2: Miss_Jammer ($2500 in chips) 
Seat 4: spidy02 ($2180.96 in chips) 
Seat 5: Lucifer999 ($7164.69 in chips) 
Seat 6: jas8k ($2064.62 in chips) 
Lucifer999: posts small blind $10
jas8k: posts big blind $25
*** HOLE CARDS ***
Dealt to Lucifer999 [2s 2c]
JaspritBumrah786: folds
spidy02: folds
Lucifer999: folds
Uncalled bet ($15) returned to jas8k
jas8k: doesn't show hand
jas8k collected $20 from pot
*** SUMMARY ***
Total pot $20.00 | Rake $0
Board []
Seat 1: JaspritBumrah786 folded before Flop (didn't bet)
Seat 4: spidy02 (button) folded before Flop (didn't bet)
Seat 5: Lucifer999 (small blind) folded before Flop
Seat 6: jas8k (big blind) collected ($20)



PokerStars Game #00327556179: Hold'em No Limit ($10/$25 USD) - 2022/04/30 12:19:48 ET
Table 'Hold'em (Min 500Max 2500) 1001' 6-max Seat #3 is the button
Seat 1: shykko60 ($425.03 in chips) 
Seat 2: gangster100 ($2099.81 in chips) 
Seat 3: movetome ($1875 in chips) 
Seat 4: devi7 ($2616.83 in chips) 
Seat 5: Lucifer999 ($2748.86 in chips) 
Seat 6: spidy02 ($4891.9 in chips) 
devi7: posts small blind $10
Lucifer999: posts big blind $25
*** HOLE CARDS ***
Dealt to Lucifer999 [Js Qs]
spidy02: folds
shykko60: folds
gangster100: folds
movetome: raises $50.00 to $75
devi7: calls $65
Lucifer999: calls $50
*** FLOP *** [Jc 8c Ac]
devi7: checks
Lucifer999: checks
movetome: bets $150
devi7: folds
Lucifer999: folds
Uncalled bet ($150) returned to movetome
movetome: doesn't show hand
movetome collected $211.19 from pot
*** SUMMARY ***
Total pot $225.00 | Rake $13.81
Board [Jc 8c Ac]
Seat 1: shykko60 folded before Flop (didn't bet)
Seat 2: gangster100 folded before Flop (didn't bet)
Seat 3: movetome (button) collected ($211.19)
Seat 4: devi7 (small blind) folded on the Flop
Seat 5: Lucifer999 (big blind) folded on the Flop
Seat 6: spidy02 folded before Flop (didn't bet)



PokerStars Game #00327556210: Hold'em No Limit ($50/$100 USD) - 2022/04/30 12:19:55 ET
Table 'Hold'em (Min 25KMax 10K)    69' 6-max Seat #3 is the button
Seat 1: Lucifer999 ($32558.11 in chips) 
Seat 3: Mpr@59  ($17410.42 in chips) 
Seat 5: tabby20 ($33471.12 in chips) 
Seat 6: manny007 ($5563.15 in chips) 
tabby20: posts small blind $50
manny007: posts big blind $100
*** HOLE CARDS ***
Dealt to Lucifer999 [8d 8h]
Lucifer999: folds
Mpr@59 : calls $100
tabby20: raises $350.00 to $450
manny007: calls $350
Mpr@59 : folds
*** FLOP *** [6d Td Js]
tabby20: checks
manny007: checks
*** TURN *** [6d Td Js] [Ts]
tabby20: bets $850
manny007: folds
Uncalled bet ($850) returned to tabby20
tabby20: doesn't show hand
tabby20 collected $956 from pot
*** SUMMARY ***
Total pot $1000.00 | Rake $44
Board [6d Td Js Ts]
Seat 1: Lucifer999 folded before Flop (didn't bet)
Seat 3: Mpr@59  (button) folded before Flop
Seat 5: tabby20 (small blind) collected ($956)
Seat 6: manny007 (big blind) folded on the Turn



PokerStars Game #00327556342: Hold'em No Limit ($10/$25 USD) - 2022/04/30 12:20:35 ET
Table 'Hold'em (Min 500Max 2500) 1001' 6-max Seat #4 is the button
Seat 1: shykko60 ($425.03 in chips) 
Seat 2: gangster100 ($2099.81 in chips) 
Seat 3: movetome ($2161.19 in chips) 
Seat 4: devi7 ($2541.83 in chips) 
Seat 5: Lucifer999 ($2673.86 in chips) 
Seat 6: spidy02 ($4891.9 in chips) 
Lucifer999: posts small blind $10
spidy02: posts big blind $25
*** HOLE CARDS ***
Dealt to Lucifer999 [Tc 8h]
shykko60: folds
gangster100: raises $38.75 to $63.75
movetome: calls $63.75
devi7: raises $226.25 to $290
Lucifer999: folds
spidy02: folds
gangster100: folds
movetome: folds
Uncalled bet ($226.25) returned to devi7
devi7: doesn't show hand
devi7 collected $226.25 from pot
*** SUMMARY ***
Total pot $226.25 | Rake $0
Board []
Seat 1: shykko60 folded before Flop (didn't bet)
Seat 2: gangster100 folded before Flop
Seat 3: movetome folded before Flop
Seat 4: devi7 (button) collected ($226.25)
Seat 5: Lucifer999 (small blind) folded before Flop
Seat 6: spidy02 (big blind) folded before Flop



PokerStars Game #00327556373: Hold'em No Limit ($50/$100 USD) - 2022/04/30 12:20:42 ET
Table 'Hold'em (Min 25KMax 10K)    69' 6-max Seat #5 is the button
Seat 1: Lucifer999 ($32558.11 in chips) 
Seat 3: Mpr@59  ($17310.42 in chips) 
Seat 5: tabby20 ($33977.12 in chips) 
Seat 6: manny007 ($5113.15 in chips) 
manny007: posts small blind $50
Lucifer999: posts big blind $100
*** HOLE CARDS ***
Dealt to Lucifer999 [8c 6c]
Mpr@59 : calls $100
tabby20: folds
manny007: calls $50
Lucifer999: raises $350.00 to $450
Mpr@59 : folds
manny007: folds
Uncalled bet ($350) returned to Lucifer999
Lucifer999: doesn't show hand
Lucifer999 collected $300 from pot
*** SUMMARY ***
Total pot $300.00 | Rake $0
Board []
Seat 1: Lucifer999 (big blind) collected ($300)
Seat 3: Mpr@59  folded before Flop
Seat 5: tabby20 (button) folded before Flop (didn't bet)
Seat 6: manny007 (small blind) folded before Flop



PokerStars Game #00327556336: Hold'em No Limit ($10/$25 USD) - 2022/04/30 12:20:32 ET
Table 'Hold'em (Min 500Max 2500)  1282' 6-max Seat #5 is the button
Seat 1: JaspritBumrah786 ($3195.6 in chips) 
Seat 2: Miss_Jammer ($2500 in chips) 
Seat 4: spidy02 ($2180.96 in chips) 
Seat 5: Lucifer999 ($7154.69 in chips) 
Seat 6: jas8k ($2074.62 in chips) 
jas8k: posts small blind $10
JaspritBumrah786: posts big blind $25
*** HOLE CARDS ***
Dealt to Lucifer999 [4s 2s]
spidy02: raises $35.00 to $60
Lucifer999: folds
jas8k: calls $50
JaspritBumrah786: calls $35
*** FLOP *** [3h Ah 9c]
jas8k: checks
JaspritBumrah786: checks
spidy02: checks
*** TURN *** [3h Ah 9c] [Th]
jas8k: checks
JaspritBumrah786: checks
spidy02: checks
*** RIVER *** [3h Ah 9c Th] [Kd]
jas8k: bets $127.16
JaspritBumrah786: folds
spidy02: folds
Uncalled bet ($127.16) returned to jas8k
jas8k: doesn't show hand
jas8k collected $169.55 from pot
*** SUMMARY ***
Total pot $180.00 | Rake $10.45
Board [3h Ah 9c Th Kd]
Seat 1: JaspritBumrah786 (big blind) folded on the River
Seat 4: spidy02 folded on the River
Seat 5: Lucifer999 (button) folded before Flop (didn't bet)
Seat 6: jas8k (small blind) collected ($169.55)



PokerStars Game #00327556462: Hold'em No Limit ($10/$25 USD) - 2022/04/30 12:21:09 ET
Table 'Hold'em (Min 500Max 2500) 1001' 6-max Seat #5 is the button
Seat 1: shykko60 ($425.03 in chips) 
Seat 2: gangster100 ($2036.06 in chips) 
Seat 3: movetome ($2097.44 in chips) 
Seat 4: devi7 ($2704.33 in chips) 
Seat 5: Lucifer999 ($2663.86 in chips) 
Seat 6: spidy02 ($4866.9 in chips) 
spidy02: posts small blind $10
shykko60: posts big blind $25
*** HOLE CARDS ***
Dealt to Lucifer999 [6c 5s]
gangster100: folds
movetome: folds
devi7: folds
Lucifer999: folds
spidy02: calls $15
shykko60: checks
*** FLOP *** [Qs 2d Ks]
spidy02: bets $35.54
shykko60: folds
Uncalled bet ($35.54) returned to spidy02
spidy02: doesn't show hand
spidy02 collected $47.38 from pot
*** SUMMARY ***
Total pot $50.00 | Rake $2.62
Board [Qs 2d Ks]
Seat 1: shykko60 (big blind) folded on the Flop
Seat 2: gangster100 folded before Flop (didn't bet)
Seat 3: movetome folded before Flop (didn't bet)
Seat 4: devi7 folded before Flop (didn't bet)
Seat 5: Lucifer999 (button) folded before Flop (didn't bet)
Seat 6: spidy02 (small blind) collected ($47.38)



PokerStars Game #00327556479: Hold'em No Limit ($50/$100 USD) - 2022/04/30 12:21:12 ET
Table 'Hold'em (Min 25KMax 10K)    69' 6-max Seat #6 is the button
Seat 1: Lucifer999 ($32758.11 in chips) 
Seat 3: Mpr@59  ($17210.42 in chips) 
Seat 5: tabby20 ($33977.12 in chips) 
Seat 6: manny007 ($5013.15 in chips) 
Lucifer999: posts small blind $50
Mpr@59 : posts big blind $100
*** HOLE CARDS ***
Dealt to Lucifer999 [Kh 9h]
tabby20: folds
manny007: folds
Lucifer999: raises $200.00 to $300
Mpr@59 : calls $200
*** FLOP *** [Qs 3s As]
Lucifer999: bets $350
Mpr@59 : calls $350
*** TURN *** [Qs 3s As] [5h]
Lucifer999: checks
Mpr@59 : checks
*** RIVER *** [Qs 3s As 5h] [8c]
Lucifer999: bets $1200
Mpr@59 : raises $15360.42 to $16560.42
Lucifer999: folds
Uncalled bet ($15360.42) returned to Mpr@59 
Mpr@59 : doesn't show hand
Mpr@59  collected $3537.2 from pot
*** SUMMARY ***
Total pot $3700.00 | Rake $162.8
Board [Qs 3s As 5h 8c]
Seat 1: Lucifer999 (small blind) folded on the River
Seat 3: Mpr@59  (big blind) collected ($3537.2)
Seat 5: tabby20 folded before Flop (didn't bet)
Seat 6: manny007 (button) folded before Flop (didn't bet)



PokerStars Game #00327556642: Hold'em No Limit ($10/$25 USD) - 2022/04/30 12:22:00 ET
Table 'Hold'em (Min 500Max 2500) 1001' 6-max Seat #6 is the button
Seat 1: shykko60 ($400.03 in chips) 
Seat 2: gangster100 ($2036.06 in chips) 
Seat 3: movetome ($2097.44 in chips) 
Seat 4: devi7 ($2704.33 in chips) 
Seat 5: Lucifer999 ($2663.86 in chips) 
Seat 6: spidy02 ($4889.28 in chips) 
shykko60: posts small blind $10
gangster100: posts big blind $25
*** HOLE CARDS ***
Dealt to Lucifer999 [As 2d]
movetome: raises $50.00 to $75
devi7: folds
Lucifer999: folds
spidy02: folds
shykko60: folds
gangster100: calls $50
*** FLOP *** [Ks 6c 3c]
gangster100: checks
movetome: bets $125
gangster100: calls $125
*** TURN *** [Ks 6c 3c] [3s]
gangster100: checks
movetome: checks
*** RIVER *** [Ks 6c 3c 3s] [Td]
gangster100: checks
movetome: checks
*** SHOW DOWN ***
movetome: shows [8c Ac] (Pair, 33)
gangster100: shows [8s 8d] (Two pairs, 8833)
gangster100 collected $384.48 from pot
*** SUMMARY ***
Total pot $410.00 | Rake $25.52
Board [Ks 6c 3c 3s Td]
Seat 1: shykko60 (small blind) folded before Flop
Seat 2: gangster100  (big blind) showed [8s 8d] and won ($384.48) with Two pairs, 8833
Seat 3: movetome showed [8c Ac] and lost with Pair, 33
Seat 4: devi7 folded before Flop (didn't bet)
Seat 5: Lucifer999 folded before Flop (didn't bet)
Seat 6: spidy02 (button) folded before Flop (didn't bet)



PokerStars Game #00327556660: Hold'em No Limit ($50/$100 USD) - 2022/04/30 12:22:06 ET
Table 'Hold'em (Min 25KMax 10K)    69' 6-max Seat #1 is the button
Seat 1: Lucifer999 ($30908.11 in chips) 
Seat 3: Mpr@59  ($18897.62 in chips) 
Seat 5: tabby20 ($33977.12 in chips) 
Seat 6: manny007 ($5013.15 in chips) 
Mpr@59 : posts small blind $50
tabby20: posts big blind $100
*** HOLE CARDS ***
Dealt to Lucifer999 [Ah Ks]
manny007: calls $100
Lucifer999: raises $350.00 to $450
Mpr@59 : folds
tabby20: folds
manny007: calls $350
*** FLOP *** [7h Th 7d]
manny007: bets $442.02
Lucifer999: calls $442.02
*** TURN *** [7h Th 7d] [Ts]
manny007: bets $1848.95
Lucifer999: folds
Uncalled bet ($1848.95) returned to manny007
manny007: doesn't show hand
manny007 collected $1848.95 from pot
*** SUMMARY ***
Total pot $1934.04 | Rake $85.09
Board [7h Th 7d Ts]
Seat 1: Lucifer999 (button) folded on the Turn
Seat 3: Mpr@59  (small blind) folded before Flop
Seat 5: tabby20 (big blind) folded before Flop
Seat 6: manny007 collected ($1848.95)



PokerStars Game #00327556599: Hold'em No Limit ($10/$25 USD) - 2022/04/30 12:21:46 ET
Table 'Hold'em (Min 500Max 2500)  1282' 6-max Seat #6 is the button
Seat 1: JaspritBumrah786 ($3135.6 in chips) 
Seat 2: Miss_Jammer ($2500 in chips) 
Seat 4: spidy02 ($2120.96 in chips) 
Seat 5: Lucifer999 ($7154.69 in chips) 
Seat 6: jas8k ($2184.17 in chips) 
JaspritBumrah786: posts small blind $10
Miss_Jammer: posts big blind $25
*** HOLE CARDS ***
Dealt to Lucifer999 [4c Tc]
spidy02: raises $45.00 to $70
Lucifer999: folds
jas8k: folds
JaspritBumrah786: folds
Miss_Jammer: folds
Uncalled bet ($45) returned to spidy02
spidy02: doesn't show hand
spidy02 collected $60 from pot
*** SUMMARY ***
Total pot $60.00 | Rake $0
Board []
Seat 1: JaspritBumrah786 (small blind) folded before Flop
Seat 2: Miss_Jammer (big blind) folded before Flop
Seat 4: spidy02 collected ($60)
Seat 5: Lucifer999 folded before Flop (didn't bet)
Seat 6: jas8k (button) folded before Flop (didn't bet)



PokerStars Game #00327556813: Hold'em No Limit ($10/$25 USD) - 2022/04/30 12:22:50 ET
Table 'Hold'em (Min 500Max 2500) 1001' 6-max Seat #1 is the button
Seat 1: shykko60 ($390.03 in chips) 
Seat 2: gangster100 ($2220.54 in chips) 
Seat 3: movetome ($2025 in chips) 
Seat 4: devi7 ($2704.33 in chips) 
Seat 5: Lucifer999 ($2663.86 in chips) 
Seat 6: spidy02 ($4889.28 in chips) 
gangster100: posts small blind $10
movetome: posts big blind $25
*** HOLE CARDS ***
Dealt to Lucifer999 [Tc Qh]
devi7: folds
Lucifer999: folds
spidy02: folds
shykko60: folds
gangster100: folds
Uncalled bet ($15) returned to movetome
movetome: doesn't show hand
movetome collected $20 from pot
*** SUMMARY ***
Total pot $20.00 | Rake $0
Board []
Seat 1: shykko60 (button) folded before Flop (didn't bet)
Seat 2: gangster100 (small blind) folded before Flop
Seat 3: movetome (big blind) collected ($20)
Seat 4: devi7 folded before Flop (didn't bet)
Seat 5: Lucifer999 folded before Flop (didn't bet)
Seat 6: spidy02 folded before Flop (didn't bet)



PokerStars Game #00327556874: Hold'em No Limit ($10/$25 USD) - 2022/04/30 12:23:07 ET
Table 'Hold'em (Min 500Max 2500)  1282' 6-max Seat #1 is the button
Seat 1: JaspritBumrah786 ($3125.6 in chips) 
Seat 2: Miss_Jammer ($2500 in chips) 
Seat 4: spidy02 ($2155.96 in chips) 
Seat 5: Lucifer999 ($7154.69 in chips) 
Seat 6: jas8k ($2184.17 in chips) 
Miss_Jammer: posts small blind $10
spidy02: posts big blind $25
*** HOLE CARDS ***
Dealt to Lucifer999 [3h Js]
Lucifer999: folds
JaspritBumrah786: folds
Miss_Jammer: folds
Uncalled bet ($15) returned to spidy02
spidy02: doesn't show hand
spidy02 collected $20 from pot
*** SUMMARY ***
Total pot $20.00 | Rake $0
Board []
Seat 1: JaspritBumrah786 (button) folded before Flop (didn't bet)
Seat 2: Miss_Jammer (small blind) folded before Flop
Seat 4: spidy02 (big blind) collected ($20)
Seat 5: Lucifer999 folded before Flop (didn't bet)



PokerStars Game #00327556833: Hold'em No Limit ($50/$100 USD) - 2022/04/30 12:22:56 ET
Table 'Hold'em (Min 25KMax 10K)    69' 6-max Seat #3 is the button
Seat 1: Lucifer999 ($30016.09 in chips) 
Seat 3: Mpr@59  ($18847.62 in chips) 
Seat 5: tabby20 ($33877.12 in chips) 
Seat 6: manny007 ($5970.08 in chips) 
tabby20: posts small blind $50
manny007: posts big blind $100
*** HOLE CARDS ***
Dealt to Lucifer999 [7s 5h]
Lucifer999: folds
Mpr@59 : calls $100
tabby20: folds
manny007: checks
*** FLOP *** [Ac 9s Ad]
manny007: checks
Mpr@59 : checks
*** TURN *** [Ac 9s Ad] [Th]
manny007: checks
Mpr@59 : checks
*** RIVER *** [Ac 9s Ad Th] [8d]
manny007: checks
Mpr@59 : checks
*** SHOW DOWN ***
manny007: shows [8h 4c] (Two pairs, AA88)
Mpr@59 : doesn't show hand
manny007 collected $239 from pot
*** SUMMARY ***
Total pot $250.00 | Rake $11
Board [Ac 9s Ad Th 8d]
Seat 1: Lucifer999 folded before Flop (didn't bet)
Seat 3: Mpr@59  (button) mucked
Seat 5: tabby20 (small blind) folded before Flop
Seat 6: manny007  (big blind) showed [8h 4c] and won ($239) with Two pairs, AA88



PokerStars Game #00327556892: Hold'em No Limit ($10/$25 USD) - 2022/04/30 12:23:12 ET
Table 'Hold'em (Min 500Max 2500) 1001' 6-max Seat #2 is the button
Seat 1: shykko60 ($390.03 in chips) 
Seat 2: gangster100 ($2210.54 in chips) 
Seat 3: movetome ($2035 in chips) 
Seat 4: devi7 ($2704.33 in chips) 
Seat 5: Lucifer999 ($2663.86 in chips) 
Seat 6: spidy02 ($4889.28 in chips) 
movetome: posts small blind $10
devi7: posts big blind $25
*** HOLE CARDS ***
Dealt to Lucifer999 [Qh Kc]
Lucifer999: raises $55.00 to $80
spidy02: calls $80
shykko60: folds
gangster100: folds
movetome: folds
devi7: raises $345.00 to $425
Lucifer999: raises $425.00 to $850
spidy02: folds
devi7: folds
Uncalled bet ($425) returned to Lucifer999
Lucifer999: doesn't show hand
Lucifer999 collected $940 from pot
*** SUMMARY ***
Total pot $940.00 | Rake $0
Board []
Seat 1: shykko60 folded before Flop (didn't bet)
Seat 2: gangster100 (button) folded before Flop (didn't bet)
Seat 3: movetome (small blind) folded before Flop
Seat 4: devi7 (big blind) folded before Flop
Seat 5: Lucifer999 collected ($940)
Seat 6: spidy02 folded before Flop



PokerStars Game #00327556967: Hold'em No Limit ($10/$25 USD) - 2022/04/30 12:23:32 ET
Table 'Hold'em (Min 500Max 2500)  1282' 6-max Seat #2 is the button
Seat 1: JaspritBumrah786 ($3125.6 in chips) 
Seat 2: Miss_Jammer ($2500 in chips) 
Seat 3: smoker player  ($640 in chips) 
Seat 4: spidy02 ($2165.96 in chips) 
Seat 5: Lucifer999 ($7154.69 in chips) 
Seat 6: jas8k ($2184.17 in chips) 
spidy02: posts small blind $10
Lucifer999: posts big blind $25
*** HOLE CARDS ***
Dealt to Lucifer999 [Js 6c]
JaspritBumrah786: folds
Miss_Jammer: raises $50.00 to $75
spidy02: folds
Lucifer999: folds
Uncalled bet ($50) returned to Miss_Jammer
Miss_Jammer: doesn't show hand
Miss_Jammer collected $60 from pot
*** SUMMARY ***
Total pot $60.00 | Rake $0
Board []
Seat 1: JaspritBumrah786 folded before Flop (didn't bet)
Seat 2: Miss_Jammer (button) collected ($60)
Seat 4: spidy02 (small blind) folded before Flop
Seat 5: Lucifer999 (big blind) folded before Flop



PokerStars Game #00327556980: Hold'em No Limit ($50/$100 USD) - 2022/04/30 12:23:35 ET
Table 'Hold'em (Min 25KMax 10K)    69' 6-max Seat #5 is the button
Seat 1: Lucifer999 ($30016.09 in chips) 
Seat 3: Mpr@59  ($18747.62 in chips) 
Seat 5: tabby20 ($33827.12 in chips) 
Seat 6: manny007 ($6109.08 in chips) 
manny007: posts small blind $50
Lucifer999: posts big blind $100
*** HOLE CARDS ***
Dealt to Lucifer999 [Ks 7h]
Mpr@59 : calls $100
tabby20: folds
manny007: folds
Lucifer999: raises $300.00 to $400
Mpr@59 : folds
Uncalled bet ($300) returned to Lucifer999
Lucifer999: doesn't show hand
Lucifer999 collected $250 from pot
*** SUMMARY ***
Total pot $250.00 | Rake $0
Board []
Seat 1: Lucifer999 (big blind) collected ($250)
Seat 3: Mpr@59  folded before Flop
Seat 5: tabby20 (button) folded before Flop (didn't bet)
Seat 6: manny007 (small blind) folded before Flop



PokerStars Game #00327557101: Hold'em No Limit ($50/$100 USD) - 2022/04/30 12:24:10 ET
Table 'Hold'em (Min 25KMax 10K)    69' 6-max Seat #6 is the button
Seat 1: Lucifer999 ($30166.09 in chips) 
Seat 3: Mpr@59  ($18647.62 in chips) 
Seat 5: tabby20 ($33827.12 in chips) 
Seat 6: manny007 ($6059.08 in chips) 
Lucifer999: posts small blind $50
Mpr@59 : posts big blind $100
*** HOLE CARDS ***
Dealt to Lucifer999 [2d 3h]
tabby20: raises $200.00 to $300
manny007: folds
Lucifer999: folds
Mpr@59 : calls $200
*** FLOP *** [7d 8d 5s]
Mpr@59 : checks
tabby20: bets $450
Mpr@59 : folds
Uncalled bet ($450) returned to tabby20
tabby20: doesn't show hand
tabby20 collected $621.4 from pot
*** SUMMARY ***
Total pot $650.00 | Rake $28.6
Board [7d 8d 5s]
Seat 1: Lucifer999 (small blind) folded before Flop
Seat 3: Mpr@59  (big blind) folded on the Flop
Seat 5: tabby20 collected ($621.4)
Seat 6: manny007 (button) folded before Flop (didn't bet)



PokerStars Game #00327557047: Hold'em No Limit ($10/$25 USD) - 2022/04/30 12:23:54 ET
Table 'Hold'em (Min 500Max 2500) 1001' 6-max Seat #3 is the button
Seat 1: shykko60 ($390.03 in chips) 
Seat 2: gangster100 ($2210.54 in chips) 
Seat 3: movetome ($2025 in chips) 
Seat 4: devi7 ($2279.33 in chips) 
Seat 5: Lucifer999 ($3178.86 in chips) 
Seat 6: spidy02 ($4809.28 in chips) 
devi7: posts small blind $10
Lucifer999: posts big blind $25
*** HOLE CARDS ***
Dealt to Lucifer999 [8h 2h]
spidy02: raises $35.00 to $60
shykko60: calls $60
gangster100: calls $60
movetome: folds
devi7: folds
Lucifer999: folds
*** FLOP *** [6h Ac 3s]
spidy02: checks
shykko60: checks
gangster100: bets $25
spidy02: raises $57.52 to $82.52
shykko60: calls $82.52
gangster100: folds
*** TURN *** [6h Ac 3s] [As]
spidy02: bets $189.89
shykko60: folds
Uncalled bet ($189.89) returned to spidy02
spidy02: doesn't show hand
spidy02 collected $379.78 from pot
*** SUMMARY ***
Total pot $405.04 | Rake $25.26
Board [6h Ac 3s As]
Seat 1: shykko60 folded on the Turn
Seat 2: gangster100 folded on the Flop
Seat 3: movetome (button) folded before Flop (didn't bet)
Seat 4: devi7 (small blind) folded before Flop
Seat 5: Lucifer999 (big blind) folded before Flop
Seat 6: spidy02 collected ($379.78)



PokerStars Game #00327557237: Hold'em No Limit ($50/$100 USD) - 2022/04/30 12:24:48 ET
Table 'Hold'em (Min 25KMax 10K)    69' 6-max Seat #1 is the button
Seat 1: Lucifer999 ($30116.09 in chips) 
Seat 3: Mpr@59  ($18347.62 in chips) 
Seat 5: tabby20 ($34148.52 in chips) 
Seat 6: manny007 ($6059.08 in chips) 
Mpr@59 : posts small blind $50
tabby20: posts big blind $100
*** HOLE CARDS ***
Dealt to Lucifer999 [7c Ac]
manny007: folds
Lucifer999: raises $200.00 to $300
Mpr@59 : folds
tabby20: folds
Uncalled bet ($200) returned to Lucifer999
Lucifer999: doesn't show hand
Lucifer999 collected $250 from pot
*** SUMMARY ***
Total pot $250.00 | Rake $0
Board []
Seat 1: Lucifer999 (button) collected ($250)
Seat 3: Mpr@59  (small blind) folded before Flop
Seat 5: tabby20 (big blind) folded before Flop
Seat 6: manny007 folded before Flop (didn't bet)



PokerStars Game #00327557088: Hold'em No Limit ($10/$25 USD) - 2022/04/30 12:24:04 ET
Table 'Hold'em (Min 500Max 2500)  1282' 6-max Seat #4 is the button
Seat 1: JaspritBumrah786 ($3125.6 in chips) 
Seat 2: Miss_Jammer ($2535 in chips) 
Seat 3: smoker player  ($640 in chips) 
Seat 4: spidy02 ($2155.96 in chips) 
Seat 5: Lucifer999 ($7129.69 in chips) 
Seat 6: jas8k ($2184.17 in chips) 
Lucifer999: posts small blind $10
JaspritBumrah786: posts big blind $25
smoker player : posts small & big blinds $35
*** HOLE CARDS ***
Dealt to Lucifer999 [7h 9c]
Miss_Jammer: raises $65.00 to $100
smoker player : folds
spidy02: calls $100
Lucifer999: folds
JaspritBumrah786: folds
*** FLOP *** [Th Kc Td]
Miss_Jammer: bets $100
spidy02: calls $100
*** TURN *** [Th Kc Td] [7d]
Miss_Jammer: checks
spidy02: checks
*** RIVER *** [Th Kc Td 7d] [2c]
Miss_Jammer: bets $300
spidy02: calls $300
*** SHOW DOWN ***
Miss_Jammer: shows [Kd Qc] (Two pairs, KKTT)
spidy02: doesn't show hand
Miss_Jammer collected $1008.83 from pot
*** SUMMARY ***
Total pot $1070.00 | Rake $61.17
Board [Th Kc Td 7d 2c]
Seat 1: JaspritBumrah786 (big blind) folded before Flop
Seat 2: Miss_Jammer  showed [Kd Qc] and won ($1008.83) with Two pairs, KKTT
Seat 3: smoker player  folded before Flop
Seat 4: spidy02 (button) mucked
Seat 5: Lucifer999 (small blind) folded before Flop



PokerStars Game #00327557354: Hold'em No Limit ($10/$25 USD) - 2022/04/30 12:25:21 ET
Table 'Hold'em (Min 500Max 2500)  1282' 6-max Seat #5 is the button
Seat 1: JaspritBumrah786 ($3100.6 in chips) 
Seat 2: Miss_Jammer ($3043.83 in chips) 
Seat 3: smoker player  ($605 in chips) 
Seat 4: spidy02 ($1655.96 in chips) 
Seat 5: Lucifer999 ($7119.69 in chips) 
Seat 6: jas8k ($2184.17 in chips) 
JaspritBumrah786: posts small blind $10
Miss_Jammer: posts big blind $25
*** HOLE CARDS ***
Dealt to Lucifer999 [4s 5h]
smoker player : folds
spidy02: raises $35.00 to $60
Lucifer999: folds
JaspritBumrah786: raises $140.00 to $200
Miss_Jammer: folds
spidy02: folds
Uncalled bet ($140) returned to JaspritBumrah786
JaspritBumrah786: doesn't show hand
JaspritBumrah786 collected $145 from pot
*** SUMMARY ***
Total pot $145.00 | Rake $0
Board []
Seat 1: JaspritBumrah786 (small blind) collected ($145)
Seat 2: Miss_Jammer (big blind) folded before Flop
Seat 3: smoker player  folded before Flop (didn't bet)
Seat 4: spidy02 folded before Flop
Seat 5: Lucifer999 (button) folded before Flop (didn't bet)



PokerStars Game #00327557334: Hold'em No Limit ($50/$100 USD) - 2022/04/30 12:25:15 ET
Table 'Hold'em (Min 25KMax 10K)    69' 6-max Seat #3 is the button
Seat 1: Lucifer999 ($30266.09 in chips) 
Seat 3: Mpr@59  ($18297.62 in chips) 
Seat 5: tabby20 ($34048.52 in chips) 
Seat 6: manny007 ($6059.08 in chips) 
tabby20: posts small blind $50
manny007: posts big blind $100
*** HOLE CARDS ***
Dealt to Lucifer999 [3c 5h]
Lucifer999: folds
Mpr@59 : calls $100
tabby20: folds
manny007: checks
*** FLOP *** [Kh 5s Ah]
manny007: checks
Mpr@59 : checks
*** TURN *** [Kh 5s Ah] [4d]
manny007: checks
Mpr@59 : checks
*** RIVER *** [Kh 5s Ah 4d] [3s]
manny007: checks
Mpr@59 : bets $239
manny007: calls $239
*** SHOW DOWN ***
Mpr@59 : shows [Ad As] (Three of a kind, AAA)
manny007: doesn't show hand
Mpr@59  collected $695.97 from pot
*** SUMMARY ***
Total pot $728.00 | Rake $32.03
Board [Kh 5s Ah 4d 3s]
Seat 1: Lucifer999 folded before Flop (didn't bet)
Seat 3: Mpr@59   (button) showed [Ad As] and won ($695.97) with Three of a kind, AAA
Seat 5: tabby20 (small blind) folded before Flop
Seat 6: manny007 (big blind) mucked



PokerStars Game #00327557302: Hold'em No Limit ($10/$25 USD) - 2022/04/30 12:25:06 ET
Table 'Hold'em (Min 500Max 2500) 1001' 6-max Seat #4 is the button
Seat 1: shykko60 ($247.51 in chips) 
Seat 2: gangster100 ($2125.54 in chips) 
Seat 3: movetome ($2025 in chips) 
Seat 4: devi7 ($2269.33 in chips) 
Seat 5: Lucifer999 ($3153.86 in chips) 
Seat 6: spidy02 ($5046.54 in chips) 
Lucifer999: posts small blind $10
spidy02: posts big blind $25
*** HOLE CARDS ***
Dealt to Lucifer999 [Th 8h]
shykko60: folds
gangster100: folds
movetome: folds
devi7: raises $50.00 to $75
Lucifer999: calls $65
spidy02: folds
*** FLOP *** [9c Ac 2s]
Lucifer999: checks
devi7: checks
*** TURN *** [9c Ac 2s] [3c]
Lucifer999: checks
devi7: bets $75
Lucifer999: folds
Uncalled bet ($75) returned to devi7
devi7: doesn't show hand
devi7 collected $164.82 from pot
*** SUMMARY ***
Total pot $175.00 | Rake $10.18
Board [9c Ac 2s 3c]
Seat 1: shykko60 folded before Flop (didn't bet)
Seat 2: gangster100 folded before Flop (didn't bet)
Seat 3: movetome folded before Flop (didn't bet)
Seat 4: devi7 (button) collected ($164.82)
Seat 5: Lucifer999 (small blind) folded on the Turn
Seat 6: spidy02 (big blind) folded before Flop



PokerStars Game #00327557464: Hold'em No Limit ($50/$100 USD) - 2022/04/30 12:25:54 ET
Table 'Hold'em (Min 25KMax 10K)    69' 6-max Seat #5 is the button
Seat 1: Lucifer999 ($30266.09 in chips) 
Seat 3: Mpr@59  ($18654.59 in chips) 
Seat 5: tabby20 ($33998.52 in chips) 
Seat 6: manny007 ($5720.08 in chips) 
manny007: posts small blind $50
Lucifer999: posts big blind $100
*** HOLE CARDS ***
Dealt to Lucifer999 [Th 5d]
Mpr@59 : calls $100
tabby20: raises $350.00 to $450
manny007: folds
Lucifer999: folds
Mpr@59 : folds
Uncalled bet ($350) returned to tabby20
tabby20: doesn't show hand
tabby20 collected $350 from pot
*** SUMMARY ***
Total pot $350.00 | Rake $0
Board []
Seat 1: Lucifer999 (big blind) folded before Flop
Seat 3: Mpr@59  folded before Flop
Seat 5: tabby20 (button) collected ($350)
Seat 6: manny007 (small blind) folded before Flop



PokerStars Game #00327557574: Hold'em No Limit ($50/$100 USD) - 2022/04/30 12:26:22 ET
Table 'Hold'em (Min 25KMax 10K)    69' 6-max Seat #6 is the button
Seat 1: Lucifer999 ($30166.09 in chips) 
Seat 3: Mpr@59  ($18554.59 in chips) 
Seat 5: tabby20 ($34248.52 in chips) 
Seat 6: manny007 ($5670.08 in chips) 
Lucifer999: posts small blind $50
Mpr@59 : posts big blind $100
*** HOLE CARDS ***
Dealt to Lucifer999 [5s Jd]
tabby20: folds
manny007: folds
Lucifer999: folds
Uncalled bet ($50) returned to Mpr@59 
Mpr@59 : doesn't show hand
Mpr@59  collected $100 from pot
*** SUMMARY ***
Total pot $100.00 | Rake $0
Board []
Seat 1: Lucifer999 (small blind) folded before Flop
Seat 3: Mpr@59  (big blind) collected ($100)
Seat 5: tabby20 folded before Flop (didn't bet)
Seat 6: manny007 (button) folded before Flop (didn't bet)



PokerStars Game #00327557467: Hold'em No Limit ($10/$25 USD) - 2022/04/30 12:25:55 ET
Table 'Hold'em (Min 500Max 2500)  1282' 6-max Seat #1 is the button
Seat 1: JaspritBumrah786 ($3185.6 in chips) 
Seat 2: Miss_Jammer ($3018.83 in chips) 
Seat 3: smoker player  ($605 in chips) 
Seat 4: spidy02 ($1595.96 in chips) 
Seat 5: Lucifer999 ($7119.69 in chips) 
Seat 6: jas8k ($2184.17 in chips) 
Miss_Jammer: posts small blind $10
smoker player : posts big blind $25
*** HOLE CARDS ***
Dealt to Lucifer999 [Kh 9h]
spidy02: raises $38.75 to $63.75
Lucifer999: calls $63.75
JaspritBumrah786: folds
Miss_Jammer: folds
smoker player : folds
*** FLOP *** [Ts Ac 5h]
spidy02: checks
Lucifer999: bets $110
spidy02: calls $110
*** TURN *** [Ts Ac 5h] [Ah]
spidy02: checks
Lucifer999: bets $280
spidy02: calls $280
*** RIVER *** [Ts Ac 5h Ah] [3h]
spidy02: bets $444.03
Lucifer999: raises $1795.97 to $2240
spidy02: calls $698.18
Uncalled bet ($1097.79) returned to Lucifer999
*** SHOW DOWN ***
spidy02: shows [Qs Qh] (Two pairs, AAQQ)
Lucifer999: shows [Kh 9h] (Flush, A high)
Lucifer999 collected $3052.56 from pot
*** SUMMARY ***
Total pot $3226.92 | Rake $174.36
Board [Ts Ac 5h Ah 3h]
Seat 1: JaspritBumrah786 (button) folded before Flop (didn't bet)
Seat 2: Miss_Jammer (small blind) folded before Flop
Seat 3: smoker player  (big blind) folded before Flop
Seat 4: spidy02 showed [Qs Qh] and lost with Two pairs, AAQQ
Seat 5: Lucifer999  showed [Kh 9h] and won ($3052.56) with Flush, A high



PokerStars Game #00327557472: Hold'em No Limit ($10/$25 USD) - 2022/04/30 12:25:57 ET
Table 'Hold'em (Min 500Max 2500) 1001' 6-max Seat #5 is the button
Seat 1: shykko60 ($247.51 in chips) 
Seat 2: gangster100 ($2125.54 in chips) 
Seat 3: movetome ($2025 in chips) 
Seat 4: devi7 ($2359.15 in chips) 
Seat 5: Lucifer999 ($3078.86 in chips) 
Seat 6: spidy02 ($5021.54 in chips) 
spidy02: posts small blind $10
shykko60: posts big blind $25
*** HOLE CARDS ***
Dealt to Lucifer999 [5d 4h]
gangster100: folds
movetome: folds
devi7: folds
Lucifer999: folds
spidy02: raises $50.00 to $75
shykko60: folds
Uncalled bet ($50) returned to spidy02
spidy02: doesn't show hand
spidy02 collected $50 from pot
*** SUMMARY ***
Total pot $50.00 | Rake $0
Board []
Seat 1: shykko60 (big blind) folded before Flop
Seat 2: gangster100 folded before Flop (didn't bet)
Seat 3: movetome folded before Flop (didn't bet)
Seat 4: devi7 folded before Flop (didn't bet)
Seat 5: Lucifer999 (button) folded before Flop (didn't bet)
Seat 6: spidy02 (small blind) collected ($50)



PokerStars Game #00327557721: Hold'em No Limit ($10/$25 USD) - 2022/04/30 12:27:00 ET
Table 'Hold'em (Min 500Max 2500)  1282' 6-max Seat #2 is the button
Seat 1: JaspritBumrah786 ($3185.6 in chips) 
Seat 2: Miss_Jammer ($3008.83 in chips) 
Seat 3: smoker player  ($580 in chips) 
Seat 5: Lucifer999 ($8576.29 in chips) 
Seat 6: jas8k ($2184.17 in chips) 
smoker player : posts small blind $10
Lucifer999: posts big blind $25
*** HOLE CARDS ***
Dealt to Lucifer999 [Ts 6s]
JaspritBumrah786: raises $50.00 to $75
Miss_Jammer: folds
smoker player : raises $505.00 to $580
Lucifer999: folds
JaspritBumrah786: folds
Uncalled bet ($505) returned to smoker player 
smoker player : doesn't show hand
smoker player  collected $175 from pot
*** SUMMARY ***
Total pot $175.00 | Rake $0
Board []
Seat 1: JaspritBumrah786 folded before Flop
Seat 2: Miss_Jammer (button) folded before Flop (didn't bet)
Seat 3: smoker player  (small blind) collected ($175)
Seat 5: Lucifer999 (big blind) folded before Flop



PokerStars Game #00327557671: Hold'em No Limit ($50/$100 USD) - 2022/04/30 12:26:47 ET
Table 'Hold'em (Min 25KMax 10K)    69' 6-max Seat #1 is the button
Seat 1: Lucifer999 ($30116.09 in chips) 
Seat 3: Mpr@59  ($18604.59 in chips) 
Seat 5: tabby20 ($34248.52 in chips) 
Seat 6: manny007 ($5670.08 in chips) 
Mpr@59 : posts small blind $50
tabby20: posts big blind $100
*** HOLE CARDS ***
Dealt to Lucifer999 [5s 5c]
manny007: folds
Lucifer999: folds
Mpr@59 : calls $50
tabby20: raises $200.00 to $300
Mpr@59 : calls $200
*** FLOP *** [8c 3c Jh]
Mpr@59 : checks
tabby20: bets $350
Mpr@59 : calls $350
*** TURN *** [8c 3c Jh] [7c]
Mpr@59 : checks
tabby20: checks
*** RIVER *** [8c 3c Jh 7c] [2h]
Mpr@59 : bets $1242.8
tabby20: folds
Uncalled bet ($1242.8) returned to Mpr@59 
Mpr@59 : doesn't show hand
Mpr@59  collected $1242.8 from pot
*** SUMMARY ***
Total pot $1300.00 | Rake $57.2
Board [8c 3c Jh 7c 2h]
Seat 1: Lucifer999 (button) folded before Flop (didn't bet)
Seat 3: Mpr@59  (small blind) collected ($1242.8)
Seat 5: tabby20 (big blind) folded on the River
Seat 6: manny007 folded before Flop (didn't bet)



PokerStars Game #00327557858: Hold'em No Limit ($25/$50 USD) - 2022/04/30 12:27:36 ET
Table 'Hold'em (Min 1K Max 5K)   216' 6-max Seat #1 is the button
Seat 1: Lucifer999 ($15295.86 in chips) 
Seat 4: manoj_d ($4111.66 in chips) 
Lucifer999: posts small blind $25
manoj_d: posts big blind $50
*** HOLE CARDS ***
Dealt to Lucifer999 [6h 9s]
Lucifer999: raises $100.00 to $150
manoj_d: folds
Uncalled bet ($100) returned to Lucifer999
Lucifer999: doesn't show hand
Lucifer999 collected $100 from pot
*** SUMMARY ***
Total pot $100.00 | Rake $0
Board []
Seat 1: Lucifer999 (button) (small blind) collected ($100)
Seat 4: manoj_d (big blind) folded before Flop



PokerStars Game #00327557866: Hold'em No Limit ($50/$100 USD) - 2022/04/30 12:27:38 ET
Table 'Hold'em (Min 25KMax 10K)    69' 6-max Seat #3 is the button
Seat 1: Lucifer999 ($30116.09 in chips) 
Seat 3: Mpr@59  ($19197.39 in chips) 
Seat 5: tabby20 ($33598.52 in chips) 
Seat 6: manny007 ($5670.08 in chips) 
tabby20: posts small blind $50
manny007: posts big blind $100
*** HOLE CARDS ***
Dealt to Lucifer999 [Qc 7c]
Lucifer999: folds
Mpr@59 : folds
tabby20: folds
Uncalled bet ($50) returned to manny007
manny007: doesn't show hand
manny007 collected $100 from pot
*** SUMMARY ***
Total pot $100.00 | Rake $0
Board []
Seat 1: Lucifer999 folded before Flop (didn't bet)
Seat 3: Mpr@59  (button) folded before Flop (didn't bet)
Seat 5: tabby20 (small blind) folded before Flop
Seat 6: manny007 (big blind) collected ($100)



PokerStars Game #00327557783: Hold'em No Limit ($10/$25 USD) - 2022/04/30 12:27:14 ET
Table 'Hold'em (Min 500Max 2500) 1001' 6-max Seat #6 is the button
Seat 1: shykko60 ($562.51 in chips) 
Seat 2: gangster100 ($2125.54 in chips) 
Seat 3: movetome ($2025 in chips) 
Seat 4: devi7 ($2359.15 in chips) 
Seat 5: Lucifer999 ($3078.86 in chips) 
Seat 6: spidy02 ($5046.54 in chips) 
shykko60: posts small blind $10
gangster100: posts big blind $25
*** HOLE CARDS ***
Dealt to Lucifer999 [Ah 7c]
movetome: folds
devi7: raises $50.00 to $75
Lucifer999: folds
spidy02: folds
shykko60: calls $65
gangster100: folds
*** FLOP *** [As Kc Tc]
shykko60: checks
devi7: checks
*** TURN *** [As Kc Tc] [Qc]
shykko60: bets $487.51
devi7: folds
Uncalled bet ($487.51) returned to shykko60
shykko60: doesn't show hand
shykko60 collected $164.82 from pot
*** SUMMARY ***
Total pot $175.00 | Rake $10.18
Board [As Kc Tc Qc]
Seat 1: shykko60 (small blind) collected ($164.82)
Seat 2: gangster100 (big blind) folded before Flop
Seat 3: movetome folded before Flop (didn't bet)
Seat 4: devi7 folded on the Turn
Seat 5: Lucifer999 folded before Flop (didn't bet)
Seat 6: spidy02 (button) folded before Flop (didn't bet)



PokerStars Game #00327557842: Hold'em No Limit ($10/$25 USD) - 2022/04/30 12:27:31 ET
Table 'Hold'em (Min 500Max 2500)  1282' 6-max Seat #3 is the button
Seat 1: JaspritBumrah786 ($3110.6 in chips) 
Seat 2: Miss_Jammer ($3008.83 in chips) 
Seat 3: smoker player  ($680 in chips) 
Seat 5: Lucifer999 ($8551.29 in chips) 
Seat 6: jas8k ($2184.17 in chips) 
Lucifer999: posts small blind $10
JaspritBumrah786: posts big blind $25
*** HOLE CARDS ***
Dealt to Lucifer999 [2d 8s]
Miss_Jammer: folds
smoker player : calls $25
Lucifer999: folds
JaspritBumrah786: checks
*** FLOP *** [5h 4h 9s]
JaspritBumrah786: bets $50
smoker player : calls $50
*** TURN *** [5h 4h 9s] [2s]
JaspritBumrah786: bets $100
smoker player : folds
Uncalled bet ($100) returned to JaspritBumrah786
JaspritBumrah786: doesn't show hand
JaspritBumrah786 collected $150.6 from pot
*** SUMMARY ***
Total pot $160.00 | Rake $9.4
Board [5h 4h 9s 2s]
Seat 1: JaspritBumrah786 (big blind) collected ($150.6)
Seat 2: Miss_Jammer folded before Flop (didn't bet)
Seat 3: smoker player  (button) folded on the Turn
Seat 5: Lucifer999 (small blind) folded before Flop



PokerStars Game #00327557965: Hold'em No Limit ($10/$25 USD) - 2022/04/30 12:28:06 ET
Table 'Hold'em (Min 500Max 2500) 1001' 6-max Seat #1 is the button
Seat 1: shykko60 ($652.33 in chips) 
Seat 2: gangster100 ($2100.54 in chips) 
Seat 3: movetome ($2025 in chips) 
Seat 4: devi7 ($2284.15 in chips) 
Seat 5: Lucifer999 ($3078.86 in chips) 
Seat 6: spidy02 ($5046.54 in chips) 
gangster100: posts small blind $10
movetome: posts big blind $25
*** HOLE CARDS ***
Dealt to Lucifer999 [3h 7h]
devi7: folds
Lucifer999: folds
spidy02: folds
shykko60: folds
gangster100: folds
Uncalled bet ($15) returned to movetome
movetome: doesn't show hand
movetome collected $20 from pot
*** SUMMARY ***
Total pot $20.00 | Rake $0
Board []
Seat 1: shykko60 (button) folded before Flop (didn't bet)
Seat 2: gangster100 (small blind) folded before Flop
Seat 3: movetome (big blind) collected ($20)
Seat 4: devi7 folded before Flop (didn't bet)
Seat 5: Lucifer999 folded before Flop (didn't bet)
Seat 6: spidy02 folded before Flop (didn't bet)



PokerStars Game #00327557975: Hold'em No Limit ($10/$25 USD) - 2022/04/30 12:28:09 ET
Table 'Hold'em (Min 500Max 2500)  1282' 6-max Seat #5 is the button
Seat 1: JaspritBumrah786 ($3186.2 in chips) 
Seat 2: Miss_Jammer ($3008.83 in chips) 
Seat 3: smoker player  ($605 in chips) 
Seat 5: Lucifer999 ($8541.29 in chips) 
Seat 6: jas8k ($2184.17 in chips) 
JaspritBumrah786: posts small blind $10
Miss_Jammer: posts big blind $25
*** HOLE CARDS ***
Dealt to Lucifer999 [4c 8c]
smoker player : folds
Lucifer999: folds
JaspritBumrah786: folds
Uncalled bet ($15) returned to Miss_Jammer
Miss_Jammer: doesn't show hand
Miss_Jammer collected $20 from pot
*** SUMMARY ***
Total pot $20.00 | Rake $0
Board []
Seat 1: JaspritBumrah786 (small blind) folded before Flop
Seat 2: Miss_Jammer (big blind) collected ($20)
Seat 3: smoker player  folded before Flop (didn't bet)
Seat 5: Lucifer999 (button) folded before Flop (didn't bet)



PokerStars Game #00327557951: Hold'em No Limit ($50/$100 USD) - 2022/04/30 12:28:02 ET
Table 'Hold'em (Min 25KMax 10K)    69' 6-max Seat #5 is the button
Seat 1: Lucifer999 ($30116.09 in chips) 
Seat 3: Mpr@59  ($19197.39 in chips) 
Seat 5: tabby20 ($33548.52 in chips) 
Seat 6: manny007 ($5720.08 in chips) 
manny007: posts small blind $50
Lucifer999: posts big blind $100
*** HOLE CARDS ***
Dealt to Lucifer999 [Kc Qs]
Mpr@59 : calls $100
tabby20: folds
manny007: calls $50
Lucifer999: raises $350.00 to $450
Mpr@59 : folds
manny007: folds
Uncalled bet ($350) returned to Lucifer999
Lucifer999: doesn't show hand
Lucifer999 collected $300 from pot
*** SUMMARY ***
Total pot $300.00 | Rake $0
Board []
Seat 1: Lucifer999 (big blind) collected ($300)
Seat 3: Mpr@59  folded before Flop
Seat 5: tabby20 (button) folded before Flop (didn't bet)
Seat 6: manny007 (small blind) folded before Flop



PokerStars Game #00327558078: Hold'em No Limit ($10/$25 USD) - 2022/04/30 12:28:33 ET
Table 'Hold'em (Min 500Max 2500)  1282' 6-max Seat #1 is the button
Seat 1: JaspritBumrah786 ($3176.2 in chips) 
Seat 2: Miss_Jammer ($3018.83 in chips) 
Seat 3: smoker player  ($605 in chips) 
Seat 5: Lucifer999 ($8541.29 in chips) 
Seat 6: jas8k ($2184.17 in chips) 
Miss_Jammer: posts small blind $10
smoker player : posts big blind $25
*** HOLE CARDS ***
Dealt to Lucifer999 [Ks 7c]
Lucifer999: folds
JaspritBumrah786: folds
Miss_Jammer: raises $50.00 to $75
smoker player : folds
Uncalled bet ($50) returned to Miss_Jammer
Miss_Jammer: doesn't show hand
Miss_Jammer collected $50 from pot
*** SUMMARY ***
Total pot $50.00 | Rake $0
Board []
Seat 1: JaspritBumrah786 (button) folded before Flop (didn't bet)
Seat 2: Miss_Jammer (small blind) collected ($50)
Seat 3: smoker player  (big blind) folded before Flop
Seat 5: Lucifer999 folded before Flop (didn't bet)



PokerStars Game #00327558053: Hold'em No Limit ($10/$25 USD) - 2022/04/30 12:28:28 ET
Table 'Hold'em (Min 500Max 2500) 1001' 6-max Seat #2 is the button
Seat 1: shykko60 ($652.33 in chips) 
Seat 2: gangster100 ($2090.54 in chips) 
Seat 3: movetome ($2035 in chips) 
Seat 4: devi7 ($2284.15 in chips) 
Seat 5: Lucifer999 ($3078.86 in chips) 
Seat 6: spidy02 ($5046.54 in chips) 
movetome: posts small blind $10
devi7: posts big blind $25
*** HOLE CARDS ***
Dealt to Lucifer999 [Tc Qd]
Lucifer999: folds
spidy02: folds
shykko60: calls $25
gangster100: folds
movetome: folds
devi7: checks
*** FLOP *** [3s Kd Td]
devi7: bets $50
shykko60: folds
Uncalled bet ($50) returned to devi7
devi7: doesn't show hand
devi7 collected $56.85 from pot
*** SUMMARY ***
Total pot $60.00 | Rake $3.15
Board [3s Kd Td]
Seat 1: shykko60 folded on the Flop
Seat 2: gangster100 (button) folded before Flop (didn't bet)
Seat 3: movetome (small blind) folded before Flop
Seat 4: devi7 (big blind) collected ($56.85)
Seat 5: Lucifer999 folded before Flop (didn't bet)
Seat 6: spidy02 folded before Flop (didn't bet)



PokerStars Game #00327558099: Hold'em No Limit ($50/$100 USD) - 2022/04/30 12:28:38 ET
Table 'Hold'em (Min 25KMax 10K)    69' 6-max Seat #6 is the button
Seat 1: Lucifer999 ($30316.09 in chips) 
Seat 3: Mpr@59  ($19097.39 in chips) 
Seat 5: tabby20 ($33548.52 in chips) 
Seat 6: manny007 ($5620.08 in chips) 
Lucifer999: posts small blind $50
Mpr@59 : posts big blind $100
*** HOLE CARDS ***
Dealt to Lucifer999 [7c Qh]
tabby20: raises $200.00 to $300
manny007: calls $300
Lucifer999: folds
Mpr@59 : calls $200
*** FLOP *** [Td 6c 6h]
Mpr@59 : checks
tabby20: bets $550
manny007: calls $550
Mpr@59 : folds
*** TURN *** [Td 6c 6h] [9h]
tabby20: checks
manny007: bets $1254.46
tabby20: folds
Uncalled bet ($1254.46) returned to manny007
manny007: doesn't show hand
manny007 collected $1959.8 from pot
*** SUMMARY ***
Total pot $2050.00 | Rake $90.2
Board [Td 6c 6h 9h]
Seat 1: Lucifer999 (small blind) folded before Flop
Seat 3: Mpr@59  (big blind) folded on the Flop
Seat 5: tabby20 folded on the Turn
Seat 6: manny007 (button) collected ($1959.8)



PokerStars Game #00327558191: Hold'em No Limit ($10/$25 USD) - 2022/04/30 12:29:04 ET
Table 'Hold'em (Min 500Max 2500)  1282' 6-max Seat #2 is the button
Seat 1: JaspritBumrah786 ($3176.2 in chips) 
Seat 2: Miss_Jammer ($3043.83 in chips) 
Seat 3: smoker player  ($580 in chips) 
Seat 5: Lucifer999 ($8541.29 in chips) 
Seat 6: jas8k ($2184.17 in chips) 
smoker player : posts small blind $10
Lucifer999: posts big blind $25
*** HOLE CARDS ***
Dealt to Lucifer999 [2s 3s]
JaspritBumrah786: folds
Miss_Jammer: raises $50.00 to $75
smoker player : calls $65
Lucifer999: folds
*** FLOP *** [7s 2h Kh]
smoker player : checks
Miss_Jammer: bets $125
smoker player : raises $380.00 to $505
Miss_Jammer: folds
Uncalled bet ($380) returned to smoker player 
smoker player : doesn't show hand
smoker player  collected $398.69 from pot
*** SUMMARY ***
Total pot $425.00 | Rake $26.31
Board [7s 2h Kh]
Seat 1: JaspritBumrah786 folded before Flop (didn't bet)
Seat 2: Miss_Jammer (button) folded on the Flop
Seat 3: smoker player  (small blind) collected ($398.69)
Seat 5: Lucifer999 (big blind) folded before Flop



PokerStars Game #00327558271: Hold'em No Limit ($50/$100 USD) - 2022/04/30 12:29:27 ET
Table 'Hold'em (Min 25KMax 10K)    69' 6-max Seat #1 is the button
Seat 1: Lucifer999 ($30266.09 in chips) 
Seat 3: Mpr@59  ($18797.39 in chips) 
Seat 5: tabby20 ($32698.52 in chips) 
Seat 6: manny007 ($6729.88 in chips) 
Mpr@59 : posts small blind $50
tabby20: posts big blind $100
*** HOLE CARDS ***
Dealt to Lucifer999 [7c 2s]
manny007: calls $100
Lucifer999: folds
Mpr@59 : calls $50
tabby20: checks
*** FLOP *** [3d 3h Ts]
Mpr@59 : checks
tabby20: checks
manny007: checks
*** TURN *** [3d 3h Ts] [Kh]
Mpr@59 : checks
tabby20: checks
manny007: bets $160.52
Mpr@59 : calls $160.52
tabby20: folds
*** RIVER *** [3d 3h Ts Kh] [4s]
Mpr@59 : checks
manny007: bets $296.86
Mpr@59 : folds
Uncalled bet ($296.86) returned to manny007
manny007: doesn't show hand
manny007 collected $593.72 from pot
*** SUMMARY ***
Total pot $621.04 | Rake $27.32
Board [3d 3h Ts Kh 4s]
Seat 1: Lucifer999 (button) folded before Flop (didn't bet)
Seat 3: Mpr@59  (small blind) folded on the River
Seat 5: tabby20 (big blind) folded on the Turn
Seat 6: manny007 collected ($593.72)



PokerStars Game #00327558202: Hold'em No Limit ($10/$25 USD) - 2022/04/30 12:29:08 ET
Table 'Hold'em (Min 500Max 2500) 1001' 6-max Seat #3 is the button
Seat 1: shykko60 ($627.33 in chips) 
Seat 2: gangster100 ($2090.54 in chips) 
Seat 3: movetome ($2025 in chips) 
Seat 4: devi7 ($2316 in chips) 
Seat 5: Lucifer999 ($3078.86 in chips) 
Seat 6: spidy02 ($5046.54 in chips) 
devi7: posts small blind $10
Lucifer999: posts big blind $25
*** HOLE CARDS ***
Dealt to Lucifer999 [6s Td]
spidy02: folds
shykko60: folds
gangster100: folds
movetome: calls $25
devi7: folds
Lucifer999: checks
*** FLOP *** [3h 2h 7h]
Lucifer999: checks
movetome: checks
*** TURN *** [3h 2h 7h] [7s]
Lucifer999: checks
movetome: checks
*** RIVER *** [3h 2h 7h 7s] [5s]
Lucifer999: bets $50
movetome: calls $50
*** SHOW DOWN ***
Lucifer999: shows [6s Td] (Pair, 77)
movetome: shows [Ac As] (Two pairs, AA77)
movetome collected $150.6 from pot
*** SUMMARY ***
Total pot $160.00 | Rake $9.4
Board [3h 2h 7h 7s 5s]
Seat 1: shykko60 folded before Flop (didn't bet)
Seat 2: gangster100 folded before Flop (didn't bet)
Seat 3: movetome  (button) showed [Ac As] and won ($150.6) with Two pairs, AA77
Seat 4: devi7 (small blind) folded before Flop
Seat 5: Lucifer999 (big blind) showed [6s Td] and lost with Pair, 77
Seat 6: spidy02 folded before Flop (didn't bet)



PokerStars Game #00327558372: Hold'em No Limit ($10/$25 USD) - 2022/04/30 12:29:57 ET
Table 'Hold'em (Min 500Max 2500)  1282' 6-max Seat #3 is the button
Seat 1: JaspritBumrah786 ($3176.2 in chips) 
Seat 2: Miss_Jammer ($2843.83 in chips) 
Seat 3: smoker player  ($778.69 in chips) 
Seat 5: Lucifer999 ($8516.29 in chips) 
Seat 6: jas8k ($2184.17 in chips) 
Lucifer999: posts small blind $10
JaspritBumrah786: posts big blind $25
*** HOLE CARDS ***
Dealt to Lucifer999 [Th Kh]
Miss_Jammer: folds
smoker player : calls $25
Lucifer999: raises $85.00 to $110
JaspritBumrah786: folds
smoker player : folds
Uncalled bet ($85) returned to Lucifer999
Lucifer999: doesn't show hand
Lucifer999 collected $75 from pot
*** SUMMARY ***
Total pot $75.00 | Rake $0
Board []
Seat 1: JaspritBumrah786 (big blind) folded before Flop
Seat 2: Miss_Jammer folded before Flop (didn't bet)
Seat 3: smoker player  (button) folded before Flop
Seat 5: Lucifer999 (small blind) collected ($75)



PokerStars Game #00327558437: Hold'em No Limit ($10/$25 USD) - 2022/04/30 12:30:10 ET
Table 'Hold'em (Min 500Max 2500) 1001' 6-max Seat #4 is the button
Seat 1: shykko60 ($627.33 in chips) 
Seat 2: gangster100 ($2090.54 in chips) 
Seat 3: movetome ($2175.6 in chips) 
Seat 4: devi7 ($2306 in chips) 
Seat 5: Lucifer999 ($3003.86 in chips) 
Seat 6: spidy02 ($5046.54 in chips) 
Lucifer999: posts small blind $10
spidy02: posts big blind $25
*** HOLE CARDS ***
Dealt to Lucifer999 [Th 5c]
shykko60: folds
gangster100: folds
movetome: folds
devi7: raises $50.00 to $75
Lucifer999: folds
spidy02: folds
Uncalled bet ($50) returned to devi7
devi7: doesn't show hand
devi7 collected $60 from pot
*** SUMMARY ***
Total pot $60.00 | Rake $0
Board []
Seat 1: shykko60 folded before Flop (didn't bet)
Seat 2: gangster100 folded before Flop (didn't bet)
Seat 3: movetome folded before Flop (didn't bet)
Seat 4: devi7 (button) collected ($60)
Seat 5: Lucifer999 (small blind) folded before Flop
Seat 6: spidy02 (big blind) folded before Flop



PokerStars Game #00327558429: Hold'em No Limit ($50/$100 USD) - 2022/04/30 12:30:08 ET
Table 'Hold'em (Min 25KMax 10K)    69' 6-max Seat #3 is the button
Seat 1: Lucifer999 ($30266.09 in chips) 
Seat 3: Mpr@59  ($18536.87 in chips) 
Seat 5: tabby20 ($32598.52 in chips) 
Seat 6: manny007 ($7063.08 in chips) 
tabby20: posts small blind $50
manny007: posts big blind $100
*** HOLE CARDS ***
Dealt to Lucifer999 [4h Qs]
Lucifer999: folds
Mpr@59 : calls $100
tabby20: calls $50
manny007: checks
*** FLOP *** [2c Jd 5c]
tabby20: bets $286.8
manny007: calls $286.8
Mpr@59 : folds
*** TURN *** [2c Jd 5c] [9c]
tabby20: checks
manny007: bets $417.6
tabby20: calls $417.6
*** RIVER *** [2c Jd 5c 9c] [3h]
tabby20: checks
manny007: bets $1225.24
tabby20: folds
Uncalled bet ($1225.24) returned to manny007
manny007: doesn't show hand
manny007 collected $1633.65 from pot
*** SUMMARY ***
Total pot $1708.80 | Rake $75.15
Board [2c Jd 5c 9c 3h]
Seat 1: Lucifer999 folded before Flop (didn't bet)
Seat 3: Mpr@59  (button) folded on the Flop
Seat 5: tabby20 (small blind) folded on the River
Seat 6: manny007 (big blind) collected ($1633.65)



PokerStars Game #00327558487: Hold'em No Limit ($25/$50 USD) - 2022/04/30 12:30:23 ET
Table 'Hold'em (Min 1K Max 5K)   216' 6-max Seat #1 is the button
Seat 1: Lucifer999 ($15345.86 in chips) 
Seat 6: Pablit0 ($1000 in chips) 
Lucifer999: posts small blind $25
Pablit0: posts big blind $50
*** HOLE CARDS ***
Dealt to Lucifer999 [5h Ad]
Lucifer999: calls $25
Pablit0: checks
*** FLOP *** [8h Jd As]
Pablit0: bets $50
Lucifer999: calls $50
*** TURN *** [8h Jd As] [4d]
Pablit0: bets $100
Lucifer999: raises $252.25 to $352.25
Pablit0: folds
Uncalled bet ($252.25) returned to Lucifer999
Lucifer999: doesn't show hand
Lucifer999 collected $382 from pot
*** SUMMARY ***
Total pot $400.00 | Rake $18
Board [8h Jd As 4d]
Seat 1: Lucifer999 (button) (small blind) collected ($382)
Seat 6: Pablit0 (big blind) folded on the Turn



PokerStars Game #00327558464: Hold'em No Limit ($10/$25 USD) - 2022/04/30 12:30:18 ET
Table 'Hold'em (Min 500Max 2500)  1282' 6-max Seat #5 is the button
Seat 1: JaspritBumrah786 ($3151.2 in chips) 
Seat 2: Miss_Jammer ($2843.83 in chips) 
Seat 3: smoker player  ($753.69 in chips) 
Seat 5: Lucifer999 ($8566.29 in chips) 
Seat 6: jas8k ($2184.17 in chips) 
JaspritBumrah786: posts small blind $10
Miss_Jammer: posts big blind $25
*** HOLE CARDS ***
Dealt to Lucifer999 [Ah 7s]
smoker player : folds
Lucifer999: raises $55.00 to $80
JaspritBumrah786: folds
Miss_Jammer: calls $55
*** FLOP *** [4h 5h 4c]
Miss_Jammer: checks
Lucifer999: bets $80
Miss_Jammer: calls $80
*** TURN *** [4h 5h 4c] [5s]
Miss_Jammer: bets $225
Lucifer999: folds
Uncalled bet ($225) returned to Miss_Jammer
Miss_Jammer: doesn't show hand
Miss_Jammer collected $309.68 from pot
*** SUMMARY ***
Total pot $330.00 | Rake $20.32
Board [4h 5h 4c 5s]
Seat 1: JaspritBumrah786 (small blind) folded before Flop
Seat 2: Miss_Jammer (big blind) collected ($309.68)
Seat 3: smoker player  folded before Flop (didn't bet)
Seat 5: Lucifer999 (button) folded on the Turn



PokerStars Game #00327558684: Hold'em No Limit ($25/$50 USD) - 2022/04/30 12:31:12 ET
Table 'Hold'em (Min 1K Max 5K)   216' 6-max Seat #6 is the button
Seat 1: Lucifer999 ($15527.86 in chips) 
Seat 6: Pablit0 ($800 in chips) 
Pablit0: posts small blind $25
Lucifer999: posts big blind $50
*** HOLE CARDS ***
Dealt to Lucifer999 [5s 5c]
Pablit0: raises $100.00 to $150
Lucifer999: raises $650.00 to $800
Pablit0: calls $650
*** FLOP *** [3c 9d Ah]
*** FLOP *** [Qd Kc Ac]
*** TURN *** [3c 9d Ah] [2s]
*** TURN *** [3c 9d Ah] [Qc]
*** RIVER *** [3c 9d Ah 2s] [2d]
*** RIVER *** [3c 9d Ah 2s] [2h]
*** SHOW DOWN ***
Lucifer999: shows [5s 5c] (Two pairs, QQ55)
Pablit0: shows [Js Jh] (Two pairs, QQJJ)
Pablit0 collected $764 from pot
Pablit0 collected $764 from pot
*** SUMMARY ***
Total pot $1600.00 | Rake $72
Board [3c 9d Ah 2s 2d]
Seat 1: Lucifer999 (big blind) showed [5s 5c] and lost with Two pairs, QQ55
Seat 6: Pablit0  (button) (small blind) showed [Js Jh] and won ($764) with Two pairs, QQJJ



PokerStars Game #00327558551: Hold'em No Limit ($10/$25 USD) - 2022/04/30 12:30:37 ET
Table 'Hold'em (Min 500Max 2500) 1001' 6-max Seat #5 is the button
Seat 1: shykko60 ($627.33 in chips) 
Seat 2: gangster100 ($2090.54 in chips) 
Seat 3: movetome ($2175.6 in chips) 
Seat 4: devi7 ($2341 in chips) 
Seat 5: Lucifer999 ($2993.86 in chips) 
Seat 6: spidy02 ($5021.54 in chips) 
spidy02: posts small blind $10
shykko60: posts big blind $25
*** HOLE CARDS ***
Dealt to Lucifer999 [8d 7c]
gangster100: raises $60.00 to $85
movetome: folds
devi7: folds
Lucifer999: folds
spidy02: folds
shykko60: calls $60
*** FLOP *** [3s 7d 7s]
shykko60: checks
gangster100: checks
*** TURN *** [3s 7d 7s] [2h]
shykko60: bets $25
gangster100: calls $25
*** RIVER *** [3s 7d 7s 2h] [3c]
shykko60: bets $75
gangster100: folds
Uncalled bet ($75) returned to shykko60
shykko60: doesn't show hand
shykko60 collected $215.93 from pot
*** SUMMARY ***
Total pot $230.00 | Rake $14.07
Board [3s 7d 7s 2h 3c]
Seat 1: shykko60 (big blind) collected ($215.93)
Seat 2: gangster100 folded on the River
Seat 3: movetome folded before Flop (didn't bet)
Seat 4: devi7 folded before Flop (didn't bet)
Seat 5: Lucifer999 (button) folded before Flop (didn't bet)
Seat 6: spidy02 (small blind) folded before Flop



PokerStars Game #00327558712: Hold'em No Limit ($10/$25 USD) - 2022/04/30 12:31:18 ET
Table 'Hold'em (Min 500Max 2500)  1282' 6-max Seat #1 is the button
Seat 1: JaspritBumrah786 ($3141.2 in chips) 
Seat 2: Miss_Jammer ($2993.51 in chips) 
Seat 3: smoker player  ($753.69 in chips) 
Seat 4: RD9627950832 ($2500 in chips) 
Seat 5: Lucifer999 ($8406.29 in chips) 
Seat 6: jas8k ($2184.17 in chips) 
Miss_Jammer: posts small blind $10
smoker player : posts big blind $25
*** HOLE CARDS ***
Dealt to Lucifer999 [6d 9c]
RD9627950832: folds
Lucifer999: folds
JaspritBumrah786: raises $50.00 to $75
Miss_Jammer: raises $150.00 to $225
smoker player : folds
JaspritBumrah786: folds
Uncalled bet ($150) returned to Miss_Jammer
Miss_Jammer: doesn't show hand
Miss_Jammer collected $200 from pot
*** SUMMARY ***
Total pot $200.00 | Rake $0
Board []
Seat 1: JaspritBumrah786 (button) folded before Flop
Seat 2: Miss_Jammer (small blind) collected ($200)
Seat 3: smoker player  (big blind) folded before Flop
Seat 4: RD9627950832 folded before Flop (didn't bet)
Seat 5: Lucifer999 folded before Flop (didn't bet)



PokerStars Game #00327558791: Hold'em No Limit ($25/$50 USD) - 2022/04/30 12:31:36 ET
Table 'Hold'em (Min 1K Max 5K)   216' 6-max Seat #1 is the button
Seat 1: Lucifer999 ($14727.86 in chips) 
Seat 6: Pablit0 ($1528 in chips) 
Lucifer999: posts small blind $25
Pablit0: posts big blind $50
*** HOLE CARDS ***
Dealt to Lucifer999 [Js 3c]
Lucifer999: calls $25
Pablit0: checks
*** FLOP *** [5d 5h Ks]
Pablit0: checks
Lucifer999: bets $50
Pablit0: folds
Uncalled bet ($50) returned to Lucifer999
Lucifer999: doesn't show hand
Lucifer999 collected $95.5 from pot
*** SUMMARY ***
Total pot $100.00 | Rake $4.5
Board [5d 5h Ks]
Seat 1: Lucifer999 (button) (small blind) collected ($95.5)
Seat 6: Pablit0 (big blind) folded on the Flop



PokerStars Game #00327558817: Hold'em No Limit ($10/$25 USD) - 2022/04/30 12:31:41 ET
Table 'Hold'em (Min 500Max 2500) 1001' 6-max Seat #6 is the button
Seat 1: shykko60 ($733.26 in chips) 
Seat 2: gangster100 ($1980.54 in chips) 
Seat 3: movetome ($2175.6 in chips) 
Seat 4: devi7 ($2341 in chips) 
Seat 5: Lucifer999 ($2993.86 in chips) 
Seat 6: spidy02 ($5011.54 in chips) 
shykko60: posts small blind $10
gangster100: posts big blind $25
*** HOLE CARDS ***
Dealt to Lucifer999 [Ac 6d]
movetome: folds
devi7: folds
Lucifer999: folds
spidy02: folds
shykko60: folds
Uncalled bet ($15) returned to gangster100
gangster100: doesn't show hand
gangster100 collected $20 from pot
*** SUMMARY ***
Total pot $20.00 | Rake $0
Board []
Seat 1: shykko60 (small blind) folded before Flop
Seat 2: gangster100 (big blind) collected ($20)
Seat 3: movetome folded before Flop (didn't bet)
Seat 4: devi7 folded before Flop (didn't bet)
Seat 5: Lucifer999 folded before Flop (didn't bet)
Seat 6: spidy02 (button) folded before Flop (didn't bet)



PokerStars Game #00327558647: Hold'em No Limit ($50/$100 USD) - 2022/04/30 12:31:02 ET
Table 'Hold'em (Min 25KMax 10K)    69' 6-max Seat #5 is the button
Seat 1: Lucifer999 ($30266.09 in chips) 
Seat 3: Mpr@59  ($18436.87 in chips) 
Seat 5: tabby20 ($31794.12 in chips) 
Seat 6: manny007 ($7892.33 in chips) 
manny007: posts small blind $50
Lucifer999: posts big blind $100
*** HOLE CARDS ***
Dealt to Lucifer999 [Qc Ah]
Mpr@59 : calls $100
tabby20: folds
manny007: calls $50
Lucifer999: raises $350.00 to $450
Mpr@59 : calls $350
manny007: folds
*** FLOP *** [Th 8d Kc]
Lucifer999: checks
Mpr@59 : checks
*** TURN *** [Th 8d Kc] [7s]
Lucifer999: bets $850
Mpr@59 : calls $850
*** RIVER *** [Th 8d Kc 7s] [Jh]
Lucifer999: bets $2600
Mpr@59 : calls $2600
*** SHOW DOWN ***
Lucifer999: shows [Qc Ah] (Straight, A-T)
Mpr@59 : doesn't show hand
Lucifer999 collected $7552.4 from pot
*** SUMMARY ***
Total pot $7900.00 | Rake $347.6
Board [Th 8d Kc 7s Jh]
Seat 1: Lucifer999  (big blind) showed [Qc Ah] and won ($7552.4) with Straight, A-T
Seat 3: Mpr@59  mucked
Seat 5: tabby20 (button) folded before Flop (didn't bet)
Seat 6: manny007 (small blind) folded before Flop



PokerStars Game #00327558895: Hold'em No Limit ($25/$50 USD) - 2022/04/30 12:32:02 ET
Table 'Hold'em (Min 1K Max 5K)   216' 6-max Seat #6 is the button
Seat 1: Lucifer999 ($14773.36 in chips) 
Seat 6: Pablit0 ($1478 in chips) 
Pablit0: posts small blind $25
Lucifer999: posts big blind $50
*** HOLE CARDS ***
Dealt to Lucifer999 [3s 8c]
Pablit0: folds
Uncalled bet ($25) returned to Lucifer999
Lucifer999: doesn't show hand
Lucifer999 collected $50 from pot
*** SUMMARY ***
Total pot $50.00 | Rake $0
Board []
Seat 1: Lucifer999 (big blind) collected ($50)
Seat 6: Pablit0 (button) (small blind) folded before Flop



PokerStars Game #00327558937: Hold'em No Limit ($25/$50 USD) - 2022/04/30 12:32:12 ET
Table 'Hold'em (Min 1K Max 5K)   216' 6-max Seat #1 is the button
Seat 1: Lucifer999 ($14798.36 in chips) 
Seat 6: Pablit0 ($1453 in chips) 
Lucifer999: posts small blind $25
Pablit0: posts big blind $50
*** HOLE CARDS ***
Dealt to Lucifer999 [Qd 6d]
Lucifer999: calls $25
Pablit0: checks
*** FLOP *** [8c 4c 7s]
Pablit0: checks
Lucifer999: bets $150
Pablit0: folds
Uncalled bet ($150) returned to Lucifer999
Lucifer999: doesn't show hand
Lucifer999 collected $95.5 from pot
*** SUMMARY ***
Total pot $100.00 | Rake $4.5
Board [8c 4c 7s]
Seat 1: Lucifer999 (button) (small blind) collected ($95.5)
Seat 6: Pablit0 (big blind) folded on the Flop



PokerStars Game #00327558878: Hold'em No Limit ($10/$25 USD) - 2022/04/30 12:31:57 ET
Table 'Hold'em (Min 500Max 2500)  1282' 6-max Seat #2 is the button
Seat 1: JaspritBumrah786 ($3066.2 in chips) 
Seat 2: Miss_Jammer ($3118.51 in chips) 
Seat 3: smoker player  ($728.69 in chips) 
Seat 4: RD9627950832 ($2475 in chips) 
Seat 5: Lucifer999 ($8406.29 in chips) 
Seat 6: jas8k ($2184.17 in chips) 
smoker player : posts small blind $10
RD9627950832: posts big blind $25
*** HOLE CARDS ***
Dealt to Lucifer999 [6c Ts]
Lucifer999: folds
JaspritBumrah786: folds
Miss_Jammer: folds
smoker player : raises $25.00 to $50
RD9627950832: calls $25
*** FLOP *** [9s 6h 5s]
smoker player : bets $45
RD9627950832: raises $45.00 to $90
smoker player : calls $45
*** TURN *** [9s 6h 5s] [Ks]
smoker player : checks
RD9627950832: checks
*** RIVER *** [9s 6h 5s Ks] [2d]
smoker player : checks
RD9627950832: bets $223.01
smoker player : folds
Uncalled bet ($223.01) returned to RD9627950832
RD9627950832: doesn't show hand
RD9627950832 collected $263.3 from pot
*** SUMMARY ***
Total pot $280.00 | Rake $16.7
Board [9s 6h 5s Ks 2d]
Seat 1: JaspritBumrah786 folded before Flop (didn't bet)
Seat 2: Miss_Jammer (button) folded before Flop (didn't bet)
Seat 3: smoker player  (small blind) folded on the River
Seat 4: RD9627950832 (big blind) collected ($263.3)
Seat 5: Lucifer999 folded before Flop (didn't bet)



PokerStars Game #00327558911: Hold'em No Limit ($50/$100 USD) - 2022/04/30 12:32:06 ET
Table 'Hold'em (Min 25KMax 10K)    69' 6-max Seat #6 is the button
Seat 1: Lucifer999 ($33918.49 in chips) 
Seat 3: Mpr@59  ($14536.87 in chips) 
Seat 5: tabby20 ($31794.12 in chips) 
Seat 6: manny007 ($7792.33 in chips) 
Lucifer999: posts small blind $50
Mpr@59 : posts big blind $100
*** HOLE CARDS ***
Dealt to Lucifer999 [2c 6h]
tabby20: raises $200.00 to $300
manny007: calls $300
Lucifer999: folds
Mpr@59 : calls $200
*** FLOP *** [Ah 2s 4d]
Mpr@59 : checks
tabby20: bets $400
manny007: folds
Mpr@59 : calls $400
*** TURN *** [Ah 2s 4d] [3s]
Mpr@59 : checks
tabby20: checks
*** RIVER *** [Ah 2s 4d 3s] [6s]
Mpr@59 : checks
tabby20: bets $1200
Mpr@59 : folds
Uncalled bet ($1200) returned to tabby20
tabby20: doesn't show hand
tabby20 collected $1673 from pot
*** SUMMARY ***
Total pot $1750.00 | Rake $77
Board [Ah 2s 4d 3s 6s]
Seat 1: Lucifer999 (small blind) folded before Flop
Seat 3: Mpr@59  (big blind) folded on the River
Seat 5: tabby20 collected ($1673)
Seat 6: manny007 (button) folded on the Flop



PokerStars Game #00327558912: Hold'em No Limit ($10/$25 USD) - 2022/04/30 12:32:06 ET
Table 'Hold'em (Min 500Max 2500) 1001' 6-max Seat #1 is the button
Seat 1: shykko60 ($723.26 in chips) 
Seat 2: gangster100 ($1990.54 in chips) 
Seat 3: movetome ($2175.6 in chips) 
Seat 4: devi7 ($2341 in chips) 
Seat 5: Lucifer999 ($2993.86 in chips) 
Seat 6: spidy02 ($5011.54 in chips) 
gangster100: posts small blind $10
movetome: posts big blind $25
*** HOLE CARDS ***
Dealt to Lucifer999 [2c 4h]
devi7: folds
Lucifer999: folds
spidy02: folds
shykko60: folds
gangster100: calls $15
movetome: checks
*** FLOP *** [6s 5s 3s]
gangster100: checks
movetome: bets $50
gangster100: raises $50.00 to $100
movetome: calls $50
*** TURN *** [6s 5s 3s] [8s]
gangster100: checks
movetome: checks
*** RIVER *** [6s 5s 3s 8s] [3h]
gangster100: bets $117.44
movetome: folds
Uncalled bet ($117.44) returned to gangster100
gangster100: doesn't show hand
gangster100 collected $234.88 from pot
*** SUMMARY ***
Total pot $250.00 | Rake $15.12
Board [6s 5s 3s 8s 3h]
Seat 1: shykko60 (button) folded before Flop (didn't bet)
Seat 2: gangster100 (small blind) collected ($234.88)
Seat 3: movetome (big blind) folded on the River
Seat 4: devi7 folded before Flop (didn't bet)
Seat 5: Lucifer999 folded before Flop (didn't bet)
Seat 6: spidy02 folded before Flop (didn't bet)



PokerStars Game #00327559058: Hold'em No Limit ($25/$50 USD) - 2022/04/30 12:32:41 ET
Table 'Hold'em (Min 1K Max 5K)   216' 6-max Seat #6 is the button
Seat 1: Lucifer999 ($14843.86 in chips) 
Seat 6: Pablit0 ($1403 in chips) 
Pablit0: posts small blind $25
Lucifer999: posts big blind $50
*** HOLE CARDS ***
Dealt to Lucifer999 [7s Ks]
Pablit0: raises $100.00 to $150
Lucifer999: calls $100
*** FLOP *** [7d Js 8c]
Lucifer999: checks
Pablit0: bets $286.5
Lucifer999: calls $286.5
*** TURN *** [7d Js 8c] [6h]
Lucifer999: checks
Pablit0: bets $966.5
Lucifer999: folds
Uncalled bet ($966.5) returned to Pablit0
Pablit0: doesn't show hand
Pablit0 collected $833.72 from pot
*** SUMMARY ***
Total pot $873.00 | Rake $39.28
Board [7d Js 8c 6h]
Seat 1: Lucifer999 (big blind) folded on the Turn
Seat 6: Pablit0 (button) (small blind) collected ($833.72)



PokerStars Game #00327559142: Hold'em No Limit ($50/$100 USD) - 2022/04/30 12:33:01 ET
Table 'Hold'em (Min 25KMax 10K)    69' 6-max Seat #1 is the button
Seat 1: Lucifer999 ($33868.49 in chips) 
Seat 3: Mpr@59  ($13836.87 in chips) 
Seat 5: tabby20 ($32767.12 in chips) 
Seat 6: manny007 ($7492.33 in chips) 
Mpr@59 : posts small blind $50
tabby20: posts big blind $100
*** HOLE CARDS ***
Dealt to Lucifer999 [7d 3s]
manny007: calls $100
Lucifer999: folds
Mpr@59 : folds
tabby20: raises $300.00 to $400
manny007: calls $300
*** FLOP *** [2h 6h 9c]
tabby20: bets $650
manny007: calls $650
*** TURN *** [2h 6h 9c] [4h]
tabby20: checks
manny007: checks
*** RIVER *** [2h 6h 9c 4h] [5h]
tabby20: bets $1500
manny007: calls $1500
*** SHOW DOWN ***
tabby20: shows [Ad Jh] (Flush, J high)
manny007: doesn't show hand
tabby20 collected $4923.4 from pot
*** SUMMARY ***
Total pot $5150.00 | Rake $226.6
Board [2h 6h 9c 4h 5h]
Seat 1: Lucifer999 (button) folded before Flop (didn't bet)
Seat 3: Mpr@59  (small blind) folded before Flop
Seat 5: tabby20  (big blind) showed [Ad Jh] and won ($4923.4) with Flush, J high
Seat 6: manny007 mucked



PokerStars Game #00327559290: Hold'em No Limit ($50/$100 USD) - 2022/04/30 12:33:40 ET
Table 'Hold'em (Min 25KMax 10K)    69' 6-max Seat #5 is the button
Seat 1: Lucifer999 ($33868.49 in chips) 
Seat 5: tabby20 ($35140.52 in chips) 
Seat 6: manny007 ($4942.33 in chips) 
manny007: posts small blind $50
Lucifer999: posts big blind $100
*** HOLE CARDS ***
Dealt to Lucifer999 [2h 6s]
tabby20: raises $200.00 to $300
manny007: folds
Lucifer999: folds
Uncalled bet ($200) returned to tabby20
tabby20: doesn't show hand
tabby20 collected $250 from pot
*** SUMMARY ***
Total pot $250.00 | Rake $0
Board []
Seat 1: Lucifer999 (big blind) folded before Flop
Seat 5: tabby20 (button) collected ($250)
Seat 6: manny007 (small blind) folded before Flop



PokerStars Game #00327559196: Hold'em No Limit ($10/$25 USD) - 2022/04/30 12:33:15 ET
Table 'Hold'em (Min 500Max 2500) 1001' 6-max Seat #2 is the button
Seat 1: shykko60 ($723.26 in chips) 
Seat 2: gangster100 ($2100.42 in chips) 
Seat 3: movetome ($2050.6 in chips) 
Seat 4: devi7 ($2341 in chips) 
Seat 5: Lucifer999 ($2993.86 in chips) 
Seat 6: spidy02 ($5011.54 in chips) 
movetome: posts small blind $10
devi7: posts big blind $25
*** HOLE CARDS ***
Dealt to Lucifer999 [7d 3h]
Lucifer999: folds
spidy02: folds
shykko60: calls $25
gangster100: folds
movetome: folds
devi7: checks
*** FLOP *** [3s 5s 4s]
devi7: checks
shykko60: bets $92.64
devi7: folds
Uncalled bet ($92.64) returned to shykko60
shykko60: doesn't show hand
shykko60 collected $56.85 from pot
*** SUMMARY ***
Total pot $60.00 | Rake $3.15
Board [3s 5s 4s]
Seat 1: shykko60 collected ($56.85)
Seat 2: gangster100 (button) folded before Flop (didn't bet)
Seat 3: movetome (small blind) folded before Flop
Seat 4: devi7 (big blind) folded on the Flop
Seat 5: Lucifer999 folded before Flop (didn't bet)
Seat 6: spidy02 folded before Flop (didn't bet)



PokerStars Game #00327559115: Hold'em No Limit ($10/$25 USD) - 2022/04/30 12:32:54 ET
Table 'Hold'em (Min 500Max 2500)  1282' 6-max Seat #3 is the button
Seat 1: JaspritBumrah786 ($3066.2 in chips) 
Seat 2: Miss_Jammer ($3118.51 in chips) 
Seat 3: smoker player  ($588.69 in chips) 
Seat 4: RD9627950832 ($2598.3 in chips) 
Seat 5: Lucifer999 ($8406.29 in chips) 
Seat 6: jas8k ($2184.17 in chips) 
RD9627950832: posts small blind $10
Lucifer999: posts big blind $25
*** HOLE CARDS ***
Dealt to Lucifer999 [8h As]
jas8k: checks
JaspritBumrah786: raises $75.00 to $100
Miss_Jammer: folds
smoker player : folds
RD9627950832: folds
Lucifer999: folds
jas8k: folds
Uncalled bet ($75) returned to JaspritBumrah786
JaspritBumrah786: doesn't show hand
JaspritBumrah786 collected $95 from pot
*** SUMMARY ***
Total pot $95.00 | Rake $0
Board []
Seat 1: JaspritBumrah786 collected ($95)
Seat 2: Miss_Jammer folded before Flop (didn't bet)
Seat 3: smoker player  (button) folded before Flop (didn't bet)
Seat 4: RD9627950832 (small blind) folded before Flop
Seat 5: Lucifer999 (big blind) folded before Flop
Seat 6: jas8k folded before Flop (didn't bet)



PokerStars Game #00327559347: Hold'em No Limit ($50/$100 USD) - 2022/04/30 12:33:53 ET
Table 'Hold'em (Min 25KMax 10K)    69' 6-max Seat #6 is the button
Seat 1: Lucifer999 ($33768.49 in chips) 
Seat 5: tabby20 ($35290.52 in chips) 
Seat 6: manny007 ($4892.33 in chips) 
Lucifer999: posts small blind $50
tabby20: posts big blind $100
*** HOLE CARDS ***
Dealt to Lucifer999 [8h 2s]
manny007: folds
Lucifer999: folds
Uncalled bet ($50) returned to tabby20
tabby20: doesn't show hand
tabby20 collected $100 from pot
*** SUMMARY ***
Total pot $100.00 | Rake $0
Board []
Seat 1: Lucifer999 (small blind) folded before Flop
Seat 5: tabby20 (big blind) collected ($100)
Seat 6: manny007 (button) folded before Flop (didn't bet)



PokerStars Game #00327559410: Hold'em No Limit ($50/$100 USD) - 2022/04/30 12:34:05 ET
Table 'Hold'em (Min 25KMax 10K)    69' 6-max Seat #1 is the button
Seat 1: Lucifer999 ($33718.49 in chips) 
Seat 5: tabby20 ($35340.52 in chips) 
Seat 6: manny007 ($4892.33 in chips) 
tabby20: posts small blind $50
manny007: posts big blind $100
*** HOLE CARDS ***
Dealt to Lucifer999 [Kc 4d]
Lucifer999: folds
tabby20: folds
Uncalled bet ($50) returned to manny007
manny007: doesn't show hand
manny007 collected $100 from pot
*** SUMMARY ***
Total pot $100.00 | Rake $0
Board []
Seat 1: Lucifer999 (button) folded before Flop (didn't bet)
Seat 5: tabby20 (small blind) folded before Flop
Seat 6: manny007 (big blind) collected ($100)



PokerStars Game #00327559396: Hold'em No Limit ($10/$25 USD) - 2022/04/30 12:34:03 ET
Table 'Hold'em (Min 500Max 2500)  1282' 6-max Seat #5 is the button
Seat 1: JaspritBumrah786 ($3136.2 in chips) 
Seat 2: Miss_Jammer ($3118.51 in chips) 
Seat 3: smoker player  ($588.69 in chips) 
Seat 5: Lucifer999 ($8381.29 in chips) 
Seat 6: jas8k ($2149.17 in chips) 
JaspritBumrah786: posts small blind $10
Miss_Jammer: posts big blind $25
*** HOLE CARDS ***
Dealt to Lucifer999 [2c 5c]
smoker player : folds
Lucifer999: folds
JaspritBumrah786: folds
Uncalled bet ($15) returned to Miss_Jammer
Miss_Jammer: doesn't show hand
Miss_Jammer collected $20 from pot
*** SUMMARY ***
Total pot $20.00 | Rake $0
Board []
Seat 1: JaspritBumrah786 (small blind) folded before Flop
Seat 2: Miss_Jammer (big blind) collected ($20)
Seat 3: smoker player  folded before Flop (didn't bet)
Seat 5: Lucifer999 (button) folded before Flop (didn't bet)



PokerStars Game #00327559366: Hold'em No Limit ($10/$25 USD) - 2022/04/30 12:33:56 ET
Table 'Hold'em (Min 500Max 2500) 1001' 6-max Seat #3 is the button
Seat 1: shykko60 ($755.11 in chips) 
Seat 2: gangster100 ($2100.42 in chips) 
Seat 3: movetome ($2040.6 in chips) 
Seat 4: devi7 ($2316 in chips) 
Seat 5: Lucifer999 ($2993.86 in chips) 
Seat 6: spidy02 ($5011.54 in chips) 
devi7: posts small blind $10
Lucifer999: posts big blind $25
*** HOLE CARDS ***
Dealt to Lucifer999 [Jc Ac]
spidy02: raises $35.00 to $60
shykko60: folds
gangster100: folds
movetome: folds
devi7: folds
Lucifer999: raises $200.00 to $260
spidy02: folds
Uncalled bet ($200) returned to Lucifer999
Lucifer999: doesn't show hand
Lucifer999 collected $130 from pot
*** SUMMARY ***
Total pot $130.00 | Rake $0
Board []
Seat 1: shykko60 folded before Flop (didn't bet)
Seat 2: gangster100 folded before Flop (didn't bet)
Seat 3: movetome (button) folded before Flop (didn't bet)
Seat 4: devi7 (small blind) folded before Flop
Seat 5: Lucifer999 (big blind) collected ($130)
Seat 6: spidy02 folded before Flop



PokerStars Game #00327559276: Hold'em No Limit ($25/$50 USD) - 2022/04/30 12:33:35 ET
Table 'Hold'em (Min 1K Max 5K)   216' 6-max Seat #1 is the button
Seat 1: Lucifer999 ($14407.36 in chips) 
Seat 6: Pablit0 ($1800.22 in chips) 
Lucifer999: posts small blind $25
Pablit0: posts big blind $50
*** HOLE CARDS ***
Dealt to Lucifer999 [3s 9d]
Lucifer999: calls $25
Pablit0: checks
*** FLOP *** [4s Qh 3h]
Pablit0: checks
Lucifer999: checks
*** TURN *** [4s Qh 3h] [Qs]
Pablit0: checks
Lucifer999: bets $50
Pablit0: calls $50
*** RIVER *** [4s Qh 3h Qs] [9c]
Pablit0: checks
Lucifer999: bets $175
Pablit0: folds
Uncalled bet ($175) returned to Lucifer999
Lucifer999: doesn't show hand
Lucifer999 collected $191 from pot
*** SUMMARY ***
Total pot $200.00 | Rake $9
Board [4s Qh 3h Qs 9c]
Seat 1: Lucifer999 (button) (small blind) collected ($191)
Seat 6: Pablit0 (big blind) folded on the River



PokerStars Game #00327559511: Hold'em No Limit ($25/$50 USD) - 2022/04/30 12:34:34 ET
Table 'Hold'em (Min 1K Max 5K)   216' 6-max Seat #6 is the button
Seat 1: Lucifer999 ($14498.36 in chips) 
Seat 4: Zorzo ($5000 in chips) 
Seat 6: Pablit0 ($1700.22 in chips) 
Lucifer999: posts small blind $25
Zorzo: posts big blind $50
*** HOLE CARDS ***
Dealt to Lucifer999 [3h 5c]
Pablit0: folds
Lucifer999: raises $100.00 to $150
Zorzo: folds
Uncalled bet ($100) returned to Lucifer999
Lucifer999: doesn't show hand
Lucifer999 collected $100 from pot
*** SUMMARY ***
Total pot $100.00 | Rake $0
Board []
Seat 1: Lucifer999 (small blind) collected ($100)
Seat 4: Zorzo (big blind) folded before Flop
Seat 6: Pablit0 (button) folded before Flop (didn't bet)



PokerStars Game #00327559509: Hold'em No Limit ($10/$25 USD) - 2022/04/30 12:34:33 ET
Table 'Hold'em (Min 500Max 2500) 1001' 6-max Seat #4 is the button
Seat 1: shykko60 ($755.11 in chips) 
Seat 2: gangster100 ($2100.42 in chips) 
Seat 3: movetome ($2040.6 in chips) 
Seat 4: devi7 ($2306 in chips) 
Seat 5: Lucifer999 ($3063.86 in chips) 
Seat 6: spidy02 ($4951.54 in chips) 
Lucifer999: posts small blind $10
spidy02: posts big blind $25
*** HOLE CARDS ***
Dealt to Lucifer999 [2h Ac]
shykko60: calls $25
gangster100: folds
movetome: folds
devi7: raises $85.00 to $110
Lucifer999: folds
spidy02: folds
shykko60: folds
Uncalled bet ($85) returned to devi7
devi7: doesn't show hand
devi7 collected $85 from pot
*** SUMMARY ***
Total pot $85.00 | Rake $0
Board []
Seat 1: shykko60 folded before Flop
Seat 2: gangster100 folded before Flop (didn't bet)
Seat 3: movetome folded before Flop (didn't bet)
Seat 4: devi7 (button) collected ($85)
Seat 5: Lucifer999 (small blind) folded before Flop
Seat 6: spidy02 (big blind) folded before Flop



PokerStars Game #00327559570: Hold'em No Limit ($25/$50 USD) - 2022/04/30 12:34:49 ET
Table 'Hold'em (Min 1K Max 5K)   216' 6-max Seat #1 is the button
Seat 1: Lucifer999 ($14548.36 in chips) 
Seat 4: Zorzo ($5000 in chips) 
Seat 6: Pablit0 ($1700.22 in chips) 
Zorzo: posts small blind $25
Pablit0: posts big blind $50
*** HOLE CARDS ***
Dealt to Lucifer999 [Th 7s]
Lucifer999: folds
Zorzo: folds
Uncalled bet ($25) returned to Pablit0
Pablit0: doesn't show hand
Pablit0 collected $50 from pot
*** SUMMARY ***
Total pot $50.00 | Rake $0
Board []
Seat 1: Lucifer999 (button) folded before Flop (didn't bet)
Seat 4: Zorzo (small blind) folded before Flop
Seat 6: Pablit0 (big blind) collected ($50)



PokerStars Game #00327559483: Hold'em No Limit ($50/$100 USD) - 2022/04/30 12:34:26 ET
Table 'Hold'em (Min 25KMax 10K)    69' 6-max Seat #5 is the button
Seat 1: Lucifer999 ($33718.49 in chips) 
Seat 5: tabby20 ($35290.52 in chips) 
Seat 6: manny007 ($4942.33 in chips) 
manny007: posts small blind $50
Lucifer999: posts big blind $100
*** HOLE CARDS ***
Dealt to Lucifer999 [2h Ah]
tabby20: raises $200.00 to $300
manny007: folds
Lucifer999: raises $1000.00 to $1300
tabby20: calls $1000
*** FLOP *** [4c 5c Qh]
Lucifer999: bets $1800
tabby20: calls $1800
*** TURN *** [4c 5c Qh] [8s]
Lucifer999: bets $5600
tabby20: folds
Uncalled bet ($5600) returned to Lucifer999
Lucifer999: doesn't show hand
Lucifer999 collected $5975 from pot
*** SUMMARY ***
Total pot $6250.00 | Rake $275
Board [4c 5c Qh 8s]
Seat 1: Lucifer999 (big blind) collected ($5975)
Seat 5: tabby20 (button) folded on the Turn
Seat 6: manny007 (small blind) folded before Flop



PokerStars Game #00327559505: Hold'em No Limit ($10/$25 USD) - 2022/04/30 12:34:32 ET
Table 'Hold'em (Min 500Max 2500)  1282' 6-max Seat #1 is the button
Seat 1: JaspritBumrah786 ($3126.2 in chips) 
Seat 2: Miss_Jammer ($3128.51 in chips) 
Seat 3: smoker player  ($588.69 in chips) 
Seat 5: Lucifer999 ($8381.29 in chips) 
Seat 6: jas8k ($2149.17 in chips) 
Miss_Jammer: posts small blind $10
smoker player : posts big blind $25
*** HOLE CARDS ***
Dealt to Lucifer999 [Jd 9c]
Lucifer999: folds
JaspritBumrah786: raises $50.00 to $75
Miss_Jammer: folds
smoker player : calls $50
*** FLOP *** [Kd 3d 5c]
smoker player : checks
JaspritBumrah786: bets $125
smoker player : folds
Uncalled bet ($125) returned to JaspritBumrah786
JaspritBumrah786: doesn't show hand
JaspritBumrah786 collected $150.6 from pot
*** SUMMARY ***
Total pot $160.00 | Rake $9.4
Board [Kd 3d 5c]
Seat 1: JaspritBumrah786 (button) collected ($150.6)
Seat 2: Miss_Jammer (small blind) folded before Flop
Seat 3: smoker player  (big blind) folded on the Flop
Seat 5: Lucifer999 folded before Flop (didn't bet)



PokerStars Game #00327559671: Hold'em No Limit ($50/$100 USD) - 2022/04/30 12:35:11 ET
Table 'Hold'em (Min 25KMax 10K)    69' 6-max Seat #6 is the button
Seat 1: Lucifer999 ($36593.49 in chips) 
Seat 2: RanveerAJ ($2500 in chips) 
Seat 5: tabby20 ($32190.52 in chips) 
Seat 6: manny007 ($4892.33 in chips) 
Lucifer999: posts small blind $50
RanveerAJ: posts big blind $100
*** HOLE CARDS ***
Dealt to Lucifer999 [8s 5c]
tabby20: folds
manny007: folds
Lucifer999: folds
Uncalled bet ($50) returned to RanveerAJ
RanveerAJ: doesn't show hand
RanveerAJ collected $100 from pot
*** SUMMARY ***
Total pot $100.00 | Rake $0
Board []
Seat 1: Lucifer999 (small blind) folded before Flop
Seat 2: RanveerAJ (big blind) collected ($100)
Seat 5: tabby20 folded before Flop (didn't bet)
Seat 6: manny007 (button) folded before Flop (didn't bet)



PokerStars Game #00327559663: Hold'em No Limit ($25/$50 USD) - 2022/04/30 12:35:10 ET
Table 'Hold'em (Min 1K Max 5K)   216' 6-max Seat #4 is the button
Seat 1: Lucifer999 ($14548.36 in chips) 
Seat 4: Zorzo ($5000 in chips) 
Seat 6: Pablit0 ($1725.22 in chips) 
Pablit0: posts small blind $25
Lucifer999: posts big blind $50
*** HOLE CARDS ***
Dealt to Lucifer999 [8c 2s]
Zorzo: raises $4950.00 to $5000
Pablit0: folds
Lucifer999: folds
Uncalled bet ($4950) returned to Zorzo
Zorzo: doesn't show hand
Zorzo collected $125 from pot
*** SUMMARY ***
Total pot $125.00 | Rake $0
Board []
Seat 1: Lucifer999 (big blind) folded before Flop
Seat 4: Zorzo (button) collected ($125)
Seat 6: Pablit0 (small blind) folded before Flop



PokerStars Game #00327559694: Hold'em No Limit ($10/$25 USD) - 2022/04/30 12:35:18 ET
Table 'Hold'em (Min 500Max 2500)  1282' 6-max Seat #2 is the button
Seat 1: JaspritBumrah786 ($3201.8 in chips) 
Seat 2: Miss_Jammer ($3118.51 in chips) 
Seat 3: smoker player  ($513.69 in chips) 
Seat 4: Saniooooo ($960 in chips) 
Seat 5: Lucifer999 ($8381.29 in chips) 
Seat 6: jas8k ($2149.17 in chips) 
smoker player : posts small blind $10
Saniooooo: posts big blind $25
*** HOLE CARDS ***
Dealt to Lucifer999 [9d 8h]
Lucifer999: folds
JaspritBumrah786: folds
Miss_Jammer: folds
smoker player : raises $25.00 to $50
Saniooooo: calls $25
*** FLOP *** [Qs Th 6c]
smoker player : bets $25
Saniooooo: calls $25
*** TURN *** [Qs Th 6c] [Ac]
smoker player : bets $87.84
Saniooooo: calls $87.84
*** RIVER *** [Qs Th 6c Ac] [6h]
smoker player : bets $350.85
Saniooooo: calls $350.85
*** SHOW DOWN ***
smoker player : shows [6s 9s] (Three of a kind, 666)
Saniooooo: shows [2s As] (Two pairs, AA66)
smoker player  collected $968.47 from pot
*** SUMMARY ***
Total pot $1027.38 | Rake $58.91
Board [Qs Th 6c Ac 6h]
Seat 1: JaspritBumrah786 folded before Flop (didn't bet)
Seat 2: Miss_Jammer (button) folded before Flop (didn't bet)
Seat 3: smoker player   (small blind) showed [6s 9s] and won ($968.47) with Three of a kind, 666
Seat 4: Saniooooo (big blind) showed [2s As] and lost with Two pairs, AA66
Seat 5: Lucifer999 folded before Flop (didn't bet)



PokerStars Game #00327559767: Hold'em No Limit ($50/$100 USD) - 2022/04/30 12:35:35 ET
Table 'Hold'em (Min 25KMax 10K)    69' 6-max Seat #1 is the button
Seat 1: Lucifer999 ($36543.49 in chips) 
Seat 2: RanveerAJ ($2550 in chips) 
Seat 5: tabby20 ($32190.52 in chips) 
Seat 6: manny007 ($4892.33 in chips) 
RanveerAJ: posts small blind $50
tabby20: posts big blind $100
*** HOLE CARDS ***
Dealt to Lucifer999 [Ks 6h]
manny007: folds
Lucifer999: folds
RanveerAJ: raises $150.00 to $250
tabby20: calls $150
*** FLOP *** [Jd 7c Jh]
RanveerAJ: bets $189
tabby20: folds
Uncalled bet ($189) returned to RanveerAJ
RanveerAJ: doesn't show hand
RanveerAJ collected $478 from pot
*** SUMMARY ***
Total pot $500.00 | Rake $22
Board [Jd 7c Jh]
Seat 1: Lucifer999 (button) folded before Flop (didn't bet)
Seat 2: RanveerAJ (small blind) collected ($478)
Seat 5: tabby20 (big blind) folded on the Flop
Seat 6: manny007 folded before Flop (didn't bet)



PokerStars Game #00327559631: Hold'em No Limit ($10/$25 USD) - 2022/04/30 12:35:04 ET
Table 'Hold'em (Min 500Max 2500) 1001' 6-max Seat #5 is the button
Seat 1: shykko60 ($730.11 in chips) 
Seat 2: gangster100 ($2100.42 in chips) 
Seat 3: movetome ($2040.6 in chips) 
Seat 4: devi7 ($2366 in chips) 
Seat 5: Lucifer999 ($3053.86 in chips) 
Seat 6: spidy02 ($4926.54 in chips) 
spidy02: posts small blind $10
shykko60: posts big blind $25
*** HOLE CARDS ***
Dealt to Lucifer999 [7c Tc]
gangster100: folds
movetome: folds
devi7: folds
Lucifer999: raises $55.00 to $80
spidy02: folds
shykko60: calls $55
*** FLOP *** [Jd 3h 9h]
shykko60: checks
Lucifer999: bets $100
shykko60: folds
Uncalled bet ($100) returned to Lucifer999
Lucifer999: doesn't show hand
Lucifer999 collected $160.08 from pot
*** SUMMARY ***
Total pot $170.00 | Rake $9.92
Board [Jd 3h 9h]
Seat 1: shykko60 (big blind) folded on the Flop
Seat 2: gangster100 folded before Flop (didn't bet)
Seat 3: movetome folded before Flop (didn't bet)
Seat 4: devi7 folded before Flop (didn't bet)
Seat 5: Lucifer999 (button) collected ($160.08)
Seat 6: spidy02 (small blind) folded before Flop



PokerStars Game #00327559847: Hold'em No Limit ($25/$50 USD) - 2022/04/30 12:35:57 ET
Table 'Hold'em (Min 1K Max 5K)   216' 6-max Seat #6 is the button
Seat 1: Lucifer999 ($14498.36 in chips) 
Seat 4: Zorzo ($5075 in chips) 
Seat 6: Pablit0 ($1700.22 in chips) 
Lucifer999: posts small blind $25
Zorzo: posts big blind $50
*** HOLE CARDS ***
Dealt to Lucifer999 [Th 7c]
Pablit0: raises $75.00 to $125
Lucifer999: folds
Zorzo: folds
Uncalled bet ($75) returned to Pablit0
Pablit0: doesn't show hand
Pablit0 collected $125 from pot
*** SUMMARY ***
Total pot $125.00 | Rake $0
Board []
Seat 1: Lucifer999 (small blind) folded before Flop
Seat 4: Zorzo (big blind) folded before Flop
Seat 6: Pablit0 (button) collected ($125)



PokerStars Game #00327559892: Hold'em No Limit ($50/$100 USD) - 2022/04/30 12:36:10 ET
Table 'Hold'em (Min 25KMax 10K)    69' 6-max Seat #2 is the button
Seat 1: Lucifer999 ($36543.49 in chips) 
Seat 2: RanveerAJ ($2778 in chips) 
Seat 5: tabby20 ($31940.52 in chips) 
Seat 6: manny007 ($4892.33 in chips) 
tabby20: posts small blind $50
manny007: posts big blind $100
*** HOLE CARDS ***
Dealt to Lucifer999 [8s 9d]
Lucifer999: folds
RanveerAJ: folds
tabby20: folds
Uncalled bet ($50) returned to manny007
manny007: doesn't show hand
manny007 collected $100 from pot
*** SUMMARY ***
Total pot $100.00 | Rake $0
Board []
Seat 1: Lucifer999 folded before Flop (didn't bet)
Seat 2: RanveerAJ (button) folded before Flop (didn't bet)
Seat 5: tabby20 (small blind) folded before Flop
Seat 6: manny007 (big blind) collected ($100)



PokerStars Game #00327559908: Hold'em No Limit ($10/$25 USD) - 2022/04/30 12:36:15 ET
Table 'Hold'em (Min 500Max 2500) 1001' 6-max Seat #6 is the button
Seat 1: shykko60 ($650.11 in chips) 
Seat 2: gangster100 ($2100.42 in chips) 
Seat 3: movetome ($2040.6 in chips) 
Seat 4: devi7 ($2366 in chips) 
Seat 5: Lucifer999 ($3133.94 in chips) 
Seat 6: spidy02 ($4916.54 in chips) 
shykko60: posts small blind $10
movetome: posts big blind $25
*** HOLE CARDS ***
Dealt to Lucifer999 [Jd Qc]
devi7: folds
Lucifer999: raises $55.00 to $80
spidy02: raises $126.25 to $206.25
shykko60: folds
movetome: folds
Lucifer999: folds
Uncalled bet ($126.25) returned to spidy02
spidy02: doesn't show hand
spidy02 collected $195 from pot
*** SUMMARY ***
Total pot $195.00 | Rake $0
Board []
Seat 1: shykko60 (small blind) folded before Flop
Seat 3: movetome (big blind) folded before Flop
Seat 4: devi7 folded before Flop (didn't bet)
Seat 5: Lucifer999 folded before Flop
Seat 6: spidy02 (button) collected ($195)



PokerStars Game #00327559862: Hold'em No Limit ($10/$25 USD) - 2022/04/30 12:36:03 ET
Table 'Hold'em (Min 500Max 2500)  1282' 6-max Seat #3 is the button
Seat 1: JaspritBumrah786 ($3201.8 in chips) 
Seat 2: Miss_Jammer ($3118.51 in chips) 
Seat 3: smoker player  ($968.47 in chips) 
Seat 4: Saniooooo ($446.31 in chips) 
Seat 5: Lucifer999 ($8381.29 in chips) 
Seat 6: jas8k ($2149.17 in chips) 
Saniooooo: posts small blind $10
Lucifer999: posts big blind $25
*** HOLE CARDS ***
Dealt to Lucifer999 [Jd 6d]
JaspritBumrah786: raises $50.00 to $75
Miss_Jammer: folds
smoker player : calls $75
Saniooooo: folds
Lucifer999: folds
*** FLOP *** [7d Qs Js]
JaspritBumrah786: checks
smoker player : checks
*** TURN *** [7d Qs Js] [Td]
JaspritBumrah786: checks
smoker player : checks
*** RIVER *** [7d Qs Js Td] [Kc]
JaspritBumrah786: checks
smoker player : checks
*** SHOW DOWN ***
JaspritBumrah786: shows [8c 8s] (Pair, 88)
smoker player : shows [9d 9s] (Straight, K-9)
smoker player  collected $174.29 from pot
*** SUMMARY ***
Total pot $185.00 | Rake $10.71
Board [7d Qs Js Td Kc]
Seat 1: JaspritBumrah786 showed [8c 8s] and lost with Pair, 88
Seat 2: Miss_Jammer folded before Flop (didn't bet)
Seat 3: smoker player   (button) showed [9d 9s] and won ($174.29) with Straight, K-9
Seat 4: Saniooooo (small blind) folded before Flop
Seat 5: Lucifer999 (big blind) folded before Flop



PokerStars Game #00327559974: Hold'em No Limit ($50/$100 USD) - 2022/04/30 12:36:31 ET
Table 'Hold'em (Min 25KMax 10K)    69' 6-max Seat #5 is the button
Seat 1: Lucifer999 ($36543.49 in chips) 
Seat 2: RanveerAJ ($2778 in chips) 
Seat 5: tabby20 ($31890.52 in chips) 
Seat 6: manny007 ($4942.33 in chips) 
manny007: posts small blind $50
Lucifer999: posts big blind $100
*** HOLE CARDS ***
Dealt to Lucifer999 [Jc Qh]
RanveerAJ: folds
tabby20: raises $200.00 to $300
manny007: folds
Lucifer999: calls $200
*** FLOP *** [Jd 9c 9d]
Lucifer999: checks
tabby20: checks
*** TURN *** [Jd 9c 9d] [4d]
Lucifer999: bets $450
tabby20: folds
Uncalled bet ($450) returned to Lucifer999
Lucifer999: doesn't show hand
Lucifer999 collected $621.4 from pot
*** SUMMARY ***
Total pot $650.00 | Rake $28.6
Board [Jd 9c 9d 4d]
Seat 1: Lucifer999 (big blind) collected ($621.4)
Seat 2: RanveerAJ folded before Flop (didn't bet)
Seat 5: tabby20 (button) folded on the Turn
Seat 6: manny007 (small blind) folded before Flop



PokerStars Game #00327559939: Hold'em No Limit ($25/$50 USD) - 2022/04/30 12:36:22 ET
Table 'Hold'em (Min 1K Max 5K)   216' 6-max Seat #1 is the button
Seat 1: Lucifer999 ($14473.36 in chips) 
Seat 4: Zorzo ($5025 in chips) 
Seat 6: Pablit0 ($1775.22 in chips) 
Zorzo: posts small blind $25
Pablit0: posts big blind $50
*** HOLE CARDS ***
Dealt to Lucifer999 [6c 7c]
Lucifer999: folds
Zorzo: raises $100.00 to $150
Pablit0: calls $100
*** FLOP *** [Jc 3d 6s]
Zorzo: bets $142.5
Pablit0: calls $142.5
*** TURN *** [Jc 3d 6s] [Qc]
Zorzo: bets $350
Pablit0: folds
Uncalled bet ($350) returned to Zorzo
Zorzo: doesn't show hand
Zorzo collected $555.75 from pot
*** SUMMARY ***
Total pot $585.00 | Rake $29.25
Board [Jc 3d 6s Qc]
Seat 1: Lucifer999 (button) folded before Flop (didn't bet)
Seat 4: Zorzo (small blind) collected ($555.75)
Seat 6: Pablit0 (big blind) folded on the Turn



PokerStars Game #00327560047: Hold'em No Limit ($10/$25 USD) - 2022/04/30 12:36:51 ET
Table 'Hold'em (Min 500Max 2500) 1001' 6-max Seat #1 is the button
Seat 1: shykko60 ($640.11 in chips) 
Seat 2: gangster100 ($2100.42 in chips) 
Seat 3: movetome ($2015.6 in chips) 
Seat 4: devi7 ($2366 in chips) 
Seat 5: Lucifer999 ($3053.94 in chips) 
Seat 6: spidy02 ($5031.54 in chips) 
movetome: posts small blind $10
devi7: posts big blind $25
*** HOLE CARDS ***
Dealt to Lucifer999 [Js 9d]
Lucifer999: folds
spidy02: raises $38.75 to $63.75
shykko60: folds
movetome: folds
devi7: folds
Uncalled bet ($38.75) returned to spidy02
spidy02: doesn't show hand
spidy02 collected $60 from pot
*** SUMMARY ***
Total pot $60.00 | Rake $0
Board []
Seat 1: shykko60 (button) folded before Flop (didn't bet)
Seat 3: movetome (small blind) folded before Flop
Seat 4: devi7 (big blind) folded before Flop
Seat 5: Lucifer999 folded before Flop (didn't bet)
Seat 6: spidy02 collected ($60)



PokerStars Game #00327560116: Hold'em No Limit ($50/$100 USD) - 2022/04/30 12:37:07 ET
Table 'Hold'em (Min 25KMax 10K)    69' 6-max Seat #6 is the button
Seat 1: Lucifer999 ($36864.89 in chips) 
Seat 2: RanveerAJ ($2778 in chips) 
Seat 5: tabby20 ($31590.52 in chips) 
Seat 6: manny007 ($4892.33 in chips) 
Lucifer999: posts small blind $50
RanveerAJ: posts big blind $100
*** HOLE CARDS ***
Dealt to Lucifer999 [6c 2d]
tabby20: folds
manny007: calls $100
Lucifer999: folds
RanveerAJ: checks
*** FLOP *** [8c Jc 5h]
RanveerAJ: checks
manny007: bets $239
RanveerAJ: folds
Uncalled bet ($239) returned to manny007
manny007: doesn't show hand
manny007 collected $239 from pot
*** SUMMARY ***
Total pot $250.00 | Rake $11
Board [8c Jc 5h]
Seat 1: Lucifer999 (small blind) folded before Flop
Seat 2: RanveerAJ (big blind) folded on the Flop
Seat 5: tabby20 folded before Flop (didn't bet)
Seat 6: manny007 (button) collected ($239)



PokerStars Game #00327560141: Hold'em No Limit ($25/$50 USD) - 2022/04/30 12:37:14 ET
Table 'Hold'em (Min 1K Max 5K)   216' 6-max Seat #4 is the button
Seat 1: Lucifer999 ($14473.36 in chips) 
Seat 4: Zorzo ($5288.25 in chips) 
Seat 6: Pablit0 ($1482.72 in chips) 
Pablit0: posts small blind $25
Lucifer999: posts big blind $50
*** HOLE CARDS ***
Dealt to Lucifer999 [Ac 3c]
Zorzo: folds
Pablit0: calls $25
Lucifer999: raises $125.00 to $175
Pablit0: raises $1307.72 to $1482.72
Lucifer999: folds
Uncalled bet ($1307.72) returned to Pablit0
Pablit0: doesn't show hand
Pablit0 collected $350 from pot
*** SUMMARY ***
Total pot $350.00 | Rake $0
Board []
Seat 1: Lucifer999 (big blind) folded before Flop
Seat 4: Zorzo (button) folded before Flop (didn't bet)
Seat 6: Pablit0 (small blind) collected ($350)



PokerStars Game #00327560095: Hold'em No Limit ($10/$25 USD) - 2022/04/30 12:37:02 ET
Table 'Hold'em (Min 500Max 2500)  1282' 6-max Seat #4 is the button
Seat 1: JaspritBumrah786 ($3126.8 in chips) 
Seat 2: Miss_Jammer ($3118.51 in chips) 
Seat 3: smoker player  ($1067.76 in chips) 
Seat 4: Saniooooo ($436.31 in chips) 
Seat 5: Lucifer999 ($8356.29 in chips) 
Seat 6: jas8k ($2149.17 in chips) 
Lucifer999: posts small blind $10
JaspritBumrah786: posts big blind $25
*** HOLE CARDS ***
Dealt to Lucifer999 [7d As]
Miss_Jammer: folds
smoker player : calls $25
Saniooooo: folds
Lucifer999: folds
JaspritBumrah786: checks
*** FLOP *** [7c 4d Td]
JaspritBumrah786: checks
smoker player : bets $25
JaspritBumrah786: calls $25
*** TURN *** [7c 4d Td] [5h]
JaspritBumrah786: checks
smoker player : checks
*** RIVER *** [7c 4d Td 5h] [3s]
JaspritBumrah786: checks
smoker player : bets $45
JaspritBumrah786: calls $45
*** SHOW DOWN ***
smoker player : shows [7h 8c] (Pair, 77)
JaspritBumrah786: shows [5d 4h] (Two pairs, 5544)
JaspritBumrah786 collected $187.5 from pot
*** SUMMARY ***
Total pot $200.00 | Rake $12.5
Board [7c 4d Td 5h 3s]
Seat 1: JaspritBumrah786  (big blind) showed [5d 4h] and won ($187.5) with Two pairs, 5544
Seat 2: Miss_Jammer folded before Flop (didn't bet)
Seat 3: smoker player  showed [7h 8c] and lost with Pair, 77
Seat 4: Saniooooo (button) folded before Flop (didn't bet)
Seat 5: Lucifer999 (small blind) folded before Flop



PokerStars Game #00327560155: Hold'em No Limit ($10/$25 USD) - 2022/04/30 12:37:17 ET
Table 'Hold'em (Min 500Max 2500) 1001' 6-max Seat #3 is the button
Seat 1: shykko60 ($640.11 in chips) 
Seat 2: gangster100 ($2100.42 in chips) 
Seat 3: movetome ($2005.6 in chips) 
Seat 4: devi7 ($2341 in chips) 
Seat 5: Lucifer999 ($3053.94 in chips) 
Seat 6: spidy02 ($5066.54 in chips) 
devi7: posts small blind $10
Lucifer999: posts big blind $25
*** HOLE CARDS ***
Dealt to Lucifer999 [2h 8s]
spidy02: folds
shykko60: calls $25
movetome: folds
devi7: folds
Lucifer999: checks
*** FLOP *** [9h Td 3s]
Lucifer999: checks
shykko60: bets $35
Lucifer999: folds
Uncalled bet ($35) returned to shykko60
shykko60: doesn't show hand
shykko60 collected $56.85 from pot
*** SUMMARY ***
Total pot $60.00 | Rake $3.15
Board [9h Td 3s]
Seat 1: shykko60 collected ($56.85)
Seat 3: movetome (button) folded before Flop (didn't bet)
Seat 4: devi7 (small blind) folded before Flop
Seat 5: Lucifer999 (big blind) folded on the Flop
Seat 6: spidy02 folded before Flop (didn't bet)



PokerStars Game #00327560264: Hold'em No Limit ($25/$50 USD) - 2022/04/30 12:37:48 ET
Table 'Hold'em (Min 1K Max 5K)   216' 6-max Seat #6 is the button
Seat 1: Lucifer999 ($14298.36 in chips) 
Seat 4: Zorzo ($5288.25 in chips) 
Seat 6: Pablit0 ($1657.72 in chips) 
Lucifer999: posts small blind $25
Zorzo: posts big blind $50
*** HOLE CARDS ***
Dealt to Lucifer999 [Kd 4c]
Pablit0: raises $75.00 to $125
Lucifer999: folds
Zorzo: folds
Uncalled bet ($75) returned to Pablit0
Pablit0: doesn't show hand
Pablit0 collected $125 from pot
*** SUMMARY ***
Total pot $125.00 | Rake $0
Board []
Seat 1: Lucifer999 (small blind) folded before Flop
Seat 4: Zorzo (big blind) folded before Flop
Seat 6: Pablit0 (button) collected ($125)



PokerStars Game #00327560284: Hold'em No Limit ($10/$25 USD) - 2022/04/30 12:37:51 ET
Table 'Hold'em (Min 500Max 2500)  1282' 6-max Seat #5 is the button
Seat 1: JaspritBumrah786 ($3219.3 in chips) 
Seat 2: Miss_Jammer ($3118.51 in chips) 
Seat 3: smoker player  ($972.76 in chips) 
Seat 4: Saniooooo ($436.31 in chips) 
Seat 5: Lucifer999 ($8346.29 in chips) 
Seat 6: jas8k ($2149.17 in chips) 
JaspritBumrah786: posts small blind $10
Miss_Jammer: posts big blind $25
*** HOLE CARDS ***
Dealt to Lucifer999 [3d 2h]
smoker player : folds
Saniooooo: folds
Lucifer999: folds
JaspritBumrah786: raises $50.00 to $75
Miss_Jammer: folds
Uncalled bet ($50) returned to JaspritBumrah786
JaspritBumrah786: doesn't show hand
JaspritBumrah786 collected $50 from pot
*** SUMMARY ***
Total pot $50.00 | Rake $0
Board []
Seat 1: JaspritBumrah786 (small blind) collected ($50)
Seat 2: Miss_Jammer (big blind) folded before Flop
Seat 3: smoker player  folded before Flop (didn't bet)
Seat 4: Saniooooo folded before Flop (didn't bet)
Seat 5: Lucifer999 (button) folded before Flop (didn't bet)



PokerStars Game #00327560236: Hold'em No Limit ($50/$100 USD) - 2022/04/30 12:37:40 ET
Table 'Hold'em (Min 25KMax 10K)    69' 6-max Seat #1 is the button
Seat 1: Lucifer999 ($36814.89 in chips) 
Seat 2: RanveerAJ ($2678 in chips) 
Seat 5: tabby20 ($31590.52 in chips) 
Seat 6: manny007 ($5031.33 in chips) 
RanveerAJ: posts small blind $50
tabby20: posts big blind $100
*** HOLE CARDS ***
Dealt to Lucifer999 [5h Ad]
manny007: calls $100
Lucifer999: folds
RanveerAJ: calls $50
tabby20: checks
*** FLOP *** [Qh 5c 4d]
RanveerAJ: checks
tabby20: checks
manny007: bets $286.8
RanveerAJ: calls $286.8
tabby20: calls $286.8
*** TURN *** [Qh 5c 4d] [5s]
RanveerAJ: checks
tabby20: checks
manny007: checks
*** RIVER *** [Qh 5c 4d 5s] [2c]
RanveerAJ: checks
tabby20: checks
manny007: checks
*** SHOW DOWN ***
manny007: shows [3s 4s] (Two pairs, 5544)
RanveerAJ: doesn't show hand
tabby20: doesn't show hand
manny007 collected $1109.36 from pot
*** SUMMARY ***
Total pot $1160.40 | Rake $51.04
Board [Qh 5c 4d 5s 2c]
Seat 1: Lucifer999 (button) folded before Flop (didn't bet)
Seat 2: RanveerAJ (small blind) mucked
Seat 5: tabby20 (big blind) mucked
Seat 6: manny007  showed [3s 4s] and won ($1109.36) with Two pairs, 5544



PokerStars Game #00327560315: Hold'em No Limit ($10/$25 USD) - 2022/04/30 12:38:00 ET
Table 'Hold'em (Min 500Max 2500) 1001' 6-max Seat #4 is the button
Seat 1: shykko60 ($671.96 in chips) 
Seat 2: gangster100 ($2100.42 in chips) 
Seat 3: movetome ($2005.6 in chips) 
Seat 4: devi7 ($2331 in chips) 
Seat 5: Lucifer999 ($3028.94 in chips) 
Seat 6: spidy02 ($5066.54 in chips) 
Lucifer999: posts small blind $10
spidy02: posts big blind $25
*** HOLE CARDS ***
Dealt to Lucifer999 [4h 7c]
shykko60: folds
movetome: folds
devi7: raises $50.00 to $75
Lucifer999: folds
spidy02: calls $50
*** FLOP *** [Jd 8h Th]
spidy02: checks
devi7: bets $99.4
spidy02: folds
Uncalled bet ($99.4) returned to devi7
devi7: doesn't show hand
devi7 collected $150.6 from pot
*** SUMMARY ***
Total pot $160.00 | Rake $9.4
Board [Jd 8h Th]
Seat 1: shykko60 folded before Flop (didn't bet)
Seat 3: movetome folded before Flop (didn't bet)
Seat 4: devi7 (button) collected ($150.6)
Seat 5: Lucifer999 (small blind) folded before Flop
Seat 6: spidy02 (big blind) folded on the Flop



PokerStars Game #00327560353: Hold'em No Limit ($25/$50 USD) - 2022/04/30 12:38:11 ET
Table 'Hold'em (Min 1K Max 5K)   216' 6-max Seat #1 is the button
Seat 1: Lucifer999 ($14273.36 in chips) 
Seat 2: johnriley ($1000 in chips) 
Seat 4: Zorzo ($5238.25 in chips) 
Seat 6: Pablit0 ($1732.72 in chips) 
Zorzo: posts small blind $25
Pablit0: posts big blind $50
*** HOLE CARDS ***
Dealt to Lucifer999 [As 8c]
Lucifer999: raises $100.00 to $150
Zorzo: folds
Pablit0: calls $100
*** FLOP *** [6d Ks 3s]
Pablit0: checks
Lucifer999: bets $200
Pablit0: folds
Uncalled bet ($200) returned to Lucifer999
Lucifer999: doesn't show hand
Lucifer999 collected $308.75 from pot
*** SUMMARY ***
Total pot $325.00 | Rake $16.25
Board [6d Ks 3s]
Seat 1: Lucifer999 (button) collected ($308.75)
Seat 4: Zorzo (small blind) folded before Flop
Seat 6: Pablit0 (big blind) folded on the Flop



PokerStars Game #00327560438: Hold'em No Limit ($10/$25 USD) - 2022/04/30 12:38:37 ET
Table 'Hold'em (Min 500Max 2500) 1001' 6-max Seat #5 is the button
Seat 1: shykko60 ($671.96 in chips) 
Seat 2: gangster100 ($2100.42 in chips) 
Seat 3: movetome ($2005.6 in chips) 
Seat 4: devi7 ($2406.6 in chips) 
Seat 5: Lucifer999 ($3018.94 in chips) 
Seat 6: spidy02 ($4991.54 in chips) 
spidy02: posts small blind $10
shykko60: posts big blind $25
*** HOLE CARDS ***
Dealt to Lucifer999 [8s 6d]
movetome: folds
devi7: folds
Lucifer999: folds
spidy02: folds
Uncalled bet ($15) returned to shykko60
shykko60: doesn't show hand
shykko60 collected $20 from pot
*** SUMMARY ***
Total pot $20.00 | Rake $0
Board []
Seat 1: shykko60 (big blind) collected ($20)
Seat 3: movetome folded before Flop (didn't bet)
Seat 4: devi7 folded before Flop (didn't bet)
Seat 5: Lucifer999 (button) folded before Flop (didn't bet)
Seat 6: spidy02 (small blind) folded before Flop



PokerStars Game #00327560434: Hold'em No Limit ($50/$100 USD) - 2022/04/30 12:38:35 ET
Table 'Hold'em (Min 25KMax 10K)    69' 6-max Seat #2 is the button
Seat 1: Lucifer999 ($36814.89 in chips) 
Seat 2: RanveerAJ ($2291.2 in chips) 
Seat 5: tabby20 ($31203.72 in chips) 
Seat 6: manny007 ($5753.89 in chips) 
tabby20: posts small blind $50
manny007: posts big blind $100
*** HOLE CARDS ***
Dealt to Lucifer999 [Ad 5s]
Lucifer999: folds
RanveerAJ: calls $100
tabby20: calls $50
manny007: raises $300.00 to $400
RanveerAJ: calls $300
tabby20: folds
*** FLOP *** [2d 6c Qs]
manny007: bets $860.4
RanveerAJ: folds
Uncalled bet ($860.4) returned to manny007
manny007: doesn't show hand
manny007 collected $860.4 from pot
*** SUMMARY ***
Total pot $900.00 | Rake $39.6
Board [2d 6c Qs]
Seat 1: Lucifer999 folded before Flop (didn't bet)
Seat 2: RanveerAJ (button) folded on the Flop
Seat 5: tabby20 (small blind) folded before Flop
Seat 6: manny007 (big blind) collected ($860.4)



PokerStars Game #00327560414: Hold'em No Limit ($10/$25 USD) - 2022/04/30 12:38:29 ET
Table 'Hold'em (Min 500Max 2500)  1282' 6-max Seat #2 is the button
Seat 1: JaspritBumrah786 ($5744.3 in chips) 
Seat 2: Miss_Jammer ($3093.51 in chips) 
Seat 3: smoker player  ($972.76 in chips) 
Seat 4: Saniooooo ($436.31 in chips) 
Seat 5: Lucifer999 ($8346.29 in chips) 
Seat 6: jas8k ($2149.17 in chips) 
smoker player : posts small blind $10
Saniooooo: posts big blind $25
jas8k: posts small blind $10
*** HOLE CARDS ***
Dealt to Lucifer999 [5s Qs]
Lucifer999: folds
jas8k: folds
Miss_Jammer: raises $50.00 to $75
smoker player : folds
Saniooooo: folds
Uncalled bet ($50) returned to Miss_Jammer
Miss_Jammer: doesn't show hand
Miss_Jammer collected $70 from pot
*** SUMMARY ***
Total pot $70.00 | Rake $0
Board []
Seat 2: Miss_Jammer (button) collected ($70)
Seat 3: smoker player  (small blind) folded before Flop
Seat 4: Saniooooo (big blind) folded before Flop
Seat 5: Lucifer999 folded before Flop (didn't bet)
Seat 6: jas8k folded before Flop



PokerStars Game #00327560482: Hold'em No Limit ($25/$50 USD) - 2022/04/30 12:38:49 ET
Table 'Hold'em (Min 1K Max 5K)   216' 6-max Seat #4 is the button
Seat 1: Lucifer999 ($14432.11 in chips) 
Seat 2: johnriley ($1000 in chips) 
Seat 4: Zorzo ($5213.25 in chips) 
Seat 6: Pablit0 ($1582.72 in chips) 
Pablit0: posts small blind $25
Lucifer999: posts big blind $50
*** HOLE CARDS ***
Dealt to Lucifer999 [4s 9s]
johnriley: checks
Zorzo: folds
Pablit0: folds
Lucifer999: raises $150.00 to $200
johnriley: folds
Uncalled bet ($150) returned to Lucifer999
Lucifer999: doesn't show hand
Lucifer999 collected $125 from pot
*** SUMMARY ***
Total pot $125.00 | Rake $0
Board []
Seat 1: Lucifer999 (big blind) collected ($125)
Seat 2: johnriley folded before Flop (didn't bet)
Seat 4: Zorzo (button) folded before Flop (didn't bet)
Seat 6: Pablit0 (small blind) folded before Flop



PokerStars Game #00327560587: Hold'em No Limit ($25/$50 USD) - 2022/04/30 12:39:19 ET
Table 'Hold'em (Min 1K Max 5K)   216' 6-max Seat #6 is the button
Seat 1: Lucifer999 ($14507.11 in chips) 
Seat 2: johnriley ($950 in chips) 
Seat 4: Zorzo ($5213.25 in chips) 
Seat 6: Pablit0 ($1557.72 in chips) 
Lucifer999: posts small blind $25
johnriley: posts big blind $50
*** HOLE CARDS ***
Dealt to Lucifer999 [4s Ts]
Zorzo: folds
Pablit0: folds
Lucifer999: folds
Uncalled bet ($25) returned to johnriley
johnriley: doesn't show hand
johnriley collected $50 from pot
*** SUMMARY ***
Total pot $50.00 | Rake $0
Board []
Seat 1: Lucifer999 (small blind) folded before Flop
Seat 2: johnriley (big blind) collected ($50)
Seat 4: Zorzo folded before Flop (didn't bet)
Seat 6: Pablit0 (button) folded before Flop (didn't bet)



PokerStars Game #00327560564: Hold'em No Limit ($50/$100 USD) - 2022/04/30 12:39:10 ET
Table 'Hold'em (Min 25KMax 10K)    69' 6-max Seat #5 is the button
Seat 1: Lucifer999 ($36814.89 in chips) 
Seat 2: RanveerAJ ($1891.2 in chips) 
Seat 5: tabby20 ($31103.72 in chips) 
Seat 6: manny007 ($6214.29 in chips) 
manny007: posts small blind $50
Lucifer999: posts big blind $100
*** HOLE CARDS ***
Dealt to Lucifer999 [8h Qs]
RanveerAJ: calls $100
tabby20: calls $100
manny007: calls $50
Lucifer999: checks
*** FLOP *** [7h 9s 6h]
manny007: bets $382.4
Lucifer999: folds
RanveerAJ: calls $382.4
tabby20: folds
*** TURN *** [7h 9s 6h] [6s]
manny007: bets $1113.59
RanveerAJ: raises $295.21 to $1408.8
manny007: calls $295.21
*** RIVER *** [7h 9s 6h 6s] [6c]
*** RIVER *** [7h 9s 6h 6s] [As]
*** SHOW DOWN ***
RanveerAJ: shows [8d Ts] (Straight, T-6)
manny007: shows [Th 8c] (Straight, T-6)
manny007 collected $951.8 from pot
RanveerAJ collected $951.8 from pot
manny007 collected $951.8 from pot
RanveerAJ collected $951.8 from pot
*** SUMMARY ***
Total pot $3982.40 | Rake $175.2
Board [7h 9s 6h 6s 6c]
Seat 1: Lucifer999 (big blind) folded on the Flop
Seat 2: RanveerAJ  showed [8d Ts] and won ($951.8) with Straight, T-6
Seat 5: tabby20 (button) folded on the Flop
Seat 6: manny007  (small blind) showed [Th 8c] and won ($951.8) with Straight, T-6



PokerStars Game #00327560526: Hold'em No Limit ($10/$25 USD) - 2022/04/30 12:39:00 ET
Table 'Hold'em (Min 500Max 2500) 1001' 6-max Seat #6 is the button
Seat 1: shykko60 ($681.96 in chips) 
Seat 2: gangster100 ($2100.42 in chips) 
Seat 3: movetome ($2005.6 in chips) 
Seat 4: devi7 ($2406.6 in chips) 
Seat 5: Lucifer999 ($3018.94 in chips) 
Seat 6: spidy02 ($4981.54 in chips) 
shykko60: posts small blind $10
movetome: posts big blind $25
*** HOLE CARDS ***
Dealt to Lucifer999 [Qc Td]
devi7: raises $50.00 to $75
Lucifer999: folds
spidy02: folds
shykko60: folds
movetome: calls $50
*** FLOP *** [Th Tc 6d]
movetome: checks
devi7: checks
*** TURN *** [Th Tc 6d] [4h]
movetome: bets $125
devi7: calls $125
*** RIVER *** [Th Tc 6d 4h] [5c]
movetome: checks
devi7: checks
*** SHOW DOWN ***
movetome: shows [2d 2s] (Two pairs, TT22)
devi7: doesn't show hand
movetome collected $384.48 from pot
*** SUMMARY ***
Total pot $410.00 | Rake $25.52
Board [Th Tc 6d 4h 5c]
Seat 1: shykko60 (small blind) folded before Flop
Seat 3: movetome  (big blind) showed [2d 2s] and won ($384.48) with Two pairs, TT22
Seat 4: devi7 mucked
Seat 5: Lucifer999 folded before Flop (didn't bet)
Seat 6: spidy02 (button) folded before Flop (didn't bet)



PokerStars Game #00327560567: Hold'em No Limit ($10/$25 USD) - 2022/04/30 12:39:12 ET
Table 'Hold'em (Min 500Max 2500)  1282' 6-max Seat #3 is the button
Seat 1: Katya_Joule ($2500 in chips) 
Seat 2: Miss_Jammer ($3138.51 in chips) 
Seat 3: smoker player  ($962.76 in chips) 
Seat 4: Saniooooo ($411.31 in chips) 
Seat 5: Lucifer999 ($8346.29 in chips) 
Seat 6: jas8k ($2139.17 in chips) 
Saniooooo: posts small blind $10
Lucifer999: posts big blind $25
Katya_Joule: posts big blind $25
*** HOLE CARDS ***
Dealt to Lucifer999 [6d 8d]
jas8k: checks
Katya_Joule: checks
Miss_Jammer: folds
smoker player : calls $25
Saniooooo: folds
Lucifer999: checks
*** FLOP *** [Th 6s Td]
Lucifer999: checks
jas8k: checks
Katya_Joule: checks
smoker player : checks
*** TURN *** [Th 6s Td] [5d]
Lucifer999: bets $73.33
jas8k: folds
Katya_Joule: folds
smoker player : folds
Uncalled bet ($73.33) returned to Lucifer999
Lucifer999: doesn't show hand
Lucifer999 collected $112.7 from pot
*** SUMMARY ***
Total pot $120.00 | Rake $7.3
Board [Th 6s Td 5d]
Seat 1: Katya_Joule folded on the Turn
Seat 2: Miss_Jammer folded before Flop (didn't bet)
Seat 3: smoker player  (button) folded on the Turn
Seat 4: Saniooooo (small blind) folded before Flop
Seat 5: Lucifer999 (big blind) collected ($112.7)
Seat 6: jas8k folded on the Turn



PokerStars Game #00327560660: Hold'em No Limit ($25/$50 USD) - 2022/04/30 12:39:40 ET
Table 'Hold'em (Min 1K Max 5K)   216' 6-max Seat #1 is the button
Seat 1: Lucifer999 ($14482.11 in chips) 
Seat 2: johnriley ($975 in chips) 
Seat 4: Zorzo ($5213.25 in chips) 
Seat 6: Pablit0 ($1557.72 in chips) 
johnriley: posts small blind $25
Zorzo: posts big blind $50
*** HOLE CARDS ***
Dealt to Lucifer999 [Ts Js]
Pablit0: folds
Lucifer999: folds
johnriley: calls $25
Zorzo: checks
*** FLOP *** [5h 3c 8c]
johnriley: bets $50
Zorzo: calls $50
*** TURN *** [5h 3c 8c] [6s]
johnriley: bets $50
Zorzo: calls $50
*** RIVER *** [5h 3c 8c 6s] [Ah]
johnriley: bets $50
Zorzo: calls $50
*** SHOW DOWN ***
johnriley: shows [3h 5d] (Two pairs, 5533)
Zorzo: doesn't show hand
johnriley collected $380 from pot
*** SUMMARY ***
Total pot $400.00 | Rake $20
Board [5h 3c 8c 6s Ah]
Seat 1: Lucifer999 (button) folded before Flop (didn't bet)
Seat 2: johnriley  (small blind) showed [3h 5d] and won ($380) with Two pairs, 5533
Seat 4: Zorzo (big blind) mucked
Seat 6: Pablit0 folded before Flop (didn't bet)



PokerStars Game #00327560737: Hold'em No Limit ($50/$100 USD) - 2022/04/30 12:40:04 ET
Table 'Hold'em (Min 25KMax 10K)    69' 6-max Seat #6 is the button
Seat 1: Lucifer999 ($36714.89 in chips) 
Seat 2: RanveerAJ ($1903.6 in chips) 
Seat 3: vinuth ($10000 in chips) 
Seat 4: toreto ($10000 in chips) 
Seat 5: tabby20 ($31003.72 in chips) 
Seat 6: manny007 ($6226.69 in chips) 
Lucifer999: posts small blind $50
RanveerAJ: posts big blind $100
*** HOLE CARDS ***
Dealt to Lucifer999 [Th 5h]
tabby20: raises $200.00 to $300
manny007: folds
Lucifer999: folds
RanveerAJ: calls $200
*** FLOP *** [4h 8h Td]
RanveerAJ: bets $310.7
tabby20: raises $466.05 to $776.75
RanveerAJ: calls $466.05
*** TURN *** [4h 8h Td] [3c]
RanveerAJ: checks
tabby20: bets $2106.57
RanveerAJ: calls $826.85
Uncalled bet ($1279.72) returned to tabby20
*** RIVER *** [4h 8h Td 3c] [Qc]
*** RIVER *** [4h 8h Td 3c] [Jc]
*** SHOW DOWN ***
RanveerAJ: shows [7s 4c] (Pair, 44)
tabby20: shows [Ah Tc] (Pair, TT)
tabby20 collected $1843.75 from pot
tabby20 collected $1843.75 from pot
*** SUMMARY ***
Total pot $3857.20 | Rake $169.7
Board [4h 8h Td 3c Qc]
Seat 1: Lucifer999 (small blind) folded before Flop
Seat 2: RanveerAJ (big blind) showed [7s 4c] and lost with Pair, 44
Seat 5: tabby20  showed [Ah Tc] and won ($1843.75) with Pair, TT
Seat 6: manny007 (button) folded before Flop (didn't bet)



PokerStars Game #00327560755: Hold'em No Limit ($10/$25 USD) - 2022/04/30 12:40:10 ET
Table 'Hold'em (Min 500Max 2500) 1001' 6-max Seat #1 is the button
Seat 1: shykko60 ($671.96 in chips) 
Seat 2: gangster100 ($2100.42 in chips) 
Seat 3: movetome ($2234.48 in chips) 
Seat 4: devi7 ($2206.6 in chips) 
Seat 5: Lucifer999 ($3018.94 in chips) 
Seat 6: spidy02 ($4981.54 in chips) 
movetome: posts small blind $10
devi7: posts big blind $25
*** HOLE CARDS ***
Dealt to Lucifer999 [4h 9d]
Lucifer999: folds
spidy02: folds
shykko60: calls $25
movetome: raises $75.00 to $100
devi7: folds
shykko60: calls $75
*** FLOP *** [6h Ks 3c]
movetome: checks
shykko60: checks
*** TURN *** [6h Ks 3c] [8d]
movetome: checks
shykko60: bets $135.6
movetome: calls $135.6
*** RIVER *** [6h Ks 3c 8d] [3s]
movetome: bets $1998.88
shykko60: folds
Uncalled bet ($1998.88) returned to movetome
movetome: doesn't show hand
movetome collected $466.16 from pot
*** SUMMARY ***
Total pot $496.20 | Rake $30.04
Board [6h Ks 3c 8d 3s]
Seat 1: shykko60 (button) folded on the River
Seat 3: movetome (small blind) collected ($466.16)
Seat 4: devi7 (big blind) folded before Flop
Seat 5: Lucifer999 folded before Flop (didn't bet)
Seat 6: spidy02 folded before Flop (didn't bet)



PokerStars Game #00327560831: Hold'em No Limit ($25/$50 USD) - 2022/04/30 12:40:30 ET
Table 'Hold'em (Min 1K Max 5K)   216' 6-max Seat #2 is the button
Seat 1: Lucifer999 ($14482.11 in chips) 
Seat 2: johnriley ($1155 in chips) 
Seat 4: Zorzo ($5013.25 in chips) 
Seat 6: Pablit0 ($1557.72 in chips) 
Zorzo: posts small blind $25
Pablit0: posts big blind $50
*** HOLE CARDS ***
Dealt to Lucifer999 [Qd Kh]
Lucifer999: raises $100.00 to $150
johnriley: calls $150
Zorzo: folds
Pablit0: calls $100
*** FLOP *** [8h 8d 2h]
Pablit0: checks
Lucifer999: bets $200
johnriley: folds
Pablit0: folds
Uncalled bet ($200) returned to Lucifer999
Lucifer999: doesn't show hand
Lucifer999 collected $451.25 from pot
*** SUMMARY ***
Total pot $475.00 | Rake $23.75
Board [8h 8d 2h]
Seat 1: Lucifer999 collected ($451.25)
Seat 2: johnriley (button) folded on the Flop
Seat 4: Zorzo (small blind) folded before Flop
Seat 6: Pablit0 (big blind) folded on the Flop



PokerStars Game #00327560781: Hold'em No Limit ($10/$25 USD) - 2022/04/30 12:40:16 ET
Table 'Hold'em (Min 500Max 2500)  1282' 6-max Seat #4 is the button
Seat 1: Katya_Joule ($2475 in chips) 
Seat 2: Miss_Jammer ($3138.51 in chips) 
Seat 3: smoker player  ($937.76 in chips) 
Seat 4: Saniooooo ($401.31 in chips) 
Seat 5: Lucifer999 ($8433.99 in chips) 
Seat 6: jas8k ($2104.17 in chips) 
Lucifer999: posts small blind $10
jas8k: posts big blind $25
*** HOLE CARDS ***
Dealt to Lucifer999 [4s 2s]
Katya_Joule: raises $45.00 to $70
Miss_Jammer: folds
smoker player : calls $70
Saniooooo: folds
Lucifer999: folds
jas8k: calls $45
*** FLOP *** [Kc 3d Ah]
jas8k: checks
Katya_Joule: bets $137.63
smoker player : calls $137.63
jas8k: calls $137.63
*** TURN *** [Kc 3d Ah] [8s]
jas8k: checks
Katya_Joule: bets $396.47
smoker player : folds
jas8k: folds
Uncalled bet ($396.47) returned to Katya_Joule
Katya_Joule: doesn't show hand
Katya_Joule collected $594.71 from pot
*** SUMMARY ***
Total pot $632.89 | Rake $38.18
Board [Kc 3d Ah 8s]
Seat 1: Katya_Joule collected ($594.71)
Seat 2: Miss_Jammer folded before Flop (didn't bet)
Seat 3: smoker player  folded on the Turn
Seat 4: Saniooooo (button) folded before Flop (didn't bet)
Seat 5: Lucifer999 (small blind) folded before Flop
Seat 6: jas8k (big blind) folded on the Turn



PokerStars Game #00327560957: Hold'em No Limit ($50/$100 USD) - 2022/04/30 12:41:07 ET
Table 'Hold'em (Min 25KMax 10K)    69' 6-max Seat #1 is the button
Seat 1: Lucifer999 ($36664.89 in chips) 
Seat 2: RanveerAJ ($2500 in chips) 
Seat 3: vinuth ($10000 in chips) 
Seat 4: toreto ($10000 in chips) 
Seat 5: tabby20 ($32787.62 in chips) 
Seat 6: manny007 ($6226.69 in chips) 
tabby20: posts small blind $50
manny007: posts big blind $100
*** HOLE CARDS ***
Dealt to Lucifer999 [9d Ks]
Lucifer999: folds
tabby20: folds
Uncalled bet ($50) returned to manny007
manny007: doesn't show hand
manny007 collected $100 from pot
*** SUMMARY ***
Total pot $100.00 | Rake $0
Board []
Seat 1: Lucifer999 (button) folded before Flop (didn't bet)
Seat 5: tabby20 (small blind) folded before Flop
Seat 6: manny007 (big blind) collected ($100)



PokerStars Game #00327561046: Hold'em No Limit ($10/$25 USD) - 2022/04/30 12:41:28 ET
Table 'Hold'em (Min 500Max 2500)  1282' 6-max Seat #5 is the button
Seat 1: Katya_Joule ($2862.08 in chips) 
Seat 2: Miss_Jammer ($3138.51 in chips) 
Seat 3: smoker player  ($730.13 in chips) 
Seat 4: Saniooooo ($401.31 in chips) 
Seat 5: Lucifer999 ($8423.99 in chips) 
Seat 6: jas8k ($1896.54 in chips) 
jas8k: posts small blind $10
Katya_Joule: posts big blind $25
*** HOLE CARDS ***
Dealt to Lucifer999 [2s 9c]
Miss_Jammer: folds
smoker player : folds
Saniooooo: raises $376.31 to $401.31
Lucifer999: folds
jas8k: folds
Katya_Joule: folds
Uncalled bet ($376.31) returned to Saniooooo
Saniooooo: doesn't show hand
Saniooooo collected $60 from pot
*** SUMMARY ***
Total pot $60.00 | Rake $0
Board []
Seat 1: Katya_Joule (big blind) folded before Flop
Seat 2: Miss_Jammer folded before Flop (didn't bet)
Seat 3: smoker player  folded before Flop (didn't bet)
Seat 4: Saniooooo collected ($60)
Seat 5: Lucifer999 (button) folded before Flop (didn't bet)
Seat 6: jas8k (small blind) folded before Flop



PokerStars Game #00327561017: Hold'em No Limit ($25/$50 USD) - 2022/04/30 12:41:22 ET
Table 'Hold'em (Min 1K Max 5K)   216' 6-max Seat #4 is the button
Seat 1: Lucifer999 ($14783.36 in chips) 
Seat 2: johnriley ($1005 in chips) 
Seat 4: Zorzo ($5000 in chips) 
Seat 6: Pablit0 ($1407.72 in chips) 
Pablit0: posts small blind $25
Lucifer999: posts big blind $50
*** HOLE CARDS ***
Dealt to Lucifer999 [4h 8c]
johnriley: calls $50
Zorzo: raises $175.00 to $225
Pablit0: folds
Lucifer999: folds
johnriley: calls $175
*** FLOP *** [6h 9d As]
johnriley: bets $780
Zorzo: folds
Uncalled bet ($780) returned to johnriley
johnriley: doesn't show hand
johnriley collected $498.75 from pot
*** SUMMARY ***
Total pot $525.00 | Rake $26.25
Board [6h 9d As]
Seat 1: Lucifer999 (big blind) folded before Flop
Seat 2: johnriley collected ($498.75)
Seat 4: Zorzo (button) folded on the Flop
Seat 6: Pablit0 (small blind) folded before Flop



PokerStars Game #00327560976: Hold'em No Limit ($10/$25 USD) - 2022/04/30 12:41:13 ET
Table 'Hold'em (Min 500Max 2500) 1001' 6-max Seat #3 is the button
Seat 1: shykko60 ($436.36 in chips) 
Seat 2: gangster100 ($2100.42 in chips) 
Seat 3: movetome ($2491.16 in chips) 
Seat 4: devi7 ($2181.6 in chips) 
Seat 5: Lucifer999 ($3018.94 in chips) 
Seat 6: spidy02 ($4981.54 in chips) 
devi7: posts small blind $10
Lucifer999: posts big blind $25
*** HOLE CARDS ***
Dealt to Lucifer999 [5c Qd]
spidy02: raises $35.00 to $60
shykko60: calls $60
movetome: calls $60
devi7: folds
Lucifer999: folds
*** FLOP *** [9h 4d 8h]
spidy02: bets $100.86
shykko60: raises $275.50 to $376.36
movetome: calls $376.36
spidy02: calls $275.5
*** TURN *** [9h 4d 8h] [Td]
spidy02: checks
movetome: checks
*** RIVER *** [9h 4d 8h Td] [Th]
spidy02: checks
movetome: checks
*** SHOW DOWN ***
shykko60: shows [Ah 8d] (Two pairs, TT88)
movetome: shows [Ad 9d] (Two pairs, TT99)
spidy02: doesn't show hand
movetome collected $1268.52 from pot
*** SUMMARY ***
Total pot $1344.08 | Rake $75.56
Board [9h 4d 8h Td Th]
Seat 1: shykko60 showed [Ah 8d] and lost with Two pairs, TT88
Seat 3: movetome  (button) showed [Ad 9d] and won ($1268.52) with Two pairs, TT99
Seat 4: devi7 (small blind) folded before Flop
Seat 5: Lucifer999 (big blind) folded before Flop
Seat 6: spidy02 mucked



PokerStars Game #00327561192: Hold'em No Limit ($25/$50 USD) - 2022/04/30 12:42:08 ET
Table 'Hold'em (Min 1K Max 5K)   216' 6-max Seat #6 is the button
Seat 1: Lucifer999 ($14733.36 in chips) 
Seat 2: johnriley ($1278.75 in chips) 
Seat 4: Zorzo ($5000 in chips) 
Seat 6: Pablit0 ($1382.72 in chips) 
Lucifer999: posts small blind $25
johnriley: posts big blind $50
*** HOLE CARDS ***
Dealt to Lucifer999 [8c Qd]
Zorzo: folds
Pablit0: folds
Lucifer999: folds
Uncalled bet ($25) returned to johnriley
johnriley: doesn't show hand
johnriley collected $50 from pot
*** SUMMARY ***
Total pot $50.00 | Rake $0
Board []
Seat 1: Lucifer999 (small blind) folded before Flop
Seat 2: johnriley (big blind) collected ($50)
Seat 4: Zorzo folded before Flop (didn't bet)
Seat 6: Pablit0 (button) folded before Flop (didn't bet)



PokerStars Game #00327561044: Hold'em No Limit ($50/$100 USD) - 2022/04/30 12:41:28 ET
Table 'Hold'em (Min 25KMax 10K)    69' 6-max Seat #5 is the button
Seat 1: Lucifer999 ($36664.89 in chips) 
Seat 2: RanveerAJ ($2500 in chips) 
Seat 3: vinuth ($10000 in chips) 
Seat 4: toreto ($10000 in chips) 
Seat 5: tabby20 ($32737.62 in chips) 
Seat 6: manny007 ($6276.69 in chips) 
manny007: posts small blind $50
Lucifer999: posts big blind $100
vinuth: posts big blind $100
*** HOLE CARDS ***
Dealt to Lucifer999 [2d 6h]
RanveerAJ: checks
vinuth: checks
tabby20: folds
manny007: calls $50
Lucifer999: checks
*** FLOP *** [As 9h 4d]
manny007: bets $100
Lucifer999: folds
RanveerAJ: calls $100
vinuth: folds
*** TURN *** [As 9h 4d] [9s]
manny007: bets $100
RanveerAJ: calls $100
*** RIVER *** [As 9h 4d 9s] [Qh]
manny007: bets $100
RanveerAJ: raises $878.12 to $978.12
manny007: folds
Uncalled bet ($878.12) returned to RanveerAJ
RanveerAJ: doesn't show hand
RanveerAJ collected $1003.8 from pot
*** SUMMARY ***
Total pot $1050.00 | Rake $46.2
Board [As 9h 4d 9s Qh]
Seat 1: Lucifer999 (big blind) folded on the Flop
Seat 2: RanveerAJ collected ($1003.8)
Seat 3: vinuth folded on the Flop
Seat 5: tabby20 (button) folded before Flop (didn't bet)
Seat 6: manny007 (small blind) folded on the River



PokerStars Game #00327561247: Hold'em No Limit ($10/$25 USD) - 2022/04/30 12:42:25 ET
Table 'Hold'em (Min 500Max 2500) 1001' 6-max Seat #4 is the button
Seat 2: gangster100 ($2100.42 in chips) 
Seat 3: movetome ($3323.32 in chips) 
Seat 4: devi7 ($2171.6 in chips) 
Seat 5: Lucifer999 ($2993.94 in chips) 
Seat 6: spidy02 ($4545.18 in chips) 
Lucifer999: posts small blind $10
spidy02: posts big blind $25
*** HOLE CARDS ***
Dealt to Lucifer999 [Ks 8d]
movetome: folds
devi7: folds
Lucifer999: raises $55.00 to $80
spidy02: folds
Uncalled bet ($55) returned to Lucifer999
Lucifer999: doesn't show hand
Lucifer999 collected $50 from pot
*** SUMMARY ***
Total pot $50.00 | Rake $0
Board []
Seat 3: movetome folded before Flop (didn't bet)
Seat 4: devi7 (button) folded before Flop (didn't bet)
Seat 5: Lucifer999 (small blind) collected ($50)
Seat 6: spidy02 (big blind) folded before Flop



PokerStars Game #00327561276: Hold'em No Limit ($25/$50 USD) - 2022/04/30 12:42:32 ET
Table 'Hold'em (Min 1K Max 5K)   216' 6-max Seat #1 is the button
Seat 1: Lucifer999 ($14708.36 in chips) 
Seat 2: johnriley ($1303.75 in chips) 
Seat 4: Zorzo ($5000 in chips) 
Seat 6: Pablit0 ($1382.72 in chips) 
johnriley: posts small blind $25
Zorzo: posts big blind $50
*** HOLE CARDS ***
Dealt to Lucifer999 [Qs 5c]
Pablit0: calls $50
Lucifer999: folds
johnriley: calls $25
Zorzo: checks
*** FLOP *** [7s Tc As]
johnriley: bets $50
Zorzo: calls $50
Pablit0: calls $50
*** TURN *** [7s Tc As] [Js]
johnriley: bets $50
Zorzo: calls $50
Pablit0: calls $50
*** RIVER *** [7s Tc As Js] [Jc]
johnriley: bets $50
Zorzo: calls $50
Pablit0: raises $150.00 to $200
johnriley: calls $150
Zorzo: raises $438.75 to $638.75
Pablit0: calls $438.75
johnriley: calls $438.75
*** SHOW DOWN ***
Zorzo: shows [Jd Ts] (Full house, JJJTT)
Pablit0: doesn't show hand
johnriley: doesn't show hand
Zorzo collected $2247.95 from pot
*** SUMMARY ***
Total pot $2366.25 | Rake $118.3
Board [7s Tc As Js Jc]
Seat 1: Lucifer999 (button) folded before Flop (didn't bet)
Seat 2: johnriley (small blind) mucked
Seat 4: Zorzo  (big blind) showed [Jd Ts] and won ($2247.95) with Full house, JJJTT
Seat 6: Pablit0 mucked



PokerStars Game #00327561313: Hold'em No Limit ($50/$100 USD) - 2022/04/30 12:42:43 ET
Table 'Hold'em (Min 25KMax 10K)    69' 6-max Seat #6 is the button
Seat 1: Lucifer999 ($36564.89 in chips) 
Seat 2: RanveerAJ ($3053.8 in chips) 
Seat 3: vinuth ($9900 in chips) 
Seat 4: toreto ($10000 in chips) 
Seat 5: tabby20 ($32737.62 in chips) 
Seat 6: manny007 ($5876.69 in chips) 
Lucifer999: posts small blind $50
RanveerAJ: posts big blind $100
*** HOLE CARDS ***
Dealt to Lucifer999 [As 9h]
vinuth: folds
tabby20: folds
manny007: calls $100
Lucifer999: raises $350.00 to $450
RanveerAJ: calls $350
manny007: calls $350
*** FLOP *** [5c Qd Kh]
Lucifer999: checks
RanveerAJ: checks
manny007: bets $484.88
Lucifer999: folds
RanveerAJ: calls $484.88
*** TURN *** [5c Qd Kh] [Qh]
RanveerAJ: checks
manny007: checks
*** RIVER *** [5c Qd Kh Qh] [Jd]
RanveerAJ: bets $2118.92
manny007: calls $2118.92
*** SHOW DOWN ***
RanveerAJ: shows [5s 5d] (Full house, 555QQ)
manny007: shows [4d Kd] (Two pairs, KKQQ)
RanveerAJ collected $6269.1 from pot
*** SUMMARY ***
Total pot $6557.60 | Rake $288.5
Board [5c Qd Kh Qh Jd]
Seat 1: Lucifer999 (small blind) folded on the Flop
Seat 2: RanveerAJ  (big blind) showed [5s 5d] and won ($6269.1) with Full house, 555QQ
Seat 3: vinuth folded before Flop (didn't bet)
Seat 5: tabby20 folded before Flop (didn't bet)
Seat 6: manny007 (button) showed [4d Kd] and lost with Two pairs, KKQQ



PokerStars Game #00327561188: Hold'em No Limit ($10/$25 USD) - 2022/04/30 12:42:08 ET
Table 'Hold'em (Min 500Max 2500)  1282' 6-max Seat #6 is the button
Seat 1: Katya_Joule ($2837.08 in chips) 
Seat 2: Miss_Jammer ($3138.51 in chips) 
Seat 3: smoker player  ($730.13 in chips) 
Seat 4: Saniooooo ($436.31 in chips) 
Seat 5: Lucifer999 ($8423.99 in chips) 
Seat 6: jas8k ($1886.54 in chips) 
Katya_Joule: posts small blind $10
Miss_Jammer: posts big blind $25
*** HOLE CARDS ***
Dealt to Lucifer999 [9d Jc]
smoker player : folds
Saniooooo: folds
Lucifer999: folds
jas8k: raises $45.00 to $70
Katya_Joule: calls $60
Miss_Jammer: folds
*** FLOP *** [3d 5s 6c]
Katya_Joule: checks
jas8k: bets $116.51
Katya_Joule: calls $116.51
*** TURN *** [3d 5s 6c] [As]
Katya_Joule: checks
jas8k: checks
*** RIVER *** [3d 5s 6c As] [Ad]
Katya_Joule: bets $249.42
jas8k: calls $249.42
*** SHOW DOWN ***
Katya_Joule: shows [2c Ah] (Three of a kind, AAA)
jas8k: doesn't show hand
Katya_Joule collected $844.82 from pot
*** SUMMARY ***
Total pot $896.86 | Rake $52.04
Board [3d 5s 6c As Ad]
Seat 1: Katya_Joule  (small blind) showed [2c Ah] and won ($844.82) with Three of a kind, AAA
Seat 2: Miss_Jammer (big blind) folded before Flop
Seat 3: smoker player  folded before Flop (didn't bet)
Seat 4: Saniooooo folded before Flop (didn't bet)
Seat 5: Lucifer999 folded before Flop (didn't bet)
Seat 6: jas8k (button) mucked



PokerStars Game #00327561354: Hold'em No Limit ($10/$25 USD) - 2022/04/30 12:42:55 ET
Table 'Hold'em (Min 500Max 2500) 1001' 6-max Seat #5 is the button
Seat 2: gangster100 ($2100.42 in chips) 
Seat 3: movetome ($3323.32 in chips) 
Seat 4: devi7 ($2171.6 in chips) 
Seat 5: Lucifer999 ($3018.94 in chips) 
Seat 6: spidy02 ($4520.18 in chips) 
spidy02: posts small blind $10
movetome: posts big blind $25
*** HOLE CARDS ***
Dealt to Lucifer999 [Ts 9h]
devi7: folds
Lucifer999: folds
spidy02: raises $50.00 to $75
movetome: calls $50
*** FLOP *** [5s Th 8h]
spidy02: checks
movetome: bets $125
spidy02: calls $125
*** TURN *** [5s Th 8h] [Jc]
spidy02: checks
movetome: checks
*** RIVER *** [5s Th 8h Jc] [4h]
spidy02: bets $253.83
movetome: folds
Uncalled bet ($253.83) returned to spidy02
spidy02: doesn't show hand
spidy02 collected $375 from pot
*** SUMMARY ***
Total pot $400.00 | Rake $25
Board [5s Th 8h Jc 4h]
Seat 3: movetome (big blind) folded on the River
Seat 4: devi7 folded before Flop (didn't bet)
Seat 5: Lucifer999 (button) folded before Flop (didn't bet)
Seat 6: spidy02 (small blind) collected ($375)



PokerStars Game #00327561486: Hold'em No Limit ($25/$50 USD) - 2022/04/30 12:43:35 ET
Table 'Hold'em (Min 1K Max 5K)   216' 6-max Seat #2 is the button
Seat 1: Lucifer999 ($14708.36 in chips) 
Seat 2: johnriley ($515 in chips) 
Seat 4: Zorzo ($6459.2 in chips) 
Seat 6: Pablit0 ($593.97 in chips) 
Zorzo: posts small blind $25
Pablit0: posts big blind $50
*** HOLE CARDS ***
Dealt to Lucifer999 [Td 2c]
Lucifer999: folds
johnriley: folds
Zorzo: folds
Uncalled bet ($25) returned to Pablit0
Pablit0: doesn't show hand
Pablit0 collected $50 from pot
*** SUMMARY ***
Total pot $50.00 | Rake $0
Board []
Seat 1: Lucifer999 folded before Flop (didn't bet)
Seat 2: johnriley (button) folded before Flop (didn't bet)
Seat 4: Zorzo (small blind) folded before Flop
Seat 6: Pablit0 (big blind) collected ($50)



PokerStars Game #00327561554: Hold'em No Limit ($25/$50 USD) - 2022/04/30 12:43:56 ET
Table 'Hold'em (Min 1K Max 5K)   216' 6-max Seat #4 is the button
Seat 1: Lucifer999 ($14708.36 in chips) 
Seat 4: Zorzo ($6434.2 in chips) 
Seat 6: Pablit0 ($618.97 in chips) 
Pablit0: posts small blind $25
Lucifer999: posts big blind $50
*** HOLE CARDS ***
Dealt to Lucifer999 [Ac 4h]
Zorzo: folds
Pablit0: folds
Uncalled bet ($25) returned to Lucifer999
Lucifer999: doesn't show hand
Lucifer999 collected $50 from pot
*** SUMMARY ***
Total pot $50.00 | Rake $0
Board []
Seat 1: Lucifer999 (big blind) collected ($50)
Seat 4: Zorzo (button) folded before Flop (didn't bet)
Seat 6: Pablit0 (small blind) folded before Flop



PokerStars Game #00327561512: Hold'em No Limit ($10/$25 USD) - 2022/04/30 12:43:46 ET
Table 'Hold'em (Min 500Max 2500)  1282' 6-max Seat #1 is the button
Seat 1: Katya_Joule ($3245.97 in chips) 
Seat 2: Miss_Jammer ($3113.51 in chips) 
Seat 3: smoker player  ($730.13 in chips) 
Seat 4: Saniooooo ($436.31 in chips) 
Seat 5: Lucifer999 ($8423.99 in chips) 
Seat 6: jas8k ($1450.61 in chips) 
Miss_Jammer: posts small blind $10
smoker player : posts big blind $25
*** HOLE CARDS ***
Dealt to Lucifer999 [Jd Td]
Saniooooo: folds
Lucifer999: folds
jas8k: raises $25.00 to $50
Katya_Joule: raises $135.00 to $185
Miss_Jammer: folds
smoker player : raises $545.13 to $730.13
jas8k: folds
Katya_Joule: folds
Uncalled bet ($545.13) returned to smoker player 
smoker player : doesn't show hand
smoker player  collected $430 from pot
*** SUMMARY ***
Total pot $430.00 | Rake $0
Board []
Seat 1: Katya_Joule (button) folded before Flop
Seat 2: Miss_Jammer (small blind) folded before Flop
Seat 3: smoker player  (big blind) collected ($430)
Seat 4: Saniooooo folded before Flop (didn't bet)
Seat 5: Lucifer999 folded before Flop (didn't bet)
Seat 6: jas8k folded before Flop



PokerStars Game #00327561531: Hold'em No Limit ($10/$25 USD) - 2022/04/30 12:43:50 ET
Table 'Hold'em (Min 500Max 2500) 1001' 6-max Seat #6 is the button
Seat 2: gangster100 ($2100.42 in chips) 
Seat 3: movetome ($3123.32 in chips) 
Seat 4: devi7 ($2171.6 in chips) 
Seat 5: Lucifer999 ($3018.94 in chips) 
Seat 6: spidy02 ($4695.18 in chips) 
movetome: posts small blind $10
devi7: posts big blind $25
*** HOLE CARDS ***
Dealt to Lucifer999 [Td Ad]
Lucifer999: folds
spidy02: raises $70.00 to $95
movetome: folds
devi7: raises $330.00 to $425
spidy02: raises $330.00 to $755
devi7: raises $1416.60 to $2171.6
spidy02: calls $1416.6
*** FLOP *** [6c 9h 6h]
*** TURN *** [6c 9h 6h] [4c]
*** RIVER *** [6c 9h 6h 4c] [2d]
*** SHOW DOWN ***
devi7: shows [Js Jh] (Two pairs, JJ66)
spidy02: shows [Kd Kh] (Two pairs, KK66)
spidy02 collected $4149.2 from pot
*** SUMMARY ***
Total pot $4353.20 | Rake $204
Board [6c 9h 6h 4c 2d]
Seat 3: movetome (small blind) folded before Flop
Seat 4: devi7 (big blind) showed [Js Jh] and lost with Two pairs, JJ66
Seat 5: Lucifer999 folded before Flop (didn't bet)
Seat 6: spidy02  (button) showed [Kd Kh] and won ($4149.2) with Two pairs, KK66



PokerStars Game #00327561638: Hold'em No Limit ($25/$50 USD) - 2022/04/30 12:44:17 ET
Table 'Hold'em (Min 1K Max 5K)   216' 6-max Seat #6 is the button
Seat 1: Lucifer999 ($14733.36 in chips) 
Seat 4: Zorzo ($6434.2 in chips) 
Seat 6: Pablit0 ($593.97 in chips) 
Lucifer999: posts small blind $25
Zorzo: posts big blind $50
*** HOLE CARDS ***
Dealt to Lucifer999 [Ah 9s]
Pablit0: folds
Lucifer999: raises $100.00 to $150
Zorzo: calls $100
*** FLOP *** [4c Tc Qc]
Lucifer999: bets $150
Zorzo: folds
Uncalled bet ($150) returned to Lucifer999
Lucifer999: doesn't show hand
Lucifer999 collected $285 from pot
*** SUMMARY ***
Total pot $300.00 | Rake $15
Board [4c Tc Qc]
Seat 1: Lucifer999 (small blind) collected ($285)
Seat 4: Zorzo (big blind) folded on the Flop
Seat 6: Pablit0 (button) folded before Flop (didn't bet)



PokerStars Game #00327561494: Hold'em No Limit ($50/$100 USD) - 2022/04/30 12:43:38 ET
Table 'Hold'em (Min 25KMax 10K)    69' 6-max Seat #1 is the button
Seat 1: Lucifer999 ($36114.89 in chips) 
Seat 2: RanveerAJ ($6269.1 in chips) 
Seat 3: vinuth ($9900 in chips) 
Seat 4: toreto ($10000 in chips) 
Seat 5: tabby20 ($32737.62 in chips) 
Seat 6: manny007 ($2822.89 in chips) 
RanveerAJ: posts small blind $50
vinuth: posts big blind $100
*** HOLE CARDS ***
Dealt to Lucifer999 [9d Jh]
tabby20: raises $250.00 to $350
manny007: folds
Lucifer999: folds
RanveerAJ: calls $300
vinuth: calls $250
*** FLOP *** [4s 8c 5s]
RanveerAJ: checks
vinuth: checks
tabby20: checks
*** TURN *** [4s 8c 5s] [9h]
RanveerAJ: bets $501.9
vinuth: calls $501.9
tabby20: folds
*** RIVER *** [4s 8c 5s 9h] [4h]
RanveerAJ: bets $1172.6
vinuth: calls $1172.6
*** SHOW DOWN ***
RanveerAJ: shows [6s 7d] (Straight, 9-5)
vinuth: doesn't show hand
RanveerAJ collected $4205.45 from pot
*** SUMMARY ***
Total pot $4399.00 | Rake $193.55
Board [4s 8c 5s 9h 4h]
Seat 1: Lucifer999 (button) folded before Flop (didn't bet)
Seat 2: RanveerAJ  (small blind) showed [6s 7d] and won ($4205.45) with Straight, 9-5
Seat 3: vinuth (big blind) mucked
Seat 5: tabby20 folded on the Turn
Seat 6: manny007 folded before Flop (didn't bet)



PokerStars Game #00327561717: Hold'em No Limit ($10/$25 USD) - 2022/04/30 12:44:41 ET
Table 'Hold'em (Min 500Max 2500) 1001' 6-max Seat #3 is the button
Seat 2: gangster100 ($2100.42 in chips) 
Seat 3: movetome ($3113.32 in chips) 
Seat 4: devi7 ($2500 in chips) 
Seat 5: Lucifer999 ($3018.94 in chips) 
Seat 6: spidy02 ($6672.78 in chips) 
devi7: posts small blind $10
Lucifer999: posts big blind $25
*** HOLE CARDS ***
Dealt to Lucifer999 [2c Qd]
spidy02: folds
movetome: folds
devi7: raises $55.00 to $80
Lucifer999: folds
Uncalled bet ($55) returned to devi7
devi7: doesn't show hand
devi7 collected $50 from pot
*** SUMMARY ***
Total pot $50.00 | Rake $0
Board []
Seat 3: movetome (button) folded before Flop (didn't bet)
Seat 4: devi7 (small blind) collected ($50)
Seat 5: Lucifer999 (big blind) folded before Flop
Seat 6: spidy02 folded before Flop (didn't bet)



PokerStars Game #00327561741: Hold'em No Limit ($50/$100 USD) - 2022/04/30 12:44:47 ET
Table 'Hold'em (Min 25KMax 10K)    69' 6-max Seat #2 is the button
Seat 1: Lucifer999 ($36114.89 in chips) 
Seat 2: RanveerAJ ($8450.05 in chips) 
Seat 3: vinuth ($7875.5 in chips) 
Seat 4: toreto ($10000 in chips) 
Seat 5: tabby20 ($32387.62 in chips) 
Seat 6: manny007 ($2822.89 in chips) 
vinuth: posts small blind $50
toreto: posts big blind $100
*** HOLE CARDS ***
Dealt to Lucifer999 [7d 6s]
tabby20: folds
manny007: folds
Lucifer999: folds
RanveerAJ: folds
vinuth: folds
Uncalled bet ($50) returned to toreto
toreto: doesn't show hand
toreto collected $100 from pot
*** SUMMARY ***
Total pot $100.00 | Rake $0
Board []
Seat 1: Lucifer999 folded before Flop (didn't bet)
Seat 2: RanveerAJ (button) folded before Flop (didn't bet)
Seat 3: vinuth (small blind) folded before Flop
Seat 4: toreto (big blind) collected ($100)
Seat 5: tabby20 folded before Flop (didn't bet)
Seat 6: manny007 folded before Flop (didn't bet)



PokerStars Game #00327561733: Hold'em No Limit ($25/$50 USD) - 2022/04/30 12:44:46 ET
Table 'Hold'em (Min 1K Max 5K)   216' 6-max Seat #1 is the button
Seat 1: Lucifer999 ($14868.36 in chips) 
Seat 4: Zorzo ($6284.2 in chips) 
Seat 6: Pablit0 ($593.97 in chips) 
Zorzo: posts small blind $25
Pablit0: posts big blind $50
*** HOLE CARDS ***
Dealt to Lucifer999 [Kc Th]
Lucifer999: raises $100.00 to $150
Zorzo: folds
Pablit0: raises $443.97 to $593.97
Lucifer999: calls $443.97
*** FLOP *** [4d 2c Jh]
*** FLOP *** [Jc Qs 6s]
*** TURN *** [4d 2c Jh] [7c]
*** TURN *** [4d 2c Jh] [8h]
*** RIVER *** [4d 2c Jh 7c] [Qh]
*** RIVER *** [4d 2c Jh 7c] [Ac]
*** SHOW DOWN ***
Lucifer999: shows [Kc Th] (Straight, A-T)
Pablit0: shows [Ks 4h] (High card, A)
Pablit0 collected $576.17 from pot
Lucifer999 collected $576.17 from pot
*** SUMMARY ***
Total pot $1212.94 | Rake $60.6
Board [4d 2c Jh 7c Qh]
Seat 1: Lucifer999  (button) showed [Kc Th] and won ($576.17) with Straight, A-T
Seat 4: Zorzo (small blind) folded before Flop
Seat 6: Pablit0  (big blind) showed [Ks 4h] and won ($576.17) with High card, A



PokerStars Game #00327561791: Hold'em No Limit ($10/$25 USD) - 2022/04/30 12:45:01 ET
Table 'Hold'em (Min 500Max 2500) 1001' 6-max Seat #4 is the button
Seat 2: gangster100 ($2100.42 in chips) 
Seat 3: movetome ($3113.32 in chips) 
Seat 4: devi7 ($2525 in chips) 
Seat 5: Lucifer999 ($2993.94 in chips) 
Seat 6: spidy02 ($6672.78 in chips) 
Lucifer999: posts small blind $10
spidy02: posts big blind $25
*** HOLE CARDS ***
Dealt to Lucifer999 [4c Th]
movetome: raises $50.00 to $75
devi7: folds
Lucifer999: folds
spidy02: folds
Uncalled bet ($50) returned to movetome
movetome: doesn't show hand
movetome collected $60 from pot
*** SUMMARY ***
Total pot $60.00 | Rake $0
Board []
Seat 3: movetome collected ($60)
Seat 4: devi7 (button) folded before Flop (didn't bet)
Seat 5: Lucifer999 (small blind) folded before Flop
Seat 6: spidy02 (big blind) folded before Flop



PokerStars Game #00327561829: Hold'em No Limit ($50/$100 USD) - 2022/04/30 12:45:11 ET
Table 'Hold'em (Min 25KMax 10K)    69' 6-max Seat #3 is the button
Seat 1: Lucifer999 ($36114.89 in chips) 
Seat 2: RanveerAJ ($8450.05 in chips) 
Seat 3: vinuth ($7825.5 in chips) 
Seat 4: toreto ($10050 in chips) 
Seat 5: tabby20 ($32387.62 in chips) 
Seat 6: manny007 ($2822.89 in chips) 
toreto: posts small blind $50
tabby20: posts big blind $100
*** HOLE CARDS ***
Dealt to Lucifer999 [3h Th]
manny007: folds
Lucifer999: folds
RanveerAJ: folds
vinuth: folds
toreto: folds
Uncalled bet ($50) returned to tabby20
tabby20: doesn't show hand
tabby20 collected $100 from pot
*** SUMMARY ***
Total pot $100.00 | Rake $0
Board []
Seat 1: Lucifer999 folded before Flop (didn't bet)
Seat 2: RanveerAJ folded before Flop (didn't bet)
Seat 3: vinuth (button) folded before Flop (didn't bet)
Seat 4: toreto (small blind) folded before Flop
Seat 5: tabby20 (big blind) collected ($100)
Seat 6: manny007 folded before Flop (didn't bet)



PokerStars Game #00327561713: Hold'em No Limit ($10/$25 USD) - 2022/04/30 12:44:40 ET
Table 'Hold'em (Min 500Max 2500)  1282' 6-max Seat #2 is the button
Seat 1: Katya_Joule ($3060.97 in chips) 
Seat 2: Miss_Jammer ($3103.51 in chips) 
Seat 3: smoker player  ($975.13 in chips) 
Seat 4: Saniooooo ($436.31 in chips) 
Seat 5: Lucifer999 ($8423.99 in chips) 
Seat 6: jas8k ($1400.61 in chips) 
smoker player : posts small blind $10
Saniooooo: posts big blind $25
*** HOLE CARDS ***
Dealt to Lucifer999 [6c 7s]
Lucifer999: folds
jas8k: folds
Katya_Joule: raises $60.00 to $85
Miss_Jammer: raises $165.00 to $250
smoker player : folds
Saniooooo: folds
Katya_Joule: calls $165
*** FLOP *** [4d 2d Jc]
Katya_Joule: checks
Miss_Jammer: bets $400
Katya_Joule: folds
Uncalled bet ($400) returned to Miss_Jammer
Miss_Jammer: doesn't show hand
Miss_Jammer collected $501.92 from pot
*** SUMMARY ***
Total pot $535.00 | Rake $33.08
Board [4d 2d Jc]
Seat 1: Katya_Joule folded on the Flop
Seat 2: Miss_Jammer (button) collected ($501.92)
Seat 3: smoker player  (small blind) folded before Flop
Seat 4: Saniooooo (big blind) folded before Flop
Seat 5: Lucifer999 folded before Flop (didn't bet)
Seat 6: jas8k folded before Flop (didn't bet)



PokerStars Game #00327561871: Hold'em No Limit ($25/$50 USD) - 2022/04/30 12:45:22 ET
Table 'Hold'em (Min 1K Max 5K)   216' 6-max Seat #4 is the button
Seat 1: Lucifer999 ($14850.56 in chips) 
Seat 4: Zorzo ($6259.2 in chips) 
Seat 6: Pablit0 ($576.17 in chips) 
Pablit0: posts small blind $25
Lucifer999: posts big blind $50
*** HOLE CARDS ***
Dealt to Lucifer999 [Qc 8s]
Zorzo: folds
Pablit0: calls $25
Lucifer999: raises $100.00 to $150
Pablit0: calls $100
*** FLOP *** [4d 3c As]
Pablit0: checks
Lucifer999: bets $150
Pablit0: raises $276.17 to $426.17
Lucifer999: folds
Uncalled bet ($276.17) returned to Pablit0
Pablit0: doesn't show hand
Pablit0 collected $570 from pot
*** SUMMARY ***
Total pot $600.00 | Rake $30
Board [4d 3c As]
Seat 1: Lucifer999 (big blind) folded on the Flop
Seat 4: Zorzo (button) folded before Flop (didn't bet)
Seat 6: Pablit0 (small blind) collected ($570)



PokerStars Game #00327561874: Hold'em No Limit ($10/$25 USD) - 2022/04/30 12:45:24 ET
Table 'Hold'em (Min 500Max 2500) 1001' 6-max Seat #5 is the button
Seat 2: gangster100 ($2100.42 in chips) 
Seat 3: movetome ($3148.32 in chips) 
Seat 4: devi7 ($2525 in chips) 
Seat 5: Lucifer999 ($2983.94 in chips) 
Seat 6: spidy02 ($6647.78 in chips) 
spidy02: posts small blind $10
movetome: posts big blind $25
*** HOLE CARDS ***
Dealt to Lucifer999 [6c 3d]
devi7: folds
Lucifer999: folds
spidy02: calls $15
movetome: raises $75.00 to $100
spidy02: folds
Uncalled bet ($75) returned to movetome
movetome: doesn't show hand
movetome collected $50 from pot
*** SUMMARY ***
Total pot $50.00 | Rake $0
Board []
Seat 3: movetome (big blind) collected ($50)
Seat 4: devi7 folded before Flop (didn't bet)
Seat 5: Lucifer999 (button) folded before Flop (didn't bet)
Seat 6: spidy02 (small blind) folded before Flop



PokerStars Game #00327561955: Hold'em No Limit ($10/$25 USD) - 2022/04/30 12:45:42 ET
Table 'Hold'em (Min 500Max 2500)  1282' 6-max Seat #3 is the button
Seat 1: Katya_Joule ($2810.97 in chips) 
Seat 2: Miss_Jammer ($3355.43 in chips) 
Seat 3: smoker player  ($965.13 in chips) 
Seat 4: Saniooooo ($411.31 in chips) 
Seat 5: Lucifer999 ($8423.99 in chips) 
Seat 6: jas8k ($1400.61 in chips) 
Saniooooo: posts small blind $10
Lucifer999: posts big blind $25
*** HOLE CARDS ***
Dealt to Lucifer999 [4c 4h]
jas8k: folds
Katya_Joule: folds
Miss_Jammer: folds
smoker player : folds
Saniooooo: raises $50.00 to $75
Lucifer999: calls $50
*** FLOP *** [7d Kc Jd]
Saniooooo: bets $336.31
Lucifer999: folds
Uncalled bet ($336.31) returned to Saniooooo
Saniooooo: doesn't show hand
Saniooooo collected $141.13 from pot
*** SUMMARY ***
Total pot $150.00 | Rake $8.87
Board [7d Kc Jd]
Seat 1: Katya_Joule folded before Flop (didn't bet)
Seat 2: Miss_Jammer folded before Flop (didn't bet)
Seat 3: smoker player  (button) folded before Flop (didn't bet)
Seat 4: Saniooooo (small blind) collected ($141.13)
Seat 5: Lucifer999 (big blind) folded on the Flop
Seat 6: jas8k folded before Flop (didn't bet)



PokerStars Game #00327561920: Hold'em No Limit ($50/$100 USD) - 2022/04/30 12:45:35 ET
Table 'Hold'em (Min 25KMax 10K)    69' 6-max Seat #4 is the button
Seat 1: Lucifer999 ($36114.89 in chips) 
Seat 2: RanveerAJ ($8450.05 in chips) 
Seat 3: vinuth ($7825.5 in chips) 
Seat 4: toreto ($10000 in chips) 
Seat 5: tabby20 ($32437.62 in chips) 
Seat 6: manny007 ($2822.89 in chips) 
tabby20: posts small blind $50
manny007: posts big blind $100
*** HOLE CARDS ***
Dealt to Lucifer999 [Qh Qs]
Lucifer999: calls $100
RanveerAJ: calls $100
vinuth: raises $300.00 to $400
toreto: folds
tabby20: folds
manny007: folds
Lucifer999: raises $1500.00 to $1900
RanveerAJ: folds
vinuth: calls $1500
*** FLOP *** [Ad Ac 4h]
Lucifer999: bets $2400
vinuth: raises $3525.50 to $5925.5
Lucifer999: calls $3525.5
*** TURN *** [Ad Ac 4h] [4s]
*** TURN *** [Ad Ac 4h] [Kc]
*** RIVER *** [Ad Ac 4h 4s] [7c]
*** RIVER *** [Ad Ac 4h 4s] [5s]
*** SHOW DOWN ***
Lucifer999: shows [Qh Qs] (Two pairs, AAQQ)
vinuth: shows [2d As] (Three of a kind, AAA)
vinuth collected $7730.5 from pot
vinuth collected $7730.5 from pot
*** SUMMARY ***
Total pot $15901.00 | Rake $440
Board [Ad Ac 4h 4s 7c]
Seat 1: Lucifer999 showed [Qh Qs] and lost with Two pairs, AAQQ
Seat 2: RanveerAJ folded before Flop
Seat 3: vinuth  showed [2d As] and won ($7730.5) with Three of a kind, AAA
Seat 4: toreto (button) folded before Flop (didn't bet)
Seat 5: tabby20 (small blind) folded before Flop
Seat 6: manny007 (big blind) folded before Flop



PokerStars Game #00327562134: Hold'em No Limit ($10/$25 USD) - 2022/04/30 12:46:38 ET
Table 'Hold'em (Min 500Max 2500)  1282' 6-max Seat #4 is the button
Seat 1: Katya_Joule ($2810.97 in chips) 
Seat 2: Miss_Jammer ($3355.43 in chips) 
Seat 3: smoker player  ($965.13 in chips) 
Seat 4: Saniooooo ($477.44 in chips) 
Seat 5: Lucifer999 ($8348.99 in chips) 
Seat 6: jas8k ($1400.61 in chips) 
Lucifer999: posts small blind $10
jas8k: posts big blind $25
*** HOLE CARDS ***
Dealt to Lucifer999 [Qc Ah]
Miss_Jammer: folds
smoker player : calls $25
Saniooooo: calls $25
Lucifer999: raises $115.00 to $140
jas8k: folds
smoker player : folds
Saniooooo: folds
Uncalled bet ($115) returned to Lucifer999
Lucifer999: doesn't show hand
Lucifer999 collected $100 from pot
*** SUMMARY ***
Total pot $100.00 | Rake $0
Board []
Seat 2: Miss_Jammer folded before Flop (didn't bet)
Seat 3: smoker player  folded before Flop
Seat 4: Saniooooo (button) folded before Flop
Seat 5: Lucifer999 (small blind) collected ($100)
Seat 6: jas8k (big blind) folded before Flop



PokerStars Game #00327562093: Hold'em No Limit ($10/$25 USD) - 2022/04/30 12:46:26 ET
Table 'Hold'em (Min 500Max 2500) 1001' 6-max Seat #6 is the button
Seat 3: movetome ($3173.32 in chips) 
Seat 4: devi7 ($2525 in chips) 
Seat 5: Lucifer999 ($2983.94 in chips) 
Seat 6: spidy02 ($6622.78 in chips) 
movetome: posts small blind $10
devi7: posts big blind $25
*** HOLE CARDS ***
Dealt to Lucifer999 [6h 3h]
Lucifer999: folds
spidy02: folds
movetome: raises $50.00 to $75
devi7: calls $50
*** FLOP *** [Kh Tc Ks]
movetome: checks
devi7: checks
*** TURN *** [Kh Tc Ks] [6d]
movetome: checks
devi7: checks
*** RIVER *** [Kh Tc Ks 6d] [Ah]
movetome: bets $100
devi7: folds
Uncalled bet ($100) returned to movetome
movetome: doesn't show hand
movetome collected $141.13 from pot
*** SUMMARY ***
Total pot $150.00 | Rake $8.87
Board [Kh Tc Ks 6d Ah]
Seat 3: movetome (small blind) collected ($141.13)
Seat 4: devi7 (big blind) folded on the River
Seat 5: Lucifer999 folded before Flop (didn't bet)
Seat 6: spidy02 (button) folded before Flop (didn't bet)



PokerStars Game #00327562028: Hold'em No Limit ($25/$50 USD) - 2022/04/30 12:46:08 ET
Table 'Hold'em (Min 1K Max 5K)   216' 6-max Seat #6 is the button
Seat 1: Lucifer999 ($14550.56 in chips) 
Seat 4: Zorzo ($6259.2 in chips) 
Seat 6: Pablit0 ($846.17 in chips) 
Lucifer999: posts small blind $25
Zorzo: posts big blind $50
*** HOLE CARDS ***
Dealt to Lucifer999 [Kh Qh]
Pablit0: raises $75.00 to $125
Lucifer999: calls $100
Zorzo: raises $425.00 to $550
Pablit0: raises $296.17 to $846.17
Lucifer999: calls $721.17
Zorzo: calls $296.17
*** FLOP *** [4c Td 2d]
Lucifer999: checks
Zorzo: checks
*** TURN *** [4c Td 2d] [Js]
Lucifer999: checks
Zorzo: checks
*** RIVER *** [4c Td 2d Js] [9s]
Lucifer999: bets $1200
Zorzo: folds
Uncalled bet ($1200) returned to Lucifer999
*** SHOW DOWN ***
Lucifer999: shows [Kh Qh] (Straight, K-9)
Pablit0: shows [Ks Jc] (Pair, JJ)
Lucifer999 collected $2411.61 from pot
*** SUMMARY ***
Total pot $2538.51 | Rake $126.9
Board [4c Td 2d Js 9s]
Seat 1: Lucifer999  (small blind) showed [Kh Qh] and won ($2411.61) with Straight, K-9
Seat 4: Zorzo (big blind) folded on the River
Seat 6: Pablit0 (button) showed [Ks Jc] and lost with Pair, JJ



PokerStars Game #00327562264: Hold'em No Limit ($25/$50 USD) - 2022/04/30 12:47:20 ET
Table 'Hold'em (Min 1K Max 5K)   216' 6-max Seat #4 is the button
Seat 1: Lucifer999 ($16116 in chips) 
Seat 4: Zorzo ($5413.03 in chips) 
Zorzo: posts small blind $25
Lucifer999: posts big blind $50
*** HOLE CARDS ***
Dealt to Lucifer999 [6s 6h]
Zorzo: folds
Uncalled bet ($25) returned to Lucifer999
Lucifer999: doesn't show hand
Lucifer999 collected $50 from pot
*** SUMMARY ***
Total pot $50.00 | Rake $0
Board []
Seat 1: Lucifer999 (big blind) collected ($50)
Seat 4: Zorzo (button) (small blind) folded before Flop



PokerStars Game #00327562239: Hold'em No Limit ($10/$25 USD) - 2022/04/30 12:47:10 ET
Table 'Hold'em (Min 500Max 2500) 1001' 6-max Seat #3 is the button
Seat 2: Katya_Joule ($2500 in chips) 
Seat 3: movetome ($3239.45 in chips) 
Seat 4: devi7 ($2450 in chips) 
Seat 5: Lucifer999 ($2983.94 in chips) 
Seat 6: spidy02 ($6622.78 in chips) 
devi7: posts small blind $10
Lucifer999: posts big blind $25
*** HOLE CARDS ***
Dealt to Lucifer999 [2c Ah]
spidy02: raises $60.00 to $85
movetome: folds
devi7: folds
Lucifer999: folds
Uncalled bet ($60) returned to spidy02
spidy02: doesn't show hand
spidy02 collected $60 from pot
*** SUMMARY ***
Total pot $60.00 | Rake $0
Board []
Seat 3: movetome (button) folded before Flop (didn't bet)
Seat 4: devi7 (small blind) folded before Flop
Seat 5: Lucifer999 (big blind) folded before Flop
Seat 6: spidy02 collected ($60)



PokerStars Game #00327562288: Hold'em No Limit ($25/$50 USD) - 2022/04/30 12:47:28 ET
Table 'Hold'em (Min 1K Max 5K)   216' 6-max Seat #1 is the button
Seat 1: Lucifer999 ($16141 in chips) 
Seat 4: Zorzo ($5388.03 in chips) 
Lucifer999: posts small blind $25
Zorzo: posts big blind $50
*** HOLE CARDS ***
Dealt to Lucifer999 [Qs 4d]
Lucifer999: folds
Uncalled bet ($25) returned to Zorzo
Zorzo: doesn't show hand
Zorzo collected $50 from pot
*** SUMMARY ***
Total pot $50.00 | Rake $0
Board []
Seat 1: Lucifer999 (button) (small blind) folded before Flop
Seat 4: Zorzo (big blind) collected ($50)



PokerStars Game #00327562194: Hold'em No Limit ($10/$25 USD) - 2022/04/30 12:46:58 ET
Table 'Hold'em (Min 500Max 2500)  1282' 6-max Seat #5 is the button
Seat 1: Katya_Joule ($2810.97 in chips) 
Seat 2: Miss_Jammer ($3355.43 in chips) 
Seat 3: smoker player  ($940.13 in chips) 
Seat 4: Saniooooo ($452.44 in chips) 
Seat 5: Lucifer999 ($8423.99 in chips) 
Seat 6: jas8k ($1375.61 in chips) 
jas8k: posts small blind $10
Miss_Jammer: posts big blind $25
*** HOLE CARDS ***
Dealt to Lucifer999 [2s 2d]
smoker player : folds
Saniooooo: calls $25
Lucifer999: raises $85.00 to $110
jas8k: folds
Miss_Jammer: raises $215.00 to $325
Saniooooo: raises $127.44 to $452.44
Lucifer999: calls $342.44
Miss_Jammer: folds
*** FLOP *** [8d Ah Qc]
*** TURN *** [8d Ah Qc] [4c]
*** RIVER *** [8d Ah Qc 4c] [Js]
*** SHOW DOWN ***
Saniooooo: shows [Kh 5h] (High card, A)
Lucifer999: shows [2s 2d] (Pair, 22)
Lucifer999 collected $1169.84 from pot
*** SUMMARY ***
Total pot $1239.88 | Rake $70.04
Board [8d Ah Qc 4c Js]
Seat 2: Miss_Jammer (big blind) folded before Flop
Seat 3: smoker player  folded before Flop (didn't bet)
Seat 4: Saniooooo showed [Kh 5h] and lost with High card, A
Seat 5: Lucifer999  (button) showed [2s 2d] and won ($1169.84) with Pair, 22
Seat 6: jas8k (small blind) folded before Flop



PokerStars Game #00327562321: Hold'em No Limit ($25/$50 USD) - 2022/04/30 12:47:37 ET
Table 'Hold'em (Min 1K Max 5K)   216' 6-max Seat #4 is the button
Seat 1: Lucifer999 ($16116 in chips) 
Seat 4: Zorzo ($5413.03 in chips) 
Zorzo: posts small blind $25
Lucifer999: posts big blind $50
*** HOLE CARDS ***
Dealt to Lucifer999 [4h 8s]
Zorzo: raises $50.00 to $100
Lucifer999: folds
Uncalled bet ($50) returned to Zorzo
Zorzo: doesn't show hand
Zorzo collected $100 from pot
*** SUMMARY ***
Total pot $100.00 | Rake $0
Board []
Seat 1: Lucifer999 (big blind) folded before Flop
Seat 4: Zorzo (button) (small blind) collected ($100)



PokerStars Game #00327562314: Hold'em No Limit ($10/$25 USD) - 2022/04/30 12:47:35 ET
Table 'Hold'em (Min 500Max 2500) 1001' 6-max Seat #4 is the button
Seat 2: Katya_Joule ($2500 in chips) 
Seat 3: movetome ($3239.45 in chips) 
Seat 4: devi7 ($2440 in chips) 
Seat 5: Lucifer999 ($2958.94 in chips) 
Seat 6: spidy02 ($6657.78 in chips) 
Lucifer999: posts small blind $10
spidy02: posts big blind $25
*** HOLE CARDS ***
Dealt to Lucifer999 [Ah 2s]
movetome: raises $50.00 to $75
devi7: folds
Lucifer999: folds
spidy02: folds
Uncalled bet ($50) returned to movetome
movetome: doesn't show hand
movetome collected $60 from pot
*** SUMMARY ***
Total pot $60.00 | Rake $0
Board []
Seat 3: movetome collected ($60)
Seat 4: devi7 (button) folded before Flop (didn't bet)
Seat 5: Lucifer999 (small blind) folded before Flop
Seat 6: spidy02 (big blind) folded before Flop



PokerStars Game #00327562379: Hold'em No Limit ($25/$50 USD) - 2022/04/30 12:47:55 ET
Table 'Hold'em (Min 1K Max 5K)   216' 6-max Seat #1 is the button
Seat 1: Lucifer999 ($16066 in chips) 
Seat 4: Zorzo ($5463.03 in chips) 
Lucifer999: posts small blind $25
Zorzo: posts big blind $50
*** HOLE CARDS ***
Dealt to Lucifer999 [Qd Ac]
Lucifer999: raises $50.00 to $100
Zorzo: folds
Uncalled bet ($50) returned to Lucifer999
Lucifer999: doesn't show hand
Lucifer999 collected $100 from pot
*** SUMMARY ***
Total pot $100.00 | Rake $0
Board []
Seat 1: Lucifer999 (button) (small blind) collected ($100)
Seat 4: Zorzo (big blind) folded before Flop



PokerStars Game #00327562428: Hold'em No Limit ($25/$50 USD) - 2022/04/30 12:48:10 ET
Table 'Hold'em (Min 1K Max 5K)   216' 6-max Seat #4 is the button
Seat 1: Lucifer999 ($16116 in chips) 
Seat 4: Zorzo ($5413.03 in chips) 
Zorzo: posts small blind $25
Lucifer999: posts big blind $50
*** HOLE CARDS ***
Dealt to Lucifer999 [Ah Ks]
Zorzo: folds
Uncalled bet ($25) returned to Lucifer999
Lucifer999: doesn't show hand
Lucifer999 collected $50 from pot
*** SUMMARY ***
Total pot $50.00 | Rake $0
Board []
Seat 1: Lucifer999 (big blind) collected ($50)
Seat 4: Zorzo (button) (small blind) folded before Flop



PokerStars Game #00327562457: Hold'em No Limit ($25/$50 USD) - 2022/04/30 12:48:18 ET
Table 'Hold'em (Min 1K Max 5K)   216' 6-max Seat #1 is the button
Seat 1: Lucifer999 ($16141 in chips) 
Seat 4: Zorzo ($5388.03 in chips) 
Lucifer999: posts small blind $25
Zorzo: posts big blind $50
*** HOLE CARDS ***
Dealt to Lucifer999 [Qc 2h]
Lucifer999: folds
Uncalled bet ($25) returned to Zorzo
Zorzo: doesn't show hand
Zorzo collected $50 from pot
*** SUMMARY ***
Total pot $50.00 | Rake $0
Board []
Seat 1: Lucifer999 (button) (small blind) folded before Flop
Seat 4: Zorzo (big blind) collected ($50)



PokerStars Game #00327562347: Hold'em No Limit ($10/$25 USD) - 2022/04/30 12:47:43 ET
Table 'Hold'em (Min 500Max 2500)  1282' 6-max Seat #6 is the button
Seat 1: Katya_Joule ($2810.97 in chips) 
Seat 2: Miss_Jammer ($3030.43 in chips) 
Seat 3: smoker player  ($940.13 in chips) 
Seat 4: Saniooooo ($2500 in chips) 
Seat 5: Lucifer999 ($9141.39 in chips) 
Seat 6: jas8k ($1365.61 in chips) 
Miss_Jammer: posts small blind $10
smoker player : posts big blind $25
*** HOLE CARDS ***
Dealt to Lucifer999 [7c Ac]
Lucifer999: raises $55.00 to $80
jas8k: calls $80
Miss_Jammer: folds
smoker player : calls $55
*** FLOP *** [3h Kc 4h]
smoker player : checks
Lucifer999: checks
jas8k: bets $176.16
smoker player : folds
Lucifer999: folds
Uncalled bet ($176.16) returned to jas8k
jas8k: doesn't show hand
jas8k collected $234.88 from pot
*** SUMMARY ***
Total pot $250.00 | Rake $15.12
Board [3h Kc 4h]
Seat 2: Miss_Jammer (small blind) folded before Flop
Seat 3: smoker player  (big blind) folded on the Flop
Seat 5: Lucifer999 folded on the Flop
Seat 6: jas8k (button) collected ($234.88)



PokerStars Game #00327562161: Hold'em No Limit ($50/$100 USD) - 2022/04/30 12:46:46 ET
Table 'Hold'em (Min 25KMax 10K)    69' 6-max Seat #5 is the button
Seat 1: Lucifer999 ($28289.39 in chips) 
Seat 2: RanveerAJ ($8350.05 in chips) 
Seat 3: vinuth ($15461 in chips) 
Seat 4: toreto ($10000 in chips) 
Seat 5: tabby20 ($32387.62 in chips) 
Seat 6: manny007 ($2722.89 in chips) 
manny007: posts small blind $50
Lucifer999: posts big blind $100
*** HOLE CARDS ***
Dealt to Lucifer999 [7c Kc]
RanveerAJ: calls $100
vinuth: raises $250.00 to $350
toreto: folds
tabby20: folds
manny007: folds
Lucifer999: calls $250
RanveerAJ: calls $250
*** FLOP *** [7d 8c Qs]
Lucifer999: checks
RanveerAJ: checks
vinuth: bets $525.8
Lucifer999: calls $525.8
RanveerAJ: calls $525.8
*** TURN *** [7d 8c Qs] [4c]
Lucifer999: checks
RanveerAJ: checks
vinuth: checks
*** RIVER *** [7d 8c Qs 4c] [9s]
Lucifer999: checks
RanveerAJ: checks
vinuth: bets $2019.72
Lucifer999: calls $2019.72
RanveerAJ: calls $2019.72
*** SHOW DOWN ***
vinuth: shows [6h Th] (Straight, T-6)
Lucifer999: doesn't show hand
RanveerAJ: doesn't show hand
vinuth collected $8352.18 from pot
*** SUMMARY ***
Total pot $8736.56 | Rake $384.38
Board [7d 8c Qs 4c 9s]
Seat 1: Lucifer999 (big blind) mucked
Seat 2: RanveerAJ mucked
Seat 3: vinuth  showed [6h Th] and won ($8352.18) with Straight, T-6
Seat 4: toreto folded before Flop (didn't bet)
Seat 5: tabby20 (button) folded before Flop (didn't bet)
Seat 6: manny007 (small blind) folded before Flop



PokerStars Game #00327562495: Hold'em No Limit ($50/$100 USD) - 2022/04/30 12:48:29 ET
Table 'Hold'em (Min 25KMax 10K)    69' 6-max Seat #6 is the button
Seat 1: Lucifer999 ($25393.87 in chips) 
Seat 2: RanveerAJ ($5454.53 in chips) 
Seat 3: vinuth ($20917.66 in chips) 
Seat 4: toreto ($10000 in chips) 
Seat 5: tabby20 ($32387.62 in chips) 
Seat 6: manny007 ($2672.89 in chips) 
Lucifer999: posts small blind $50
RanveerAJ: posts big blind $100
*** HOLE CARDS ***
Dealt to Lucifer999 [6s Js]
vinuth: folds
toreto: raises $100.00 to $200
tabby20: raises $550.00 to $750
manny007: folds
Lucifer999: folds
RanveerAJ: folds
toreto: folds
Uncalled bet ($550) returned to tabby20
tabby20: doesn't show hand
tabby20 collected $550 from pot
*** SUMMARY ***
Total pot $550.00 | Rake $0
Board []
Seat 1: Lucifer999 (small blind) folded before Flop
Seat 2: RanveerAJ (big blind) folded before Flop
Seat 3: vinuth folded before Flop (didn't bet)
Seat 4: toreto folded before Flop
Seat 5: tabby20 collected ($550)
Seat 6: manny007 (button) folded before Flop (didn't bet)



PokerStars Game #00327562486: Hold'em No Limit ($25/$50 USD) - 2022/04/30 12:48:26 ET
Table 'Hold'em (Min 1K Max 5K)   216' 6-max Seat #4 is the button
Seat 1: Lucifer999 ($16116 in chips) 
Seat 4: Zorzo ($5413.03 in chips) 
Seat 6: DM0507 ($2555 in chips) 
Zorzo: posts small blind $25
Lucifer999: posts big blind $50
*** HOLE CARDS ***
Dealt to Lucifer999 [Kd 3c]
Zorzo: raises $50.00 to $100
Lucifer999: calls $50
*** FLOP *** [5h 3d 9s]
Lucifer999: checks
Zorzo: bets $150
Lucifer999: calls $150
*** TURN *** [5h 3d 9s] [9d]
Lucifer999: checks
Zorzo: checks
*** RIVER *** [5h 3d 9s 9d] [Ad]
Lucifer999: checks
Zorzo: checks
*** SHOW DOWN ***
Zorzo: shows [8h Tc] (Pair, 99)
Lucifer999: shows [Kd 3c] (Two pairs, 9933)
Lucifer999 collected $477.5 from pot
*** SUMMARY ***
Total pot $500.00 | Rake $22.5
Board [5h 3d 9s 9d Ad]
Seat 1: Lucifer999  (big blind) showed [Kd 3c] and won ($477.5) with Two pairs, 9933
Seat 4: Zorzo (button) (small blind) showed [8h Tc] and lost with Pair, 99



PokerStars Game #00327562492: Hold'em No Limit ($10/$25 USD) - 2022/04/30 12:48:28 ET
Table 'Hold'em (Min 500Max 2500)  1282' 6-max Seat #2 is the button
Seat 1: Katya_Joule ($2810.97 in chips) 
Seat 2: Miss_Jammer ($3020.43 in chips) 
Seat 3: smoker player  ($860.13 in chips) 
Seat 4: Millie ($2500 in chips) 
Seat 5: Lucifer999 ($9061.39 in chips) 
Seat 6: jas8k ($1520.49 in chips) 
smoker player : posts small blind $10
Millie: posts big blind $25
*** HOLE CARDS ***
Dealt to Lucifer999 [Jd 6h]
Lucifer999: folds
jas8k: raises $45.00 to $70
Miss_Jammer: folds
smoker player : calls $60
Millie: folds
*** FLOP *** [Kh 4c 5d]
smoker player : checks
jas8k: bets $85
smoker player : calls $85
*** TURN *** [Kh 4c 5d] [7c]
smoker player : bets $25
jas8k: calls $25
*** RIVER *** [Kh 4c 5d 7c] [Qc]
smoker player : bets $25
jas8k: raises $254.50 to $279.5
smoker player : folds
Uncalled bet ($254.5) returned to jas8k
jas8k: doesn't show hand
jas8k collected $408.17 from pot
*** SUMMARY ***
Total pot $435.00 | Rake $26.83
Board [Kh 4c 5d 7c Qc]
Seat 2: Miss_Jammer (button) folded before Flop (didn't bet)
Seat 3: smoker player  (small blind) folded on the River
Seat 4: Millie (big blind) folded before Flop
Seat 5: Lucifer999 folded before Flop (didn't bet)
Seat 6: jas8k collected ($408.17)



PokerStars Game #00327562394: Hold'em No Limit ($10/$25 USD) - 2022/04/30 12:47:59 ET
Table 'Hold'em (Min 500Max 2500) 1001' 6-max Seat #5 is the button
Seat 2: Katya_Joule ($2500 in chips) 
Seat 3: movetome ($3274.45 in chips) 
Seat 4: devi7 ($2440 in chips) 
Seat 5: Lucifer999 ($2948.94 in chips) 
Seat 6: spidy02 ($6632.78 in chips) 
spidy02: posts small blind $10
Katya_Joule: posts big blind $25
*** HOLE CARDS ***
Dealt to Lucifer999 [Kh 5h]
movetome: folds
devi7: folds
Lucifer999: raises $55.00 to $80
spidy02: calls $70
Katya_Joule: folds
*** FLOP *** [Tc Kc 6d]
spidy02: checks
Lucifer999: checks
*** TURN *** [Tc Kc 6d] [Kd]
spidy02: checks
Lucifer999: bets $110
spidy02: folds
Uncalled bet ($110) returned to Lucifer999
Lucifer999: doesn't show hand
Lucifer999 collected $174.29 from pot
*** SUMMARY ***
Total pot $185.00 | Rake $10.71
Board [Tc Kc 6d Kd]
Seat 2: Katya_Joule (big blind) folded before Flop
Seat 3: movetome folded before Flop (didn't bet)
Seat 4: devi7 folded before Flop (didn't bet)
Seat 5: Lucifer999 (button) collected ($174.29)
Seat 6: spidy02 (small blind) folded on the Turn



PokerStars Game #00327562640: Hold'em No Limit ($25/$50 USD) - 2022/04/30 12:49:15 ET
Table 'Hold'em (Min 1K Max 5K)   216' 6-max Seat #1 is the button
Seat 1: Lucifer999 ($16343.5 in chips) 
Seat 4: Zorzo ($5163.03 in chips) 
Seat 6: DM0507 ($2555 in chips) 
Zorzo: posts small blind $25
DM0507: posts big blind $50
*** HOLE CARDS ***
Dealt to Lucifer999 [6h Qh]
Lucifer999: folds
Zorzo: folds
Uncalled bet ($25) returned to DM0507
DM0507: doesn't show hand
DM0507 collected $50 from pot
*** SUMMARY ***
Total pot $50.00 | Rake $0
Board []
Seat 1: Lucifer999 (button) folded before Flop (didn't bet)
Seat 4: Zorzo (small blind) folded before Flop
Seat 6: DM0507 (big blind) collected ($50)



PokerStars Game #00327562681: Hold'em No Limit ($10/$25 USD) - 2022/04/30 12:49:28 ET
Table 'Hold'em (Min 500Max 2500) 1001' 6-max Seat #6 is the button
Seat 2: Katya_Joule ($2475 in chips) 
Seat 3: movetome ($3274.45 in chips) 
Seat 4: devi7 ($2440 in chips) 
Seat 5: Lucifer999 ($3043.23 in chips) 
Seat 6: spidy02 ($6552.78 in chips) 
movetome: posts small blind $10
devi7: posts big blind $25
*** HOLE CARDS ***
Dealt to Lucifer999 [Ah Jd]
Lucifer999: folds
spidy02: folds
movetome: folds
Uncalled bet ($15) returned to devi7
devi7: doesn't show hand
devi7 collected $20 from pot
*** SUMMARY ***
Total pot $20.00 | Rake $0
Board []
Seat 3: movetome (small blind) folded before Flop
Seat 4: devi7 (big blind) collected ($20)
Seat 5: Lucifer999 folded before Flop (didn't bet)
Seat 6: spidy02 (button) folded before Flop (didn't bet)



PokerStars Game #00327562717: Hold'em No Limit ($25/$50 USD) - 2022/04/30 12:49:38 ET
Table 'Hold'em (Min 1K Max 5K)   216' 6-max Seat #4 is the button
Seat 1: Lucifer999 ($16343.5 in chips) 
Seat 4: Zorzo ($5138.03 in chips) 
Seat 6: DM0507 ($2580 in chips) 
DM0507: posts small blind $25
Lucifer999: posts big blind $50
*** HOLE CARDS ***
Dealt to Lucifer999 [5s Kh]
Zorzo: folds
DM0507: raises $100.00 to $150
Lucifer999: folds
Uncalled bet ($100) returned to DM0507
DM0507: doesn't show hand
DM0507 collected $100 from pot
*** SUMMARY ***
Total pot $100.00 | Rake $0
Board []
Seat 1: Lucifer999 (big blind) folded before Flop
Seat 4: Zorzo (button) folded before Flop (didn't bet)
Seat 6: DM0507 (small blind) collected ($100)



PokerStars Game #00327562766: Hold'em No Limit ($10/$25 USD) - 2022/04/30 12:49:53 ET
Table 'Hold'em (Min 500Max 2500) 1001' 6-max Seat #3 is the button
Seat 2: Katya_Joule ($2475 in chips) 
Seat 3: movetome ($3264.45 in chips) 
Seat 4: devi7 ($2450 in chips) 
Seat 5: Lucifer999 ($3043.23 in chips) 
Seat 6: spidy02 ($6552.78 in chips) 
devi7: posts small blind $10
Lucifer999: posts big blind $25
*** HOLE CARDS ***
Dealt to Lucifer999 [9h Ac]
spidy02: folds
movetome: folds
devi7: folds
Uncalled bet ($15) returned to Lucifer999
Lucifer999: doesn't show hand
Lucifer999 collected $20 from pot
*** SUMMARY ***
Total pot $20.00 | Rake $0
Board []
Seat 3: movetome (button) folded before Flop (didn't bet)
Seat 4: devi7 (small blind) folded before Flop
Seat 5: Lucifer999 (big blind) collected ($20)
Seat 6: spidy02 folded before Flop (didn't bet)



PokerStars Game #00327562808: Hold'em No Limit ($10/$25 USD) - 2022/04/30 12:50:07 ET
Table 'Hold'em (Min 500Max 2500) 1001' 6-max Seat #4 is the button
Seat 2: Katya_Joule ($2475 in chips) 
Seat 3: movetome ($3264.45 in chips) 
Seat 4: devi7 ($2440 in chips) 
Seat 5: Lucifer999 ($3053.23 in chips) 
Seat 6: spidy02 ($6552.78 in chips) 
Lucifer999: posts small blind $10
spidy02: posts big blind $25
*** HOLE CARDS ***
Dealt to Lucifer999 [7h 8s]
movetome: folds
devi7: folds
Lucifer999: folds
Uncalled bet ($15) returned to spidy02
spidy02: doesn't show hand
spidy02 collected $20 from pot
*** SUMMARY ***
Total pot $20.00 | Rake $0
Board []
Seat 3: movetome folded before Flop (didn't bet)
Seat 4: devi7 (button) folded before Flop (didn't bet)
Seat 5: Lucifer999 (small blind) folded before Flop
Seat 6: spidy02 (big blind) collected ($20)



PokerStars Game #00327562672: Hold'em No Limit ($10/$25 USD) - 2022/04/30 12:49:24 ET
Table 'Hold'em (Min 500Max 2500)  1282' 6-max Seat #3 is the button
Seat 1: Katya_Joule ($2810.97 in chips) 
Seat 2: Miss_Jammer ($3020.43 in chips) 
Seat 3: smoker player  ($655.13 in chips) 
Seat 4: Millie ($2500 in chips) 
Seat 5: Lucifer999 ($9061.39 in chips) 
Seat 6: jas8k ($1723.66 in chips) 
Millie: posts small blind $10
Lucifer999: posts big blind $25
Katya_Joule: posts small & big blinds $35
*** HOLE CARDS ***
Dealt to Lucifer999 [3d 2d]
jas8k: calls $25
Katya_Joule: checks
Miss_Jammer: folds
smoker player : raises $110.00 to $145
Millie: raises $505.00 to $650
Lucifer999: folds
jas8k: folds
Katya_Joule: folds
smoker player : folds
Uncalled bet ($505) returned to Millie
Millie: doesn't show hand
Millie collected $375 from pot
*** SUMMARY ***
Total pot $375.00 | Rake $0
Board []
Seat 1: Katya_Joule folded before Flop
Seat 2: Miss_Jammer folded before Flop (didn't bet)
Seat 3: smoker player  (button) folded before Flop
Seat 4: Millie (small blind) collected ($375)
Seat 5: Lucifer999 (big blind) folded before Flop
Seat 6: jas8k folded before Flop



PokerStars Game #00327562798: Hold'em No Limit ($25/$50 USD) - 2022/04/30 12:50:04 ET
Table 'Hold'em (Min 1K Max 5K)   216' 6-max Seat #6 is the button
Seat 1: Lucifer999 ($16293.5 in chips) 
Seat 4: Zorzo ($5138.03 in chips) 
Seat 6: DM0507 ($2630 in chips) 
Lucifer999: posts small blind $25
Zorzo: posts big blind $50
*** HOLE CARDS ***
Dealt to Lucifer999 [Ah 2h]
DM0507: calls $50
Lucifer999: calls $25
Zorzo: raises $175.00 to $225
DM0507: calls $175
Lucifer999: raises $875.00 to $1100
Zorzo: folds
DM0507: calls $875
*** FLOP *** [2c 9h Td]
Lucifer999: bets $2350
DM0507: calls $1530
Uncalled bet ($820) returned to Lucifer999
*** TURN *** [2c 9h Td] [3h]
*** TURN *** [2c 9h Td] [9s]
*** RIVER *** [2c 9h Td 3h] [Kd]
*** RIVER *** [2c 9h Td 3h] [5c]
*** SHOW DOWN ***
Lucifer999: shows [Ah 2h] (Two pairs, 9922)
DM0507: shows [8c 8h] (Two pairs, 9988)
DM0507 collected $2605.38 from pot
DM0507 collected $2605.37 from pot
*** SUMMARY ***
Total pot $5485.00 | Rake $274.25
Board [2c 9h Td 3h Kd]
Seat 1: Lucifer999 (small blind) showed [Ah 2h] and lost with Two pairs, 9922
Seat 4: Zorzo (big blind) folded before Flop
Seat 6: DM0507  (button) showed [8c 8h] and won ($2605.37) with Two pairs, 9988



PokerStars Game #00327562629: Hold'em No Limit ($50/$100 USD) - 2022/04/30 12:49:10 ET
Table 'Hold'em (Min 25KMax 10K)    69' 6-max Seat #1 is the button
Seat 1: Lucifer999 ($25343.87 in chips) 
Seat 2: RanveerAJ ($5354.53 in chips) 
Seat 3: vinuth ($20917.66 in chips) 
Seat 4: toreto ($9800 in chips) 
Seat 5: tabby20 ($32737.62 in chips) 
Seat 6: manny007 ($2672.89 in chips) 
RanveerAJ: posts small blind $50
vinuth: posts big blind $100
*** HOLE CARDS ***
Dealt to Lucifer999 [7s 8s]
toreto: raises $250.00 to $350
tabby20: folds
manny007: folds
Lucifer999: calls $350
RanveerAJ: calls $300
vinuth: folds
*** FLOP *** [6s Tc 2s]
RanveerAJ: checks
toreto: checks
Lucifer999: bets $700
RanveerAJ: calls $700
toreto: folds
*** TURN *** [6s Tc 2s] [9c]
RanveerAJ: checks
Lucifer999: bets $1800
RanveerAJ: calls $1800
*** RIVER *** [6s Tc 2s 9c] [Ad]
RanveerAJ: checks
Lucifer999: bets $5900
RanveerAJ: calls $2504.53
Uncalled bet ($3395.47) returned to Lucifer999
*** SHOW DOWN ***
Lucifer999: shows [7s 8s] (Straight, T-6)
RanveerAJ: shows [Ac 6c] (Two pairs, AA66)
Lucifer999 collected $10719.06 from pot
*** SUMMARY ***
Total pot $11159.06 | Rake $440
Board [6s Tc 2s 9c Ad]
Seat 1: Lucifer999  (button) showed [7s 8s] and won ($10719.06) with Straight, T-6
Seat 2: RanveerAJ (small blind) showed [Ac 6c] and lost with Two pairs, AA66
Seat 3: vinuth (big blind) folded before Flop
Seat 4: toreto folded on the Flop
Seat 5: tabby20 folded before Flop (didn't bet)
Seat 6: manny007 folded before Flop (didn't bet)



PokerStars Game #00327562933: Hold'em No Limit ($25/$50 USD) - 2022/04/30 12:50:44 ET
Table 'Hold'em (Min 1K Max 5K)   216' 6-max Seat #1 is the button
Seat 1: Lucifer999 ($13663.5 in chips) 
Seat 4: Zorzo ($5000 in chips) 
Seat 6: DM0507 ($5210.75 in chips) 
Zorzo: posts small blind $25
DM0507: posts big blind $50
*** HOLE CARDS ***
Dealt to Lucifer999 [8d As]
Lucifer999: folds
Zorzo: folds
Uncalled bet ($25) returned to DM0507
DM0507: doesn't show hand
DM0507 collected $50 from pot
*** SUMMARY ***
Total pot $50.00 | Rake $0
Board []
Seat 1: Lucifer999 (button) folded before Flop (didn't bet)
Seat 4: Zorzo (small blind) folded before Flop
Seat 6: DM0507 (big blind) collected ($50)



PokerStars Game #00327562956: Hold'em No Limit ($50/$100 USD) - 2022/04/30 12:50:48 ET
Table 'Hold'em (Min 25KMax 10K)    69' 6-max Seat #3 is the button
Seat 1: Lucifer999 ($30708.4 in chips) 
Seat 3: vinuth ($20817.66 in chips) 
Seat 4: toreto ($9450 in chips) 
Seat 5: tabby20 ($32737.62 in chips) 
Seat 6: manny007 ($2672.89 in chips) 
toreto: posts small blind $50
tabby20: posts big blind $100
*** HOLE CARDS ***
Dealt to Lucifer999 [9h 8d]
manny007: folds
Lucifer999: folds
vinuth: folds
toreto: folds
Uncalled bet ($50) returned to tabby20
tabby20: doesn't show hand
tabby20 collected $100 from pot
*** SUMMARY ***
Total pot $100.00 | Rake $0
Board []
Seat 1: Lucifer999 folded before Flop (didn't bet)
Seat 3: vinuth (button) folded before Flop (didn't bet)
Seat 4: toreto (small blind) folded before Flop
Seat 5: tabby20 (big blind) collected ($100)
Seat 6: manny007 folded before Flop (didn't bet)



PokerStars Game #00327562893: Hold'em No Limit ($10/$25 USD) - 2022/04/30 12:50:34 ET
Table 'Hold'em (Min 500Max 2500)  1282' 6-max Seat #4 is the button
Seat 1: Katya_Joule ($2775.97 in chips) 
Seat 2: Miss_Jammer ($3020.43 in chips) 
Seat 3: smoker player  ($510.13 in chips) 
Seat 4: Millie ($2730 in chips) 
Seat 5: Lucifer999 ($9036.39 in chips) 
Seat 6: jas8k ($1698.66 in chips) 
Lucifer999: posts small blind $10
Katya_Joule: posts big blind $25
*** HOLE CARDS ***
Dealt to Lucifer999 [9d 9h]
Miss_Jammer: folds
smoker player : folds
Millie: raises $60.00 to $85
Lucifer999: calls $75
Katya_Joule: folds
*** FLOP *** [Td 8h 8c]
Lucifer999: checks
Millie: bets $91.88
Lucifer999: calls $91.88
*** TURN *** [Td 8h 8c] [5d]
Lucifer999: checks
Millie: bets $220
Lucifer999: calls $220
*** RIVER *** [Td 8h 8c 5d] [3d]
Lucifer999: checks
Millie: bets $550
Lucifer999: folds
Uncalled bet ($550) returned to Millie
Millie: doesn't show hand
Millie collected $770.82 from pot
*** SUMMARY ***
Total pot $818.76 | Rake $47.94
Board [Td 8h 8c 5d 3d]
Seat 1: Katya_Joule (big blind) folded before Flop
Seat 2: Miss_Jammer folded before Flop (didn't bet)
Seat 3: smoker player  folded before Flop (didn't bet)
Seat 4: Millie (button) collected ($770.82)
Seat 5: Lucifer999 (small blind) folded on the River



PokerStars Game #00327562880: Hold'em No Limit ($10/$25 USD) - 2022/04/30 12:50:29 ET
Table 'Hold'em (Min 500Max 2500) 1001' 6-max Seat #5 is the button
Seat 2: Katya_Joule ($2475 in chips) 
Seat 3: movetome ($3264.45 in chips) 
Seat 4: devi7 ($2440 in chips) 
Seat 5: Lucifer999 ($3043.23 in chips) 
Seat 6: spidy02 ($6562.78 in chips) 
spidy02: posts small blind $10
Katya_Joule: posts big blind $25
*** HOLE CARDS ***
Dealt to Lucifer999 [5s Ts]
movetome: folds
devi7: folds
Lucifer999: folds
spidy02: calls $15
Katya_Joule: checks
*** FLOP *** [Js Kh 6c]
spidy02: bets $47.38
Katya_Joule: raises $78.97 to $126.35
spidy02: calls $78.97
*** TURN *** [Js Kh 6c] [5c]
spidy02: checks
Katya_Joule: bets $209.23
spidy02: calls $209.23
*** RIVER *** [Js Kh 6c 5c] [2c]
spidy02: checks
Katya_Joule: bets $452.21
spidy02: folds
Uncalled bet ($452.21) returned to Katya_Joule
Katya_Joule: doesn't show hand
Katya_Joule collected $678.31 from pot
*** SUMMARY ***
Total pot $721.16 | Rake $42.85
Board [Js Kh 6c 5c 2c]
Seat 2: Katya_Joule (big blind) collected ($678.31)
Seat 3: movetome folded before Flop (didn't bet)
Seat 4: devi7 folded before Flop (didn't bet)
Seat 5: Lucifer999 (button) folded before Flop (didn't bet)
Seat 6: spidy02 (small blind) folded on the River



PokerStars Game #00327563006: Hold'em No Limit ($25/$50 USD) - 2022/04/30 12:51:04 ET
Table 'Hold'em (Min 1K Max 5K)   216' 6-max Seat #4 is the button
Seat 1: Lucifer999 ($13663.5 in chips) 
Seat 4: Zorzo ($5000 in chips) 
Seat 6: DM0507 ($5235.75 in chips) 
DM0507: posts small blind $25
Lucifer999: posts big blind $50
*** HOLE CARDS ***
Dealt to Lucifer999 [4d Qc]
Zorzo: raises $125.00 to $175
DM0507: calls $150
Lucifer999: folds
*** FLOP *** [Ah 9c 7c]
DM0507: checks
Zorzo: bets $275
DM0507: calls $275
*** TURN *** [Ah 9c 7c] [6s]
DM0507: checks
Zorzo: checks
*** RIVER *** [Ah 9c 7c 6s] [Kh]
DM0507: bets $902.5
Zorzo: folds
Uncalled bet ($902.5) returned to DM0507
DM0507: doesn't show hand
DM0507 collected $902.5 from pot
*** SUMMARY ***
Total pot $950.00 | Rake $47.5
Board [Ah 9c 7c 6s Kh]
Seat 1: Lucifer999 (big blind) folded before Flop
Seat 4: Zorzo (button) folded on the River
Seat 6: DM0507 (small blind) collected ($902.5)



PokerStars Game #00327563019: Hold'em No Limit ($50/$100 USD) - 2022/04/30 12:51:08 ET
Table 'Hold'em (Min 25KMax 10K)    69' 6-max Seat #4 is the button
Seat 1: Lucifer999 ($30708.4 in chips) 
Seat 3: vinuth ($20817.66 in chips) 
Seat 4: toreto ($9400 in chips) 
Seat 5: tabby20 ($32787.62 in chips) 
Seat 6: manny007 ($2672.89 in chips) 
tabby20: posts small blind $50
manny007: posts big blind $100
*** HOLE CARDS ***
Dealt to Lucifer999 [2h Kh]
Lucifer999: folds
vinuth: raises $250.00 to $350
toreto: folds
tabby20: raises $950.00 to $1300
manny007: folds
vinuth: calls $950
*** FLOP *** [3s 8d 2d]
tabby20: bets $2100
vinuth: folds
Uncalled bet ($2100) returned to tabby20
tabby20: doesn't show hand
tabby20 collected $2581.2 from pot
*** SUMMARY ***
Total pot $2700.00 | Rake $118.8
Board [3s 8d 2d]
Seat 1: Lucifer999 folded before Flop (didn't bet)
Seat 3: vinuth folded on the Flop
Seat 4: toreto (button) folded before Flop (didn't bet)
Seat 5: tabby20 (small blind) collected ($2581.2)
Seat 6: manny007 (big blind) folded before Flop



PokerStars Game #00327563109: Hold'em No Limit ($10/$25 USD) - 2022/04/30 12:51:39 ET
Table 'Hold'em (Min 500Max 2500)  1282' 6-max Seat #5 is the button
Seat 1: Katya_Joule ($2750.97 in chips) 
Seat 2: Miss_Jammer ($3020.43 in chips) 
Seat 3: smoker player  ($510.13 in chips) 
Seat 4: Millie ($3103.94 in chips) 
Seat 5: Lucifer999 ($8639.51 in chips) 
Seat 6: jas8k ($1698.66 in chips) 
Katya_Joule: posts small blind $10
Miss_Jammer: posts big blind $25
*** HOLE CARDS ***
Dealt to Lucifer999 [As 9c]
smoker player : calls $25
Millie: folds
Lucifer999: raises $85.00 to $110
Katya_Joule: folds
Miss_Jammer: folds
smoker player : calls $85
*** FLOP *** [Ac Kc Ts]
smoker player : checks
Lucifer999: bets $90
smoker player : raises $310.13 to $400.13
Lucifer999: calls $310.13
*** TURN *** [Ac Kc Ts] [6d]
*** RIVER *** [Ac Kc Ts 6d] [3d]
*** SHOW DOWN ***
smoker player : shows [Qd Jd] (Straight, A-T)
Lucifer999: shows [As 9c] (Pair, AA)
smoker player  collected $994.88 from pot
*** SUMMARY ***
Total pot $1055.26 | Rake $60.38
Board [Ac Kc Ts 6d 3d]
Seat 1: Katya_Joule (small blind) folded before Flop
Seat 2: Miss_Jammer (big blind) folded before Flop
Seat 3: smoker player   showed [Qd Jd] and won ($994.88) with Straight, A-T
Seat 4: Millie folded before Flop (didn't bet)
Seat 5: Lucifer999 (button) showed [As 9c] and lost with Pair, AA



PokerStars Game #00327563175: Hold'em No Limit ($25/$50 USD) - 2022/04/30 12:51:56 ET
Table 'Hold'em (Min 1K Max 5K)   216' 6-max Seat #6 is the button
Seat 1: Lucifer999 ($13613.5 in chips) 
Seat 4: Zorzo ($5000 in chips) 
Seat 6: DM0507 ($5688.25 in chips) 
Lucifer999: posts small blind $25
Zorzo: posts big blind $50
*** HOLE CARDS ***
Dealt to Lucifer999 [4c 2c]
DM0507: folds
Lucifer999: raises $100.00 to $150
Zorzo: raises $300.00 to $450
Lucifer999: folds
Uncalled bet ($300) returned to Zorzo
Zorzo: doesn't show hand
Zorzo collected $300 from pot
*** SUMMARY ***
Total pot $300.00 | Rake $0
Board []
Seat 1: Lucifer999 (small blind) folded before Flop
Seat 4: Zorzo (big blind) collected ($300)
Seat 6: DM0507 (button) folded before Flop (didn't bet)



PokerStars Game #00327563179: Hold'em No Limit ($50/$100 USD) - 2022/04/30 12:51:57 ET
Table 'Hold'em (Min 25KMax 10K)    69' 6-max Seat #5 is the button
Seat 1: Lucifer999 ($30708.4 in chips) 
Seat 3: vinuth ($19517.66 in chips) 
Seat 4: toreto ($9400 in chips) 
Seat 5: tabby20 ($34068.82 in chips) 
Seat 6: manny007 ($2572.89 in chips) 
manny007: posts small blind $50
Lucifer999: posts big blind $100
*** HOLE CARDS ***
Dealt to Lucifer999 [Ah 7c]
vinuth: folds
toreto: calls $100
tabby20: raises $350.00 to $450
manny007: raises $1100.00 to $1550
Lucifer999: folds
toreto: folds
tabby20: folds
Uncalled bet ($1100) returned to manny007
manny007: doesn't show hand
manny007 collected $1100 from pot
*** SUMMARY ***
Total pot $1100.00 | Rake $0
Board []
Seat 1: Lucifer999 (big blind) folded before Flop
Seat 3: vinuth folded before Flop (didn't bet)
Seat 4: toreto folded before Flop
Seat 5: tabby20 (button) folded before Flop
Seat 6: manny007 (small blind) collected ($1100)



PokerStars Game #00327563125: Hold'em No Limit ($10/$25 USD) - 2022/04/30 12:51:42 ET
Table 'Hold'em (Min 500Max 2500) 1001' 6-max Seat #6 is the button
Seat 2: Katya_Joule ($2792.73 in chips) 
Seat 3: movetome ($3264.45 in chips) 
Seat 4: devi7 ($2440 in chips) 
Seat 5: Lucifer999 ($3043.23 in chips) 
Seat 6: spidy02 ($6202.2 in chips) 
Katya_Joule: posts small blind $10
movetome: posts big blind $25
*** HOLE CARDS ***
Dealt to Lucifer999 [9s 2c]
devi7: folds
Lucifer999: folds
spidy02: calls $25
Katya_Joule: calls $15
movetome: raises $100.00 to $125
spidy02: folds
Katya_Joule: calls $100
*** FLOP *** [4c 7s Ks]
Katya_Joule: checks
movetome: bets $200
Katya_Joule: folds
Uncalled bet ($200) returned to movetome
movetome: doesn't show hand
movetome collected $258.57 from pot
*** SUMMARY ***
Total pot $275.00 | Rake $16.43
Board [4c 7s Ks]
Seat 2: Katya_Joule (small blind) folded on the Flop
Seat 3: movetome (big blind) collected ($258.57)
Seat 4: devi7 folded before Flop (didn't bet)
Seat 5: Lucifer999 folded before Flop (didn't bet)
Seat 6: spidy02 (button) folded before Flop



PokerStars Game #00327563292: Hold'em No Limit ($10/$25 USD) - 2022/04/30 12:52:32 ET
Table 'Hold'em (Min 500Max 2500) 1001' 6-max Seat #2 is the button
Seat 2: Katya_Joule ($2667.73 in chips) 
Seat 3: movetome ($3398.02 in chips) 
Seat 4: devi7 ($2440 in chips) 
Seat 5: Lucifer999 ($3043.23 in chips) 
Seat 6: spidy02 ($6177.2 in chips) 
movetome: posts small blind $10
devi7: posts big blind $25
*** HOLE CARDS ***
Dealt to Lucifer999 [9s 8c]
Lucifer999: folds
spidy02: raises $45.00 to $70
Katya_Joule: folds
movetome: folds
devi7: folds
Uncalled bet ($45) returned to spidy02
spidy02: doesn't show hand
spidy02 collected $60 from pot
*** SUMMARY ***
Total pot $60.00 | Rake $0
Board []
Seat 2: Katya_Joule (button) folded before Flop (didn't bet)
Seat 3: movetome (small blind) folded before Flop
Seat 4: devi7 (big blind) folded before Flop
Seat 5: Lucifer999 folded before Flop (didn't bet)
Seat 6: spidy02 collected ($60)



PokerStars Game #00327563257: Hold'em No Limit ($25/$50 USD) - 2022/04/30 12:52:21 ET
Table 'Hold'em (Min 1K Max 5K)   216' 6-max Seat #1 is the button
Seat 1: Lucifer999 ($13463.5 in chips) 
Seat 4: Zorzo ($5150 in chips) 
Seat 6: DM0507 ($5688.25 in chips) 
Zorzo: posts small blind $25
DM0507: posts big blind $50
*** HOLE CARDS ***
Dealt to Lucifer999 [Qc Kd]
Lucifer999: raises $125.00 to $175
Zorzo: calls $150
DM0507: calls $125
*** FLOP *** [Tc 6h 8h]
Zorzo: bets $400
DM0507: folds
Lucifer999: folds
Uncalled bet ($400) returned to Zorzo
Zorzo: doesn't show hand
Zorzo collected $498.75 from pot
*** SUMMARY ***
Total pot $525.00 | Rake $26.25
Board [Tc 6h 8h]
Seat 1: Lucifer999 (button) folded on the Flop
Seat 4: Zorzo (small blind) collected ($498.75)
Seat 6: DM0507 (big blind) folded on the Flop



PokerStars Game #00327563281: Hold'em No Limit ($50/$100 USD) - 2022/04/30 12:52:29 ET
Table 'Hold'em (Min 25KMax 10K)    69' 6-max Seat #6 is the button
Seat 1: Lucifer999 ($30608.4 in chips) 
Seat 2: RanveerAJ ($2500 in chips) 
Seat 3: vinuth ($19517.66 in chips) 
Seat 4: toreto ($9300 in chips) 
Seat 5: tabby20 ($33618.82 in chips) 
Seat 6: manny007 ($3222.89 in chips) 
Lucifer999: posts small blind $50
vinuth: posts big blind $100
*** HOLE CARDS ***
Dealt to Lucifer999 [2h 7s]
toreto: calls $100
tabby20: raises $350.00 to $450
manny007: folds
Lucifer999: folds
vinuth: folds
toreto: calls $350
*** FLOP *** [6d Ah 8c]
toreto: checks
tabby20: checks
*** TURN *** [6d Ah 8c] [Ac]
toreto: bets $501.9
tabby20: calls $501.9
*** RIVER *** [6d Ah 8c Ac] [Th]
toreto: bets $981.74
tabby20: folds
Uncalled bet ($981.74) returned to toreto
toreto: doesn't show hand
toreto collected $1963.47 from pot
*** SUMMARY ***
Total pot $2053.80 | Rake $90.33
Board [6d Ah 8c Ac Th]
Seat 1: Lucifer999 (small blind) folded before Flop
Seat 3: vinuth (big blind) folded before Flop
Seat 4: toreto collected ($1963.47)
Seat 5: tabby20 folded on the River
Seat 6: manny007 (button) folded before Flop (didn't bet)



PokerStars Game #00327563233: Hold'em No Limit ($10/$25 USD) - 2022/04/30 12:52:15 ET
Table 'Hold'em (Min 500Max 2500)  1282' 6-max Seat #1 is the button
Seat 1: Katya_Joule ($2740.97 in chips) 
Seat 2: Miss_Jammer ($2995.43 in chips) 
Seat 3: smoker player  ($994.88 in chips) 
Seat 4: Millie ($3103.94 in chips) 
Seat 5: Lucifer999 ($8129.38 in chips) 
Seat 6: jas8k ($1698.66 in chips) 
Miss_Jammer: posts small blind $10
smoker player : posts big blind $25
jas8k: posts small & big blinds $35
*** HOLE CARDS ***
Dealt to Lucifer999 [8c Jd]
Millie: folds
Lucifer999: folds
jas8k: raises $25.00 to $60
Katya_Joule: folds
Miss_Jammer: calls $40
smoker player : folds
*** FLOP *** [6s 2d Qs]
Miss_Jammer: checks
jas8k: bets $95.19
Miss_Jammer: calls $95.19
*** TURN *** [6s 2d Qs] [5d]
Miss_Jammer: bets $250
jas8k: calls $250
*** RIVER *** [6s 2d Qs 5d] [5c]
Miss_Jammer: checks
jas8k: bets $388.54
Miss_Jammer: calls $388.54
*** SHOW DOWN ***
jas8k: shows [Jh Qh] (Two pairs, QQ55)
Miss_Jammer: doesn't show hand
jas8k collected $1513.36 from pot
*** SUMMARY ***
Total pot $1602.46 | Rake $89.1
Board [6s 2d Qs 5d 5c]
Seat 1: Katya_Joule (button) folded before Flop (didn't bet)
Seat 2: Miss_Jammer (small blind) mucked
Seat 3: smoker player  (big blind) folded before Flop
Seat 4: Millie folded before Flop (didn't bet)
Seat 5: Lucifer999 folded before Flop (didn't bet)
Seat 6: jas8k  showed [Jh Qh] and won ($1513.36) with Two pairs, QQ55



PokerStars Game #00327563415: Hold'em No Limit ($25/$50 USD) - 2022/04/30 12:53:16 ET
Table 'Hold'em (Min 1K Max 5K)   216' 6-max Seat #4 is the button
Seat 1: Lucifer999 ($13288.5 in chips) 
Seat 4: Zorzo ($5473.75 in chips) 
Seat 5: Preet991 ($2500 in chips) 
Seat 6: DM0507 ($5513.25 in chips) 
DM0507: posts small blind $25
Lucifer999: posts big blind $50
*** HOLE CARDS ***
Dealt to Lucifer999 [6h Tc]
Zorzo: raises $125.00 to $175
DM0507: folds
Lucifer999: folds
Uncalled bet ($125) returned to Zorzo
Zorzo: doesn't show hand
Zorzo collected $125 from pot
*** SUMMARY ***
Total pot $125.00 | Rake $0
Board []
Seat 1: Lucifer999 (big blind) folded before Flop
Seat 4: Zorzo (button) collected ($125)
Seat 6: DM0507 (small blind) folded before Flop



PokerStars Game #00327563424: Hold'em No Limit ($50/$100 USD) - 2022/04/30 12:53:19 ET
Table 'Hold'em (Min 25KMax 10K)    69' 6-max Seat #1 is the button
Seat 1: Lucifer999 ($30558.4 in chips) 
Seat 2: RanveerAJ ($2500 in chips) 
Seat 3: vinuth ($19417.66 in chips) 
Seat 4: toreto ($10311.57 in chips) 
Seat 5: tabby20 ($32666.92 in chips) 
Seat 6: manny007 ($3222.89 in chips) 
vinuth: posts small blind $50
toreto: posts big blind $100
*** HOLE CARDS ***
Dealt to Lucifer999 [2h Kh]
tabby20: raises $200.00 to $300
manny007: raises $750.00 to $1050
Lucifer999: folds
vinuth: folds
toreto: folds
tabby20: folds
Uncalled bet ($750) returned to manny007
manny007: doesn't show hand
manny007 collected $750 from pot
*** SUMMARY ***
Total pot $750.00 | Rake $0
Board []
Seat 1: Lucifer999 (button) folded before Flop (didn't bet)
Seat 3: vinuth (small blind) folded before Flop
Seat 4: toreto (big blind) folded before Flop
Seat 5: tabby20 folded before Flop
Seat 6: manny007 collected ($750)



PokerStars Game #00327563384: Hold'em No Limit ($10/$25 USD) - 2022/04/30 12:53:04 ET
Table 'Hold'em (Min 500Max 2500) 1001' 6-max Seat #3 is the button
Seat 2: Katya_Joule ($2667.73 in chips) 
Seat 3: movetome ($3388.02 in chips) 
Seat 4: devi7 ($2415 in chips) 
Seat 5: Lucifer999 ($3043.23 in chips) 
Seat 6: spidy02 ($6212.2 in chips) 
devi7: posts small blind $10
Lucifer999: posts big blind $25
*** HOLE CARDS ***
Dealt to Lucifer999 [6c 2c]
spidy02: folds
Katya_Joule: folds
movetome: raises $50.00 to $75
devi7: calls $65
Lucifer999: folds
*** FLOP *** [4c 4d 4h]
devi7: checks
movetome: bets $50
devi7: calls $50
*** TURN *** [4c 4d 4h] [Th]
devi7: checks
movetome: bets $175
devi7: folds
Uncalled bet ($175) returned to movetome
movetome: doesn't show hand
movetome collected $258.57 from pot
*** SUMMARY ***
Total pot $275.00 | Rake $16.43
Board [4c 4d 4h Th]
Seat 2: Katya_Joule folded before Flop (didn't bet)
Seat 3: movetome (button) collected ($258.57)
Seat 4: devi7 (small blind) folded on the Turn
Seat 5: Lucifer999 (big blind) folded before Flop
Seat 6: spidy02 folded before Flop (didn't bet)



PokerStars Game #00327563530: Hold'em No Limit ($50/$100 USD) - 2022/04/30 12:53:48 ET
Table 'Hold'em (Min 25KMax 10K)    69' 6-max Seat #3 is the button
Seat 1: Lucifer999 ($30558.4 in chips) 
Seat 2: RanveerAJ ($2500 in chips) 
Seat 3: vinuth ($19367.66 in chips) 
Seat 4: toreto ($10211.57 in chips) 
Seat 5: tabby20 ($32366.92 in chips) 
Seat 6: manny007 ($3672.89 in chips) 
toreto: posts small blind $50
tabby20: posts big blind $100
RanveerAJ: posts big blind $100
*** HOLE CARDS ***
Dealt to Lucifer999 [Ad 3s]
manny007: folds
Lucifer999: folds
RanveerAJ: checks
vinuth: folds
toreto: raises $100.00 to $200
tabby20: calls $100
RanveerAJ: calls $100
*** FLOP *** [Td Kh Kc]
toreto: checks
tabby20: checks
RanveerAJ: bets $286.8
toreto: folds
tabby20: folds
Uncalled bet ($286.8) returned to RanveerAJ
RanveerAJ: doesn't show hand
RanveerAJ collected $573.6 from pot
*** SUMMARY ***
Total pot $600.00 | Rake $26.4
Board [Td Kh Kc]
Seat 1: Lucifer999 folded before Flop (didn't bet)
Seat 2: RanveerAJ collected ($573.6)
Seat 3: vinuth (button) folded before Flop (didn't bet)
Seat 4: toreto (small blind) folded on the Flop
Seat 5: tabby20 (big blind) folded on the Flop
Seat 6: manny007 folded before Flop (didn't bet)



PokerStars Game #00327563446: Hold'em No Limit ($10/$25 USD) - 2022/04/30 12:53:25 ET
Table 'Hold'em (Min 500Max 2500)  1282' 6-max Seat #2 is the button
Seat 1: Katya_Joule ($2740.97 in chips) 
Seat 2: Miss_Jammer ($2500 in chips) 
Seat 3: smoker player  ($969.88 in chips) 
Seat 4: Millie ($3103.94 in chips) 
Seat 5: Lucifer999 ($8129.38 in chips) 
Seat 6: jas8k ($2418.29 in chips) 
smoker player : posts small blind $10
Millie: posts big blind $25
*** HOLE CARDS ***
Dealt to Lucifer999 [8s 7c]
Lucifer999: folds
jas8k: folds
Katya_Joule: raises $60.00 to $85
Miss_Jammer: raises $165.00 to $250
smoker player : folds
Millie: folds
Katya_Joule: calls $165
*** FLOP *** [6c Qs Qh]
Katya_Joule: checks
Miss_Jammer: bets $175
Katya_Joule: calls $175
*** TURN *** [6c Qs Qh] [9d]
Katya_Joule: checks
Miss_Jammer: bets $675
Katya_Joule: raises $754.27 to $1429.27
Miss_Jammer: folds
Uncalled bet ($754.27) returned to Katya_Joule
Katya_Joule: doesn't show hand
Katya_Joule collected $2112.67 from pot
*** SUMMARY ***
Total pot $2235.00 | Rake $122.33
Board [6c Qs Qh 9d]
Seat 1: Katya_Joule collected ($2112.67)
Seat 2: Miss_Jammer (button) folded on the Turn
Seat 3: smoker player  (small blind) folded before Flop
Seat 4: Millie (big blind) folded before Flop
Seat 5: Lucifer999 folded before Flop (didn't bet)
Seat 6: jas8k folded before Flop (didn't bet)



PokerStars Game #00327563459: Hold'em No Limit ($25/$50 USD) - 2022/04/30 12:53:30 ET
Table 'Hold'em (Min 1K Max 5K)   216' 6-max Seat #6 is the button
Seat 1: Lucifer999 ($13238.5 in chips) 
Seat 4: Zorzo ($5548.75 in chips) 
Seat 5: Preet991 ($2500 in chips) 
Seat 6: DM0507 ($5488.25 in chips) 
Lucifer999: posts small blind $25
Zorzo: posts big blind $50
*** HOLE CARDS ***
Dealt to Lucifer999 [6c Qh]
Preet991: checks
DM0507: calls $50
Lucifer999: calls $25
Zorzo: checks
*** FLOP *** [2s Kd 5h]
Lucifer999: checks
Zorzo: checks
Preet991: checks
DM0507: checks
*** TURN *** [2s Kd 5h] [Tc]
Lucifer999: checks
Zorzo: bets $150
Preet991: folds
DM0507: calls $150
Lucifer999: folds
*** RIVER *** [2s Kd 5h Tc] [4d]
Zorzo: checks
DM0507: checks
*** SHOW DOWN ***
Zorzo: shows [Ts 8d] (Pair, TT)
DM0507: doesn't show hand
Zorzo collected $475 from pot
*** SUMMARY ***
Total pot $500.00 | Rake $25
Board [2s Kd 5h Tc 4d]
Seat 1: Lucifer999 (small blind) folded on the Turn
Seat 4: Zorzo  (big blind) showed [Ts 8d] and won ($475) with Pair, TT
Seat 5: Preet991 folded on the Turn
Seat 6: DM0507 (button) mucked



PokerStars Game #00327563548: Hold'em No Limit ($10/$25 USD) - 2022/04/30 12:53:56 ET
Table 'Hold'em (Min 500Max 2500) 1001' 6-max Seat #4 is the button
Seat 2: Katya_Joule ($2667.73 in chips) 
Seat 3: movetome ($3521.59 in chips) 
Seat 4: devi7 ($2290 in chips) 
Seat 5: Lucifer999 ($3018.23 in chips) 
Seat 6: spidy02 ($6212.2 in chips) 
Lucifer999: posts small blind $10
spidy02: posts big blind $25
*** HOLE CARDS ***
Dealt to Lucifer999 [7d 4d]
Katya_Joule: folds
movetome: folds
devi7: raises $50.00 to $75
Lucifer999: calls $65
spidy02: calls $50
*** FLOP *** [Kh Ac 9h]
Lucifer999: checks
spidy02: checks
devi7: checks
*** TURN *** [Kh Ac 9h] [Tc]
Lucifer999: checks
spidy02: bets $135.04
devi7: calls $135.04
Lucifer999: folds
*** RIVER *** [Kh Ac 9h Tc] [9s]
spidy02: checks
devi7: checks
*** SHOW DOWN ***
spidy02: shows [Jc Qh] (Straight, A-T)
devi7: doesn't show hand
spidy02 collected $465.1 from pot
*** SUMMARY ***
Total pot $495.08 | Rake $29.98
Board [Kh Ac 9h Tc 9s]
Seat 2: Katya_Joule folded before Flop (didn't bet)
Seat 3: movetome folded before Flop (didn't bet)
Seat 4: devi7 (button) mucked
Seat 5: Lucifer999 (small blind) folded on the Turn
Seat 6: spidy02  (big blind) showed [Jc Qh] and won ($465.1) with Straight, A-T



PokerStars Game #00327563728: Hold'em No Limit ($25/$50 USD) - 2022/04/30 12:54:50 ET
Table 'Hold'em (Min 1K Max 5K)   216' 6-max Seat #1 is the button
Seat 1: Lucifer999 ($13188.5 in chips) 
Seat 4: Zorzo ($5823.75 in chips) 
Seat 5: Preet991 ($2450 in chips) 
Seat 6: DM0507 ($5288.25 in chips) 
Zorzo: posts small blind $25
Preet991: posts big blind $50
*** HOLE CARDS ***
Dealt to Lucifer999 [4c 6h]
DM0507: calls $50
Lucifer999: folds
Zorzo: folds
Preet991: checks
*** FLOP *** [5h Ad 5d]
Preet991: checks
DM0507: checks
*** TURN *** [5h Ad 5d] [Qd]
Preet991: checks
DM0507: checks
*** RIVER *** [5h Ad 5d Qd] [7d]
Preet991: bets $100
DM0507: folds
Uncalled bet ($100) returned to Preet991
Preet991: doesn't show hand
Preet991 collected $118.75 from pot
*** SUMMARY ***
Total pot $125.00 | Rake $6.25
Board [5h Ad 5d Qd 7d]
Seat 1: Lucifer999 (button) folded before Flop (didn't bet)
Seat 4: Zorzo (small blind) folded before Flop
Seat 5: Preet991 (big blind) collected ($118.75)
Seat 6: DM0507 folded on the River



PokerStars Game #00327563657: Hold'em No Limit ($50/$100 USD) - 2022/04/30 12:54:29 ET
Table 'Hold'em (Min 25KMax 10K)    69' 6-max Seat #4 is the button
Seat 1: Lucifer999 ($30558.4 in chips) 
Seat 2: RanveerAJ ($2873.6 in chips) 
Seat 3: vinuth ($19367.66 in chips) 
Seat 4: toreto ($10011.57 in chips) 
Seat 5: tabby20 ($32166.92 in chips) 
Seat 6: manny007 ($3672.89 in chips) 
tabby20: posts small blind $50
manny007: posts big blind $100
*** HOLE CARDS ***
Dealt to Lucifer999 [Kh 7h]
Lucifer999: folds
RanveerAJ: calls $100
vinuth: raises $250.00 to $350
toreto: folds
tabby20: folds
manny007: folds
RanveerAJ: calls $250
*** FLOP *** [Ac 9h Kd]
RanveerAJ: checks
vinuth: bets $609.45
RanveerAJ: calls $609.45
*** TURN *** [Ac 9h Kd] [Ad]
RanveerAJ: bets $1914.15
vinuth: calls $1914.15
*** RIVER *** [Ac 9h Kd Ad] [3s]
*** RIVER *** [Ac 9h Kd Ad] [5h]
*** SHOW DOWN ***
RanveerAJ: shows [Th Ks] (Two pairs, AAKK)
vinuth: shows [9d 9s] (Full house, 999AA)
vinuth collected $2818.87 from pot
vinuth collected $2818.87 from pot
*** SUMMARY ***
Total pot $5897.20 | Rake $259.46
Board [Ac 9h Kd Ad 3s]
Seat 1: Lucifer999 folded before Flop (didn't bet)
Seat 2: RanveerAJ showed [Th Ks] and lost with Two pairs, AAKK
Seat 3: vinuth  showed [9d 9s] and won ($2818.87) with Full house, 999AA
Seat 4: toreto (button) folded before Flop (didn't bet)
Seat 5: tabby20 (small blind) folded before Flop
Seat 6: manny007 (big blind) folded before Flop



PokerStars Game #00327563707: Hold'em No Limit ($10/$25 USD) - 2022/04/30 12:54:43 ET
Table 'Hold'em (Min 500Max 2500)  1282' 6-max Seat #3 is the button
Seat 1: Katya_Joule ($3753.64 in chips) 
Seat 2: Miss_Jammer ($2500 in chips) 
Seat 3: smoker player  ($959.88 in chips) 
Seat 4: Millie ($3078.94 in chips) 
Seat 5: Lucifer999 ($8129.38 in chips) 
Seat 6: jas8k ($2418.29 in chips) 
Millie: posts small blind $10
Lucifer999: posts big blind $25
*** HOLE CARDS ***
Dealt to Lucifer999 [6s 5h]
Katya_Joule: folds
Miss_Jammer: folds
smoker player : calls $25
Millie: folds
Lucifer999: checks
*** FLOP *** [Th 3h 5s]
Lucifer999: checks
smoker player : checks
*** TURN *** [Th 3h 5s] [Kc]
Lucifer999: checks
smoker player : checks
*** RIVER *** [Th 3h 5s Kc] [9c]
Lucifer999: checks
smoker player : checks
*** SHOW DOWN ***
Lucifer999: shows [6s 5h] (Pair, 55)
smoker player : doesn't show hand
Lucifer999 collected $56.85 from pot
*** SUMMARY ***
Total pot $60.00 | Rake $3.15
Board [Th 3h 5s Kc 9c]
Seat 1: Katya_Joule folded before Flop (didn't bet)
Seat 2: Miss_Jammer folded before Flop (didn't bet)
Seat 3: smoker player  (button) mucked
Seat 4: Millie (small blind) folded before Flop
Seat 5: Lucifer999  (big blind) showed [6s 5h] and won ($56.85) with Pair, 55



PokerStars Game #00327563769: Hold'em No Limit ($10/$25 USD) - 2022/04/30 12:55:04 ET
Table 'Hold'em (Min 500Max 2500) 1001' 6-max Seat #5 is the button
Seat 2: Katya_Joule ($2667.73 in chips) 
Seat 3: movetome ($3521.59 in chips) 
Seat 4: devi7 ($2079.96 in chips) 
Seat 5: Lucifer999 ($2943.23 in chips) 
Seat 6: spidy02 ($6467.26 in chips) 
spidy02: posts small blind $10
Katya_Joule: posts big blind $25
*** HOLE CARDS ***
Dealt to Lucifer999 [Ac Tc]
movetome: folds
devi7: folds
Lucifer999: raises $55.00 to $80
spidy02: folds
Katya_Joule: folds
Uncalled bet ($55) returned to Lucifer999
Lucifer999: doesn't show hand
Lucifer999 collected $60 from pot
*** SUMMARY ***
Total pot $60.00 | Rake $0
Board []
Seat 2: Katya_Joule (big blind) folded before Flop
Seat 3: movetome folded before Flop (didn't bet)
Seat 4: devi7 folded before Flop (didn't bet)
Seat 5: Lucifer999 (button) collected ($60)
Seat 6: spidy02 (small blind) folded before Flop



PokerStars Game #00327563805: Hold'em No Limit ($25/$50 USD) - 2022/04/30 12:55:15 ET
Table 'Hold'em (Min 1K Max 5K)   216' 6-max Seat #4 is the button
Seat 1: Lucifer999 ($13188.5 in chips) 
Seat 2: Pablit0 ($1050 in chips) 
Seat 4: Zorzo ($5798.75 in chips) 
Seat 5: Preet991 ($2518.75 in chips) 
Seat 6: DM0507 ($5238.25 in chips) 
Preet991: posts small blind $25
DM0507: posts big blind $50
Pablit0: posts big blind $50
*** HOLE CARDS ***
Dealt to Lucifer999 [4c As]
Lucifer999: folds
Pablit0: checks
Zorzo: raises $175.00 to $225
Preet991: calls $200
DM0507: calls $175
Pablit0: folds
*** FLOP *** [3d 9d 2c]
Preet991: checks
DM0507: checks
Zorzo: bets $450
Preet991: calls $450
DM0507: folds
*** TURN *** [3d 9d 2c] [6s]
Preet991: bets $1843.75
Zorzo: calls $1843.75
*** RIVER *** [3d 9d 2c 6s] [5d]
*** RIVER *** [3d 9d 2c 6s] [2d]
*** SHOW DOWN ***
Zorzo: shows [9h Kd] (Two pairs, 9922)
Preet991: shows [4d Ad] (Flush, A high)
Preet991 collected $2523.45 from pot
Preet991 collected $2523.45 from pot
*** SUMMARY ***
Total pot $5312.50 | Rake $265.6
Board [3d 9d 2c 6s 5d]
Seat 1: Lucifer999 folded before Flop (didn't bet)
Seat 2: Pablit0 folded before Flop
Seat 4: Zorzo (button) showed [9h Kd] and lost with Two pairs, 9922
Seat 5: Preet991  (small blind) showed [4d Ad] and won ($2523.45) with Flush, A high
Seat 6: DM0507 (big blind) folded on the Flop



PokerStars Game #00327563882: Hold'em No Limit ($10/$25 USD) - 2022/04/30 12:55:41 ET
Table 'Hold'em (Min 500Max 2500) 1001' 6-max Seat #6 is the button
Seat 2: Katya_Joule ($2642.73 in chips) 
Seat 3: movetome ($3521.59 in chips) 
Seat 4: devi7 ($2079.96 in chips) 
Seat 5: Lucifer999 ($2978.23 in chips) 
Seat 6: spidy02 ($6457.26 in chips) 
Katya_Joule: posts small blind $10
movetome: posts big blind $25
*** HOLE CARDS ***
Dealt to Lucifer999 [6d 8d]
devi7: folds
Lucifer999: raises $55.00 to $80
spidy02: folds
Katya_Joule: folds
movetome: folds
Uncalled bet ($55) returned to Lucifer999
Lucifer999: doesn't show hand
Lucifer999 collected $60 from pot
*** SUMMARY ***
Total pot $60.00 | Rake $0
Board []
Seat 2: Katya_Joule (small blind) folded before Flop
Seat 3: movetome (big blind) folded before Flop
Seat 4: devi7 folded before Flop (didn't bet)
Seat 5: Lucifer999 collected ($60)
Seat 6: spidy02 (button) folded before Flop (didn't bet)



PokerStars Game #00327563815: Hold'em No Limit ($50/$100 USD) - 2022/04/30 12:55:19 ET
Table 'Hold'em (Min 25KMax 10K)    69' 6-max Seat #5 is the button
Seat 1: Lucifer999 ($30558.4 in chips) 
Seat 3: vinuth ($22131.8 in chips) 
Seat 4: toreto ($10011.57 in chips) 
Seat 5: tabby20 ($32116.92 in chips) 
Seat 6: manny007 ($3572.89 in chips) 
manny007: posts small blind $50
Lucifer999: posts big blind $100
*** HOLE CARDS ***
Dealt to Lucifer999 [As Tc]
vinuth: raises $250.00 to $350
toreto: calls $350
tabby20: raises $1200.00 to $1550
manny007: folds
Lucifer999: folds
vinuth: folds
toreto: folds
Uncalled bet ($1200) returned to tabby20
tabby20: doesn't show hand
tabby20 collected $1200 from pot
*** SUMMARY ***
Total pot $1200.00 | Rake $0
Board []
Seat 1: Lucifer999 (big blind) folded before Flop
Seat 3: vinuth folded before Flop
Seat 4: toreto folded before Flop
Seat 5: tabby20 (button) collected ($1200)
Seat 6: manny007 (small blind) folded before Flop



PokerStars Game #00327563952: Hold'em No Limit ($25/$50 USD) - 2022/04/30 12:56:04 ET
Table 'Hold'em (Min 1K Max 5K)   216' 6-max Seat #5 is the button
Seat 1: Lucifer999 ($13188.5 in chips) 
Seat 2: Pablit0 ($1000 in chips) 
Seat 4: Zorzo ($5000 in chips) 
Seat 5: Preet991 ($5046.9 in chips) 
Seat 6: DM0507 ($5013.25 in chips) 
DM0507: posts small blind $25
Lucifer999: posts big blind $50
*** HOLE CARDS ***
Dealt to Lucifer999 [Js 4h]
Pablit0: folds
Zorzo: folds
Preet991: folds
DM0507: calls $25
Lucifer999: checks
*** FLOP *** [6s 8c 6d]
DM0507: bets $95
Lucifer999: folds
Uncalled bet ($95) returned to DM0507
DM0507: doesn't show hand
DM0507 collected $95 from pot
*** SUMMARY ***
Total pot $100.00 | Rake $5
Board [6s 8c 6d]
Seat 1: Lucifer999 (big blind) folded on the Flop
Seat 2: Pablit0 folded before Flop (didn't bet)
Seat 4: Zorzo folded before Flop (didn't bet)
Seat 5: Preet991 (button) folded before Flop (didn't bet)
Seat 6: DM0507 (small blind) collected ($95)



PokerStars Game #00327563861: Hold'em No Limit ($10/$25 USD) - 2022/04/30 12:55:33 ET
Table 'Hold'em (Min 500Max 2500)  1282' 6-max Seat #4 is the button
Seat 1: Katya_Joule ($3753.64 in chips) 
Seat 2: Miss_Jammer ($2500 in chips) 
Seat 3: smoker player  ($934.88 in chips) 
Seat 4: Millie ($3068.94 in chips) 
Seat 5: Lucifer999 ($8161.23 in chips) 
Seat 6: jas8k ($2418.29 in chips) 
Lucifer999: posts small blind $10
jas8k: posts big blind $25
*** HOLE CARDS ***
Dealt to Lucifer999 [Js Jd]
Katya_Joule: folds
Miss_Jammer: folds
smoker player : calls $25
Millie: raises $85.00 to $110
Lucifer999: calls $100
jas8k: folds
smoker player : folds
*** FLOP *** [As 8h 5c]
Lucifer999: checks
Millie: bets $100
Lucifer999: calls $100
*** TURN *** [As 8h 5c] [4c]
Lucifer999: checks
Millie: checks
*** RIVER *** [As 8h 5c 4c] [6d]
Lucifer999: checks
Millie: bets $170
Lucifer999: calls $170
*** SHOW DOWN ***
Millie: shows [7h 7d] (Straight, 8-4)
Lucifer999: doesn't show hand
Millie collected $762.48 from pot
*** SUMMARY ***
Total pot $810.00 | Rake $47.52
Board [As 8h 5c 4c 6d]
Seat 1: Katya_Joule folded before Flop (didn't bet)
Seat 2: Miss_Jammer folded before Flop (didn't bet)
Seat 3: smoker player  folded before Flop
Seat 4: Millie  (button) showed [7h 7d] and won ($762.48) with Straight, 8-4
Seat 5: Lucifer999 (small blind) mucked
Seat 6: jas8k (big blind) folded before Flop



PokerStars Game #00327563990: Hold'em No Limit ($10/$25 USD) - 2022/04/30 12:56:20 ET
Table 'Hold'em (Min 500Max 2500) 1001' 6-max Seat #2 is the button
Seat 1: HSV ($965.02 in chips) 
Seat 2: Katya_Joule ($2632.73 in chips) 
Seat 3: movetome ($3496.59 in chips) 
Seat 4: devi7 ($2079.96 in chips) 
Seat 5: Lucifer999 ($3013.23 in chips) 
Seat 6: spidy02 ($6457.26 in chips) 
movetome: posts small blind $10
devi7: posts big blind $25
HSV: posts big blind $25
*** HOLE CARDS ***
Dealt to Lucifer999 [6s Kd]
Lucifer999: folds
spidy02: folds
HSV: checks
Katya_Joule: folds
movetome: raises $75.00 to $100
devi7: calls $75
HSV: calls $75
*** FLOP *** [8s 8c Qc]
movetome: checks
devi7: bets $125
HSV: folds
movetome: calls $125
*** TURN *** [8s 8c Qc] [2c]
movetome: bets $375
devi7: calls $375
*** RIVER *** [8s 8c Qc 2c] [Tc]
movetome: checks
devi7: checks
*** SHOW DOWN ***
movetome: shows [4s 4h] (Two pairs, 8844)
devi7: shows [As 8d] (Three of a kind, 888)
devi7 collected $1226.75 from pot
*** SUMMARY ***
Total pot $1300.00 | Rake $73.25
Board [8s 8c Qc 2c Tc]
Seat 1: HSV folded on the Flop
Seat 2: Katya_Joule (button) folded before Flop (didn't bet)
Seat 3: movetome (small blind) showed [4s 4h] and lost with Two pairs, 8844
Seat 4: devi7  (big blind) showed [As 8d] and won ($1226.75) with Three of a kind, 888
Seat 5: Lucifer999 folded before Flop (didn't bet)
Seat 6: spidy02 folded before Flop (didn't bet)



PokerStars Game #00327564009: Hold'em No Limit ($50/$100 USD) - 2022/04/30 12:56:26 ET
Table 'Hold'em (Min 25KMax 10K)    69' 6-max Seat #6 is the button
Seat 1: Lucifer999 ($30458.4 in chips) 
Seat 3: vinuth ($21781.8 in chips) 
Seat 4: toreto ($9661.57 in chips) 
Seat 5: tabby20 ($32966.92 in chips) 
Seat 6: manny007 ($3522.89 in chips) 
Lucifer999: posts small blind $50
vinuth: posts big blind $100
*** HOLE CARDS ***
Dealt to Lucifer999 [2h Ts]
toreto: raises $100.00 to $200
tabby20: folds
manny007: folds
Lucifer999: folds
vinuth: raises $350.00 to $550
toreto: calls $350
*** FLOP *** [5d 9s 6s]
vinuth: bets $824.55
toreto: calls $824.55
*** TURN *** [5d 9s 6s] [Td]
vinuth: bets $2006.96
toreto: folds
Uncalled bet ($2006.96) returned to vinuth
vinuth: doesn't show hand
vinuth collected $2675.95 from pot
*** SUMMARY ***
Total pot $2799.10 | Rake $123.15
Board [5d 9s 6s Td]
Seat 1: Lucifer999 (small blind) folded before Flop
Seat 3: vinuth (big blind) collected ($2675.95)
Seat 4: toreto folded on the Turn
Seat 5: tabby20 folded before Flop (didn't bet)
Seat 6: manny007 (button) folded before Flop (didn't bet)



PokerStars Game #00327564042: Hold'em No Limit ($25/$50 USD) - 2022/04/30 12:56:40 ET
Table 'Hold'em (Min 1K Max 5K)   216' 6-max Seat #6 is the button
Seat 1: Lucifer999 ($13138.5 in chips) 
Seat 2: Pablit0 ($1000 in chips) 
Seat 4: Zorzo ($5000 in chips) 
Seat 6: DM0507 ($5058.25 in chips) 
Lucifer999: posts small blind $25
Pablit0: posts big blind $50
*** HOLE CARDS ***
Dealt to Lucifer999 [2s 4h]
Zorzo: raises $125.00 to $175
DM0507: calls $175
Lucifer999: folds
Pablit0: folds
*** FLOP *** [7c 4d 5c]
Zorzo: checks
DM0507: bets $403.75
Zorzo: raises $896.25 to $1300
DM0507: calls $896.25
*** TURN *** [7c 4d 5c] [Js]
Zorzo: bets $3525
DM0507: calls $3525
*** RIVER *** [7c 4d 5c Js] [4s]
*** RIVER *** [7c 4d 5c Js] [3d]
*** SHOW DOWN ***
Zorzo: shows [Kd Kh] (Pair, KK)
DM0507: shows [Qc Ac] (High card, A)
Zorzo collected $4893 from pot
Zorzo collected $4893 from pot
*** SUMMARY ***
Total pot $10075.00 | Rake $289
Board [7c 4d 5c Js 4s]
Seat 1: Lucifer999 (small blind) folded before Flop
Seat 2: Pablit0 (big blind) folded before Flop
Seat 4: Zorzo  showed [Kd Kh] and won ($4893) with Pair, KK
Seat 6: DM0507 (button) showed [Qc Ac] and lost with High card, A



PokerStars Game #00327564173: Hold'em No Limit ($10/$25 USD) - 2022/04/30 12:57:19 ET
Table 'Hold'em (Min 500Max 2500) 1001' 6-max Seat #3 is the button
Seat 1: HSV ($865.02 in chips) 
Seat 2: Katya_Joule ($2632.73 in chips) 
Seat 3: movetome ($2896.59 in chips) 
Seat 4: devi7 ($2706.71 in chips) 
Seat 5: Lucifer999 ($3013.23 in chips) 
Seat 6: spidy02 ($6457.26 in chips) 
devi7: posts small blind $10
Lucifer999: posts big blind $25
*** HOLE CARDS ***
Dealt to Lucifer999 [3h As]
spidy02: folds
HSV: folds
Katya_Joule: folds
movetome: folds
devi7: folds
Uncalled bet ($15) returned to Lucifer999
Lucifer999: doesn't show hand
Lucifer999 collected $20 from pot
*** SUMMARY ***
Total pot $20.00 | Rake $0
Board []
Seat 1: HSV folded before Flop (didn't bet)
Seat 2: Katya_Joule folded before Flop (didn't bet)
Seat 3: movetome (button) folded before Flop (didn't bet)
Seat 4: devi7 (small blind) folded before Flop
Seat 5: Lucifer999 (big blind) collected ($20)
Seat 6: spidy02 folded before Flop (didn't bet)



PokerStars Game #00327564069: Hold'em No Limit ($10/$25 USD) - 2022/04/30 12:56:46 ET
Table 'Hold'em (Min 500Max 2500)  1282' 6-max Seat #5 is the button
Seat 1: Katya_Joule ($3753.64 in chips) 
Seat 2: Miss_Jammer ($2500 in chips) 
Seat 3: smoker player  ($909.88 in chips) 
Seat 4: Millie ($3451.42 in chips) 
Seat 5: Lucifer999 ($7781.23 in chips) 
Seat 6: jas8k ($2393.29 in chips) 
jas8k: posts small blind $10
Katya_Joule: posts big blind $25
*** HOLE CARDS ***
Dealt to Lucifer999 [2s 7h]
Miss_Jammer: folds
smoker player : calls $25
Millie: folds
Lucifer999: folds
jas8k: calls $15
Katya_Joule: checks
*** FLOP *** [5c Th Jd]
jas8k: checks
Katya_Joule: checks
smoker player : checks
*** TURN *** [5c Th Jd] [5h]
jas8k: checks
Katya_Joule: bets $71.07
smoker player : folds
jas8k: folds
Uncalled bet ($71.07) returned to Katya_Joule
Katya_Joule: doesn't show hand
Katya_Joule collected $71.07 from pot
*** SUMMARY ***
Total pot $75.00 | Rake $3.93
Board [5c Th Jd 5h]
Seat 1: Katya_Joule (big blind) collected ($71.07)
Seat 2: Miss_Jammer folded before Flop (didn't bet)
Seat 3: smoker player  folded on the Turn
Seat 4: Millie folded before Flop (didn't bet)
Seat 5: Lucifer999 (button) folded before Flop (didn't bet)
Seat 6: jas8k (small blind) folded on the Turn



PokerStars Game #00327564196: Hold'em No Limit ($25/$50 USD) - 2022/04/30 12:57:27 ET
Table 'Hold'em (Min 1K Max 5K)   216' 6-max Seat #1 is the button
Seat 1: Lucifer999 ($13113.5 in chips) 
Seat 2: Pablit0 ($950 in chips) 
Seat 4: Zorzo ($9786 in chips) 
Seat 6: DM0507 ($58.25 in chips) 
Pablit0: posts small blind $25
Zorzo: posts big blind $50
*** HOLE CARDS ***
Dealt to Lucifer999 [Kd Th]
DM0507: raises $8.25 to $58.25
Lucifer999: calls $58.25
Pablit0: calls $33.25
Zorzo: calls $8.25
*** FLOP *** [9h 7h 5h]
Pablit0: checks
Zorzo: bets $175
Lucifer999: folds
Pablit0: folds
Uncalled bet ($175) returned to Zorzo
*** TURN *** [9h 7h 5h] [8h]
*** TURN *** [9h 7h 5h] [Ks]
*** RIVER *** [9h 7h 5h 8h] [Jd]
*** RIVER *** [9h 7h 5h 8h] [Jc]
*** SHOW DOWN ***
Zorzo: shows [Jh 6s] (Pair, JJ)
DM0507: shows [Ah 5d] (Pair, 55)
DM0507 collected $110.68 from pot
Zorzo collected $110.67 from pot
*** SUMMARY ***
Total pot $233.00 | Rake $11.65
Board [9h 7h 5h 8h Jd]
Seat 1: Lucifer999 (button) folded on the Flop
Seat 2: Pablit0 (small blind) folded on the Flop
Seat 4: Zorzo  (big blind) showed [Jh 6s] and won ($110.67) with Pair, JJ
Seat 6: DM0507  showed [Ah 5d] and won ($110.68) with Pair, 55



PokerStars Game #00327564179: Hold'em No Limit ($50/$100 USD) - 2022/04/30 12:57:20 ET
Table 'Hold'em (Min 25KMax 10K)    69' 6-max Seat #1 is the button
Seat 1: Lucifer999 ($30408.4 in chips) 
Seat 2: RanveerAJ ($2774.44 in chips) 
Seat 3: vinuth ($23083.2 in chips) 
Seat 4: toreto ($8287.02 in chips) 
Seat 5: tabby20 ($32966.92 in chips) 
Seat 6: manny007 ($3522.89 in chips) 
vinuth: posts small blind $50
toreto: posts big blind $100
*** HOLE CARDS ***
Dealt to Lucifer999 [3c 4d]
tabby20: raises $200.00 to $300
manny007: folds
Lucifer999: folds
vinuth: calls $250
toreto: folds
*** FLOP *** [2c Tc Kh]
vinuth: checks
tabby20: checks
*** TURN *** [2c Tc Kh] [9d]
vinuth: bets $501.9
tabby20: calls $501.9
*** RIVER *** [2c Tc Kh 9d] [Ah]
vinuth: bets $1221.65
tabby20: folds
Uncalled bet ($1221.65) returned to vinuth
vinuth: doesn't show hand
vinuth collected $1628.87 from pot
*** SUMMARY ***
Total pot $1703.80 | Rake $74.93
Board [2c Tc Kh 9d Ah]
Seat 1: Lucifer999 (button) folded before Flop (didn't bet)
Seat 3: vinuth (small blind) collected ($1628.87)
Seat 4: toreto (big blind) folded before Flop
Seat 5: tabby20 folded on the River
Seat 6: manny007 folded before Flop (didn't bet)



PokerStars Game #00327564278: Hold'em No Limit ($25/$50 USD) - 2022/04/30 12:57:57 ET
Table 'Hold'em (Min 1K Max 5K)   216' 6-max Seat #2 is the button
Seat 1: Lucifer999 ($13055.25 in chips) 
Seat 2: Pablit0 ($891.75 in chips) 
Seat 4: Zorzo ($9838.42 in chips) 
Seat 6: DM0507 ($110.68 in chips) 
Zorzo: posts small blind $25
DM0507: posts big blind $50
*** HOLE CARDS ***
Dealt to Lucifer999 [9c Jd]
Lucifer999: folds
Pablit0: folds
Zorzo: raises $50.00 to $100
DM0507: raises $10.68 to $110.68
Zorzo: calls $10.68
*** FLOP *** [9s Td 6s]
*** FLOP *** [7h Js 2h]
*** TURN *** [9s Td 6s] [4c]
*** TURN *** [9s Td 6s] [Ts]
*** RIVER *** [9s Td 6s 4c] [7d]
*** RIVER *** [9s Td 6s 4c] [5s]
*** SHOW DOWN ***
Zorzo: shows [Kh Jc] (Pair, JJ)
DM0507: shows [3c 6d] (High card, J)
DM0507 collected $105.16 from pot
Zorzo collected $105.15 from pot
*** SUMMARY ***
Total pot $221.36 | Rake $11.05
Board [9s Td 6s 4c 7d]
Seat 1: Lucifer999 folded before Flop (didn't bet)
Seat 2: Pablit0 (button) folded before Flop (didn't bet)
Seat 4: Zorzo  (small blind) showed [Kh Jc] and won ($105.15) with Pair, JJ
Seat 6: DM0507  (big blind) showed [3c 6d] and won ($105.16) with High card, J



PokerStars Game #00327564212: Hold'em No Limit ($10/$25 USD) - 2022/04/30 12:57:32 ET
Table 'Hold'em (Min 500Max 2500) 1001' 6-max Seat #4 is the button
Seat 1: HSV ($865.02 in chips) 
Seat 2: Katya_Joule ($2632.73 in chips) 
Seat 3: movetome ($2896.59 in chips) 
Seat 4: devi7 ($2696.71 in chips) 
Seat 5: Lucifer999 ($3023.23 in chips) 
Seat 6: spidy02 ($6457.26 in chips) 
Lucifer999: posts small blind $10
spidy02: posts big blind $25
*** HOLE CARDS ***
Dealt to Lucifer999 [Jh Ad]
HSV: folds
Katya_Joule: folds
movetome: folds
devi7: raises $50.00 to $75
Lucifer999: calls $65
spidy02: folds
*** FLOP *** [3d 3h 8d]
Lucifer999: checks
devi7: checks
*** TURN *** [3d 3h 8d] [Kc]
Lucifer999: checks
devi7: bets $75
Lucifer999: folds
Uncalled bet ($75) returned to devi7
devi7: doesn't show hand
devi7 collected $164.82 from pot
*** SUMMARY ***
Total pot $175.00 | Rake $10.18
Board [3d 3h 8d Kc]
Seat 1: HSV folded before Flop (didn't bet)
Seat 2: Katya_Joule folded before Flop (didn't bet)
Seat 3: movetome folded before Flop (didn't bet)
Seat 4: devi7 (button) collected ($164.82)
Seat 5: Lucifer999 (small blind) folded on the Turn
Seat 6: spidy02 (big blind) folded before Flop



PokerStars Game #00327564358: Hold'em No Limit ($25/$50 USD) - 2022/04/30 12:58:27 ET
Table 'Hold'em (Min 1K Max 5K)   216' 6-max Seat #4 is the button
Seat 1: Lucifer999 ($13055.25 in chips) 
Seat 2: Pablit0 ($891.75 in chips) 
Seat 4: Zorzo ($9832.89 in chips) 
Seat 6: DM0507 ($105.16 in chips) 
DM0507: posts small blind $25
Lucifer999: posts big blind $50
*** HOLE CARDS ***
Dealt to Lucifer999 [Qs 6c]
Pablit0: calls $50
Zorzo: folds
DM0507: calls $25
Lucifer999: checks
*** FLOP *** [2d Kd 8s]
DM0507: bets $55.16
Lucifer999: folds
Pablit0: calls $55.16
*** TURN *** [2d Kd 8s] [6s]
*** TURN *** [2d Kd 8s] [Qc]
*** RIVER *** [2d Kd 8s 6s] [3c]
*** RIVER *** [2d Kd 8s 6s] [Qd]
*** SHOW DOWN ***
Pablit0: shows [Kc 8c] (Two pairs, KKQQ)
DM0507: shows [4d 6d] (Flush, K high)
Pablit0 collected $123.66 from pot
DM0507 collected $123.66 from pot
*** SUMMARY ***
Total pot $260.32 | Rake $13
Board [2d Kd 8s 6s 3c]
Seat 1: Lucifer999 (big blind) folded on the Flop
Seat 2: Pablit0  showed [Kc 8c] and won ($123.66) with Two pairs, KKQQ
Seat 4: Zorzo (button) folded before Flop (didn't bet)
Seat 6: DM0507  (small blind) showed [4d 6d] and won ($123.66) with Flush, K high



PokerStars Game #00327564368: Hold'em No Limit ($10/$25 USD) - 2022/04/30 12:58:30 ET
Table 'Hold'em (Min 500Max 2500) 1001' 6-max Seat #5 is the button
Seat 1: HSV ($865.02 in chips) 
Seat 2: Katya_Joule ($2632.73 in chips) 
Seat 3: movetome ($2896.59 in chips) 
Seat 4: devi7 ($2786.53 in chips) 
Seat 5: Lucifer999 ($2948.23 in chips) 
Seat 6: spidy02 ($6432.26 in chips) 
spidy02: posts small blind $10
HSV: posts big blind $25
*** HOLE CARDS ***
Dealt to Lucifer999 [As 8s]
Katya_Joule: folds
movetome: folds
devi7: raises $50.00 to $75
Lucifer999: calls $75
spidy02: folds
HSV: folds
*** FLOP *** [3d 6c Kh]
devi7: bets $87.15
Lucifer999: folds
Uncalled bet ($87.15) returned to devi7
devi7: doesn't show hand
devi7 collected $174.29 from pot
*** SUMMARY ***
Total pot $185.00 | Rake $10.71
Board [3d 6c Kh]
Seat 1: HSV (big blind) folded before Flop
Seat 2: Katya_Joule folded before Flop (didn't bet)
Seat 3: movetome folded before Flop (didn't bet)
Seat 4: devi7 collected ($174.29)
Seat 5: Lucifer999 (button) folded on the Flop
Seat 6: spidy02 (small blind) folded before Flop



PokerStars Game #00327564310: Hold'em No Limit ($50/$100 USD) - 2022/04/30 12:58:07 ET
Table 'Hold'em (Min 25KMax 10K)    69' 6-max Seat #3 is the button
Seat 1: Lucifer999 ($30408.4 in chips) 
Seat 2: RanveerAJ ($2774.44 in chips) 
Seat 3: vinuth ($23910.17 in chips) 
Seat 4: toreto ($8187.02 in chips) 
Seat 5: tabby20 ($32165.02 in chips) 
Seat 6: manny007 ($3522.89 in chips) 
toreto: posts small blind $50
tabby20: posts big blind $100
RanveerAJ: posts big blind $100
*** HOLE CARDS ***
Dealt to Lucifer999 [Qs Th]
manny007: folds
Lucifer999: folds
RanveerAJ: checks
vinuth: raises $250.00 to $350
toreto: calls $300
tabby20: folds
RanveerAJ: calls $250
*** FLOP *** [5h Jh Ah]
toreto: checks
RanveerAJ: checks
vinuth: checks
*** TURN *** [5h Jh Ah] [5s]
toreto: checks
RanveerAJ: bets $499.7
vinuth: calls $499.7
toreto: folds
*** RIVER *** [5h Jh Ah 5s] [7s]
RanveerAJ: checks
vinuth: checks
*** SHOW DOWN ***
RanveerAJ: shows [Ks Tc] (Pair, 55)
vinuth: shows [Ac 8d] (Two pairs, AA55)
vinuth collected $2054.85 from pot
*** SUMMARY ***
Total pot $2149.40 | Rake $94.55
Board [5h Jh Ah 5s 7s]
Seat 1: Lucifer999 folded before Flop (didn't bet)
Seat 2: RanveerAJ showed [Ks Tc] and lost with Pair, 55
Seat 3: vinuth  (button) showed [Ac 8d] and won ($2054.85) with Two pairs, AA55
Seat 4: toreto (small blind) folded on the Turn
Seat 5: tabby20 (big blind) folded before Flop
Seat 6: manny007 folded before Flop (didn't bet)



PokerStars Game #00327564455: Hold'em No Limit ($25/$50 USD) - 2022/04/30 12:59:05 ET
Table 'Hold'em (Min 1K Max 5K)   216' 6-max Seat #6 is the button
Seat 1: Lucifer999 ($13005.25 in chips) 
Seat 2: Pablit0 ($910.25 in chips) 
Seat 4: Zorzo ($9832.89 in chips) 
Seat 6: DM0507 ($123.66 in chips) 
Lucifer999: posts small blind $25
Pablit0: posts big blind $50
*** HOLE CARDS ***
Dealt to Lucifer999 [Js 8d]
DM0507: raises $73.66 to $123.66
Lucifer999: calls $98.66
Pablit0: folds
*** FLOP *** [Jd Qh Ah]
*** FLOP *** [6d Kh 8h]
*** TURN *** [Jd Qh Ah] [9d]
*** TURN *** [Jd Qh Ah] [Kd]
*** RIVER *** [Jd Qh Ah 9d] [5s]
*** RIVER *** [Jd Qh Ah 9d] [3d]
*** SHOW DOWN ***
Lucifer999: shows [Js 8d] (Two pairs, KK88)
DM0507: shows [Ad Jh] (Pair, KK)
DM0507 collected $141.24 from pot
Lucifer999 collected $141.23 from pot
*** SUMMARY ***
Total pot $297.32 | Rake $14.85
Board [Jd Qh Ah 9d 5s]
Seat 1: Lucifer999  (small blind) showed [Js 8d] and won ($141.23) with Two pairs, KK88
Seat 2: Pablit0 (big blind) folded before Flop
Seat 6: DM0507  (button) showed [Ad Jh] and won ($141.24) with Pair, KK



PokerStars Game #00327564487: Hold'em No Limit ($50/$100 USD) - 2022/04/30 12:59:13 ET
Table 'Hold'em (Min 25KMax 10K)    69' 6-max Seat #4 is the button
Seat 1: Lucifer999 ($30408.4 in chips) 
Seat 2: RanveerAJ ($1924.74 in chips) 
Seat 3: vinuth ($25115.32 in chips) 
Seat 4: toreto ($7904.51 in chips) 
Seat 5: tabby20 ($32065.02 in chips) 
Seat 6: manny007 ($3522.89 in chips) 
tabby20: posts small blind $50
manny007: posts big blind $100
*** HOLE CARDS ***
Dealt to Lucifer999 [5d 7s]
Lucifer999: folds
RanveerAJ: folds
vinuth: folds
toreto: folds
tabby20: folds
Uncalled bet ($50) returned to manny007
manny007: doesn't show hand
manny007 collected $100 from pot
*** SUMMARY ***
Total pot $100.00 | Rake $0
Board []
Seat 1: Lucifer999 folded before Flop (didn't bet)
Seat 2: RanveerAJ folded before Flop (didn't bet)
Seat 3: vinuth folded before Flop (didn't bet)
Seat 4: toreto (button) folded before Flop (didn't bet)
Seat 5: tabby20 (small blind) folded before Flop
Seat 6: manny007 (big blind) collected ($100)



PokerStars Game #00327564282: Hold'em No Limit ($10/$25 USD) - 2022/04/30 12:57:58 ET
Table 'Hold'em (Min 500Max 2500)  1282' 6-max Seat #6 is the button
Seat 1: Katya_Joule ($3799.71 in chips) 
Seat 2: Miss_Jammer ($2500 in chips) 
Seat 3: smoker player  ($884.88 in chips) 
Seat 4: Millie ($3451.42 in chips) 
Seat 5: Lucifer999 ($7781.23 in chips) 
Seat 6: jas8k ($2368.29 in chips) 
Katya_Joule: posts small blind $10
Miss_Jammer: posts big blind $25
*** HOLE CARDS ***
Dealt to Lucifer999 [2s 9h]
smoker player : folds
Millie: raises $60.00 to $85
Lucifer999: folds
jas8k: folds
Katya_Joule: raises $125.00 to $210
Miss_Jammer: calls $185
Millie: calls $125
*** FLOP *** [Qd 4s 8s]
Katya_Joule: checks
Miss_Jammer: checks
Millie: bets $280
Katya_Joule: calls $280
Miss_Jammer: raises $970.00 to $1250
Millie: folds
Katya_Joule: folds
Uncalled bet ($970) returned to Miss_Jammer
Miss_Jammer: doesn't show hand
Miss_Jammer collected $1387.83 from pot
*** SUMMARY ***
Total pot $1470.00 | Rake $82.17
Board [Qd 4s 8s]
Seat 1: Katya_Joule (small blind) folded on the Flop
Seat 2: Miss_Jammer (big blind) collected ($1387.83)
Seat 3: smoker player  folded before Flop (didn't bet)
Seat 4: Millie folded on the Flop
Seat 5: Lucifer999 folded before Flop (didn't bet)
Seat 6: jas8k (button) folded before Flop (didn't bet)



PokerStars Game #00327564457: Hold'em No Limit ($10/$25 USD) - 2022/04/30 12:59:06 ET
Table 'Hold'em (Min 500Max 2500) 1001' 6-max Seat #6 is the button
Seat 1: HSV ($840.02 in chips) 
Seat 2: Katya_Joule ($2632.73 in chips) 
Seat 3: movetome ($2896.59 in chips) 
Seat 4: devi7 ($2885.82 in chips) 
Seat 5: Lucifer999 ($2873.23 in chips) 
Seat 6: spidy02 ($6422.26 in chips) 
HSV: posts small blind $10
Katya_Joule: posts big blind $25
*** HOLE CARDS ***
Dealt to Lucifer999 [Js Td]
movetome: folds
devi7: folds
Lucifer999: raises $55.00 to $80
spidy02: folds
HSV: calls $70
Katya_Joule: folds
*** FLOP *** [5c Qd 6s]
HSV: checks
Lucifer999: bets $85
HSV: calls $85
*** TURN *** [5c Qd 6s] [3s]
HSV: checks
Lucifer999: checks
*** RIVER *** [5c Qd 6s 3s] [Qs]
HSV: checks
Lucifer999: checks
*** SHOW DOWN ***
Lucifer999: shows [Js Td] (Pair, QQ)
HSV: shows [8h 8s] (Two pairs, QQ88)
HSV collected $333.37 from pot
*** SUMMARY ***
Total pot $355.00 | Rake $21.63
Board [5c Qd 6s 3s Qs]
Seat 1: HSV  (small blind) showed [8h 8s] and won ($333.37) with Two pairs, QQ88
Seat 2: Katya_Joule (big blind) folded before Flop
Seat 3: movetome folded before Flop (didn't bet)
Seat 4: devi7 folded before Flop (didn't bet)
Seat 5: Lucifer999 showed [Js Td] and lost with Pair, QQ
Seat 6: spidy02 (button) folded before Flop (didn't bet)



PokerStars Game #00327564540: Hold'em No Limit ($25/$50 USD) - 2022/04/30 12:59:33 ET
Table 'Hold'em (Min 1K Max 5K)   216' 6-max Seat #1 is the button
Seat 1: Lucifer999 ($13022.82 in chips) 
Seat 2: Pablit0 ($860.25 in chips) 
Seat 6: DM0507 ($141.24 in chips) 
Pablit0: posts small blind $25
DM0507: posts big blind $50
*** HOLE CARDS ***
Dealt to Lucifer999 [7s Tc]
Lucifer999: folds
Pablit0: raises $810.25 to $860.25
DM0507: calls $91.24
Uncalled bet ($719.01) returned to Pablit0
*** FLOP *** [Qd 5c 4d]
*** FLOP *** [6d 4h 6s]
*** TURN *** [Qd 5c 4d] [2s]
*** TURN *** [Qd 5c 4d] [Ac]
*** RIVER *** [Qd 5c 4d 2s] [8c]
*** RIVER *** [Qd 5c 4d 2s] [Qc]
*** SHOW DOWN ***
Pablit0: shows [Kd 9c] (Pair, 66)
DM0507: shows [Ad Qs] (Two pairs, AAQQ)
DM0507 collected $134.19 from pot
DM0507 collected $134.19 from pot
*** SUMMARY ***
Total pot $282.48 | Rake $14.1
Board [Qd 5c 4d 2s 8c]
Seat 1: Lucifer999 (button) folded before Flop (didn't bet)
Seat 2: Pablit0 (small blind) showed [Kd 9c] and lost with Pair, 66
Seat 6: DM0507  (big blind) showed [Ad Qs] and won ($134.19) with Two pairs, AAQQ



PokerStars Game #00327564558: Hold'em No Limit ($10/$25 USD) - 2022/04/30 12:59:38 ET
Table 'Hold'em (Min 500Max 2500)  1282' 6-max Seat #1 is the button
Seat 1: Katya_Joule ($3309.71 in chips) 
Seat 2: Miss_Jammer ($3397.83 in chips) 
Seat 3: smoker player  ($884.88 in chips) 
Seat 4: Millie ($2961.42 in chips) 
Seat 5: Lucifer999 ($7781.23 in chips) 
Seat 6: jas8k ($2368.29 in chips) 
Miss_Jammer: posts small blind $10
smoker player : posts big blind $25
*** HOLE CARDS ***
Dealt to Lucifer999 [Ah Js]
Millie: folds
Lucifer999: raises $55.00 to $80
jas8k: folds
Katya_Joule: calls $80
Miss_Jammer: folds
smoker player : folds
*** FLOP *** [7s 4d Td]
Lucifer999: checks
Katya_Joule: bets $122.51
Lucifer999: folds
Uncalled bet ($122.51) returned to Katya_Joule
Katya_Joule: doesn't show hand
Katya_Joule collected $183.77 from pot
*** SUMMARY ***
Total pot $195.00 | Rake $11.23
Board [7s 4d Td]
Seat 1: Katya_Joule (button) collected ($183.77)
Seat 2: Miss_Jammer (small blind) folded before Flop
Seat 3: smoker player  (big blind) folded before Flop
Seat 4: Millie folded before Flop (didn't bet)
Seat 5: Lucifer999 folded on the Flop
Seat 6: jas8k folded before Flop (didn't bet)



PokerStars Game #00327564636: Hold'em No Limit ($25/$50 USD) - 2022/04/30 13:00:03 ET
Table 'Hold'em (Min 1K Max 5K)   216' 6-max Seat #2 is the button
Seat 1: Lucifer999 ($13022.82 in chips) 
Seat 2: Pablit0 ($719.01 in chips) 
Seat 6: DM0507 ($268.38 in chips) 
DM0507: posts small blind $25
Lucifer999: posts big blind $50
*** HOLE CARDS ***
Dealt to Lucifer999 [Kh 6h]
Pablit0: folds
DM0507: raises $218.38 to $268.38
Lucifer999: calls $218.38
*** FLOP *** [7h Tc Ad]
*** FLOP *** [4c 7c 4s]
*** TURN *** [7h Tc Ad] [Jd]
*** TURN *** [7h Tc Ad] [5s]
*** RIVER *** [7h Tc Ad Jd] [8d]
*** RIVER *** [7h Tc Ad Jd] [Qs]
*** SHOW DOWN ***
Lucifer999: shows [Kh 6h] (Pair, 44)
DM0507: shows [Qd 9d] (Two pairs, QQ44)
DM0507 collected $254.98 from pot
DM0507 collected $254.98 from pot
*** SUMMARY ***
Total pot $536.76 | Rake $26.8
Board [7h Tc Ad Jd 8d]
Seat 1: Lucifer999 (big blind) showed [Kh 6h] and lost with Pair, 44
Seat 2: Pablit0 (button) folded before Flop (didn't bet)
Seat 6: DM0507  (small blind) showed [Qd 9d] and won ($254.98) with Two pairs, QQ44



PokerStars Game #00327564548: Hold'em No Limit ($50/$100 USD) - 2022/04/30 12:59:35 ET
Table 'Hold'em (Min 25KMax 10K)    69' 6-max Seat #5 is the button
Seat 1: Lucifer999 ($30408.4 in chips) 
Seat 2: RanveerAJ ($1924.74 in chips) 
Seat 3: vinuth ($25115.32 in chips) 
Seat 4: toreto ($8184.51 in chips) 
Seat 5: tabby20 ($32015.02 in chips) 
Seat 6: manny007 ($3572.89 in chips) 
manny007: posts small blind $50
Lucifer999: posts big blind $100
*** HOLE CARDS ***
Dealt to Lucifer999 [5c 4h]
RanveerAJ: folds
vinuth: raises $250.00 to $350
toreto: folds
tabby20: calls $350
manny007: calls $300
Lucifer999: folds
*** FLOP *** [As Ts Js]
manny007: bets $157.8
vinuth: raises $457.80 to $615.6
tabby20: calls $615.6
manny007: folds
*** TURN *** [As Ts Js] [8c]
vinuth: bets $1213.65
tabby20: calls $1213.65
*** RIVER *** [As Ts Js 8c] [6h]
vinuth: checks
tabby20: checks
*** SHOW DOWN ***
vinuth: shows [7d 8d] (Pair, 88)
tabby20: shows [Ad Jd] (Two pairs, AAJJ)
tabby20 collected $4747.8 from pot
*** SUMMARY ***
Total pot $4966.30 | Rake $218.5
Board [As Ts Js 8c 6h]
Seat 1: Lucifer999 (big blind) folded before Flop
Seat 2: RanveerAJ folded before Flop (didn't bet)
Seat 3: vinuth showed [7d 8d] and lost with Pair, 88
Seat 4: toreto folded before Flop (didn't bet)
Seat 5: tabby20  (button) showed [Ad Jd] and won ($4747.8) with Two pairs, AAJJ
Seat 6: manny007 (small blind) folded on the Flop



PokerStars Game #00327564625: Hold'em No Limit ($10/$25 USD) - 2022/04/30 13:00:01 ET
Table 'Hold'em (Min 500Max 2500) 1001' 6-max Seat #1 is the button
Seat 1: HSV ($1008.39 in chips) 
Seat 2: Katya_Joule ($2607.73 in chips) 
Seat 3: movetome ($2896.59 in chips) 
Seat 4: devi7 ($2885.82 in chips) 
Seat 5: Lucifer999 ($2708.23 in chips) 
Seat 6: spidy02 ($6422.26 in chips) 
Katya_Joule: posts small blind $10
movetome: posts big blind $25
*** HOLE CARDS ***
Dealt to Lucifer999 [5h 4c]
devi7: folds
Lucifer999: folds
spidy02: calls $25
HSV: calls $25
Katya_Joule: calls $15
movetome: checks
*** FLOP *** [Ac 8s Qc]
Katya_Joule: checks
movetome: checks
spidy02: checks
HSV: bets $70.31
Katya_Joule: folds
movetome: folds
spidy02: folds
Uncalled bet ($70.31) returned to HSV
HSV: doesn't show hand
HSV collected $93.75 from pot
*** SUMMARY ***
Total pot $100.00 | Rake $6.25
Board [Ac 8s Qc]
Seat 1: HSV (button) collected ($93.75)
Seat 2: Katya_Joule (small blind) folded on the Flop
Seat 3: movetome (big blind) folded on the Flop
Seat 4: devi7 folded before Flop (didn't bet)
Seat 5: Lucifer999 folded before Flop (didn't bet)
Seat 6: spidy02 folded on the Flop



PokerStars Game #00327564708: Hold'em No Limit ($25/$50 USD) - 2022/04/30 13:00:32 ET
Table 'Hold'em (Min 1K Max 5K)   216' 6-max Seat #1 is the button
Seat 1: Lucifer999 ($12754.44 in chips) 
Seat 2: Pablit0 ($719.01 in chips) 
Seat 6: DM0507 ($509.96 in chips) 
Lucifer999: posts small blind $25
DM0507: posts big blind $50
*** HOLE CARDS ***
Dealt to Lucifer999 [Ac Qh]
Lucifer999: calls $25
DM0507: raises $459.96 to $509.96
Lucifer999: calls $459.96
*** FLOP *** [Js 5d As]
*** FLOP *** [7d 4h 7h]
*** TURN *** [Js 5d As] [9c]
*** TURN *** [Js 5d As] [Jh]
*** RIVER *** [Js 5d As 9c] [Ks]
*** RIVER *** [Js 5d As 9c] [Qd]
*** SHOW DOWN ***
Lucifer999: shows [Ac Qh] (Two pairs, QQ77)
DM0507: shows [Ts Qc] (Two pairs, QQ77)
DM0507 collected $487.04 from pot
Lucifer999 collected $487.03 from pot
*** SUMMARY ***
Total pot $1019.92 | Rake $45.85
Board [Js 5d As 9c Ks]
Seat 1: Lucifer999  (button) (small blind) showed [Ac Qh] and won ($487.03) with Two pairs, QQ77
Seat 6: DM0507  (big blind) showed [Ts Qc] and won ($487.04) with Two pairs, QQ77



PokerStars Game #00327564694: Hold'em No Limit ($10/$25 USD) - 2022/04/30 13:00:27 ET
Table 'Hold'em (Min 500Max 2500)  1282' 6-max Seat #2 is the button
Seat 1: Katya_Joule ($3413.48 in chips) 
Seat 2: Miss_Jammer ($3387.83 in chips) 
Seat 3: smoker player  ($859.88 in chips) 
Seat 4: Millie ($2961.42 in chips) 
Seat 5: Lucifer999 ($7701.23 in chips) 
Seat 6: jas8k ($2368.29 in chips) 
smoker player : posts small blind $10
Millie: posts big blind $25
*** HOLE CARDS ***
Dealt to Lucifer999 [Qd 7s]
Lucifer999: folds
jas8k: calls $25
Katya_Joule: raises $85.00 to $110
Miss_Jammer: folds
smoker player : folds
Millie: folds
jas8k: folds
Uncalled bet ($85) returned to Katya_Joule
Katya_Joule: doesn't show hand
Katya_Joule collected $85 from pot
*** SUMMARY ***
Total pot $85.00 | Rake $0
Board []
Seat 1: Katya_Joule collected ($85)
Seat 2: Miss_Jammer (button) folded before Flop (didn't bet)
Seat 3: smoker player  (small blind) folded before Flop
Seat 4: Millie (big blind) folded before Flop
Seat 5: Lucifer999 folded before Flop (didn't bet)
Seat 6: jas8k folded before Flop



PokerStars Game #00327564767: Hold'em No Limit ($25/$50 USD) - 2022/04/30 13:00:55 ET
Table 'Hold'em (Min 1K Max 5K)   216' 6-max Seat #6 is the button
Seat 1: Lucifer999 ($12731.51 in chips) 
Seat 2: Pablit0 ($719.01 in chips) 
Seat 6: DM0507 ($487.04 in chips) 
DM0507: posts small blind $25
Lucifer999: posts big blind $50
*** HOLE CARDS ***
Dealt to Lucifer999 [2s Ah]
DM0507: raises $437.04 to $487.04
Lucifer999: calls $437.04
*** FLOP *** [Kd 3s 7h]
*** FLOP *** [9d Ad 2c]
*** TURN *** [Kd 3s 7h] [Qh]
*** TURN *** [Kd 3s 7h] [Jc]
*** RIVER *** [Kd 3s 7h Qh] [Td]
*** RIVER *** [Kd 3s 7h Qh] [Qd]
*** SHOW DOWN ***
Lucifer999: shows [2s Ah] (Two pairs, AA22)
DM0507: shows [6c 6h] (Pair, 66)
DM0507 collected $465.13 from pot
Lucifer999 collected $465.12 from pot
*** SUMMARY ***
Total pot $974.08 | Rake $43.83
Board [Kd 3s 7h Qh Td]
Seat 1: Lucifer999  (big blind) showed [2s Ah] and won ($465.12) with Two pairs, AA22
Seat 6: DM0507  (button) (small blind) showed [6c 6h] and won ($465.13) with Pair, 66



PokerStars Game #00327564829: Hold'em No Limit ($25/$50 USD) - 2022/04/30 13:01:16 ET
Table 'Hold'em (Min 1K Max 5K)   216' 6-max Seat #1 is the button
Seat 1: Lucifer999 ($12709.59 in chips) 
Seat 2: Pablit0 ($719.01 in chips) 
Seat 6: DM0507 ($465.13 in chips) 
Lucifer999: posts small blind $25
DM0507: posts big blind $50
*** HOLE CARDS ***
Dealt to Lucifer999 [8h 2d]
Lucifer999: folds
Uncalled bet ($25) returned to DM0507
DM0507: doesn't show hand
DM0507 collected $50 from pot
*** SUMMARY ***
Total pot $50.00 | Rake $0
Board []
Seat 1: Lucifer999 (button) (small blind) folded before Flop
Seat 6: DM0507 (big blind) collected ($50)



PokerStars Game #00327564759: Hold'em No Limit ($10/$25 USD) - 2022/04/30 13:00:53 ET
Table 'Hold'em (Min 500Max 2500) 1001' 6-max Seat #2 is the button
Seat 1: HSV ($1077.14 in chips) 
Seat 2: Katya_Joule ($2582.73 in chips) 
Seat 3: movetome ($2871.59 in chips) 
Seat 4: devi7 ($2885.82 in chips) 
Seat 5: Lucifer999 ($2708.23 in chips) 
Seat 6: spidy02 ($6397.26 in chips) 
movetome: posts small blind $10
devi7: posts big blind $25
*** HOLE CARDS ***
Dealt to Lucifer999 [Qs 9d]
Lucifer999: folds
spidy02: folds
HSV: raises $38.75 to $63.75
Katya_Joule: folds
movetome: raises $136.25 to $200
devi7: folds
HSV: calls $136.25
*** FLOP *** [9h Td 5s]
movetome: bets $325
HSV: calls $325
*** TURN *** [9h Td 5s] [Tc]
movetome: bets $2346.59
HSV: calls $552.14
Uncalled bet ($1794.45) returned to movetome
*** RIVER *** [9h Td 5s Tc] [7d]
*** SHOW DOWN ***
HSV: shows [Th Jh] (Three of a kind, TTT)
movetome: shows [Ks Ac] (Pair, TT)
HSV collected $2059.89 from pot
*** SUMMARY ***
Total pot $2179.28 | Rake $119.39
Board [9h Td 5s Tc 7d]
Seat 1: HSV  showed [Th Jh] and won ($2059.89) with Three of a kind, TTT
Seat 2: Katya_Joule (button) folded before Flop (didn't bet)
Seat 3: movetome (small blind) showed [Ks Ac] and lost with Pair, TT
Seat 4: devi7 (big blind) folded before Flop
Seat 5: Lucifer999 folded before Flop (didn't bet)
Seat 6: spidy02 folded before Flop (didn't bet)



PokerStars Game #00327564794: Hold'em No Limit ($10/$25 USD) - 2022/04/30 13:01:02 ET
Table 'Hold'em (Min 500Max 2500)  1282' 6-max Seat #3 is the button
Seat 1: Katya_Joule ($3473.48 in chips) 
Seat 2: Miss_Jammer ($3387.83 in chips) 
Seat 3: smoker player  ($849.88 in chips) 
Seat 4: Millie ($2936.42 in chips) 
Seat 5: Lucifer999 ($7701.23 in chips) 
Seat 6: jas8k ($2343.29 in chips) 
Millie: posts small blind $10
Lucifer999: posts big blind $25
*** HOLE CARDS ***
Dealt to Lucifer999 [8s 7h]
jas8k: calls $25
Katya_Joule: raises $85.00 to $110
Miss_Jammer: folds
smoker player : folds
Millie: folds
Lucifer999: folds
jas8k: folds
Uncalled bet ($85) returned to Katya_Joule
Katya_Joule: doesn't show hand
Katya_Joule collected $85 from pot
*** SUMMARY ***
Total pot $85.00 | Rake $0
Board []
Seat 1: Katya_Joule collected ($85)
Seat 2: Miss_Jammer folded before Flop (didn't bet)
Seat 3: smoker player  (button) folded before Flop (didn't bet)
Seat 4: Millie (small blind) folded before Flop
Seat 5: Lucifer999 (big blind) folded before Flop
Seat 6: jas8k folded before Flop



PokerStars Game #00327564728: Hold'em No Limit ($50/$100 USD) - 2022/04/30 13:00:37 ET
Table 'Hold'em (Min 25KMax 10K)    69' 6-max Seat #6 is the button
Seat 1: Lucifer999 ($30308.4 in chips) 
Seat 2: RanveerAJ ($1924.74 in chips) 
Seat 3: vinuth ($22936.07 in chips) 
Seat 4: toreto ($8184.51 in chips) 
Seat 5: tabby20 ($34583.57 in chips) 
Seat 6: manny007 ($3065.09 in chips) 
Lucifer999: posts small blind $50
RanveerAJ: posts big blind $100
*** HOLE CARDS ***
Dealt to Lucifer999 [9c Qd]
vinuth: folds
toreto: folds
tabby20: raises $200.00 to $300
manny007: calls $300
Lucifer999: folds
RanveerAJ: calls $200
*** FLOP *** [As 8d Tc]
RanveerAJ: bets $404.1
tabby20: calls $404.1
manny007: folds
*** TURN *** [As 8d Tc] [Kh]
RanveerAJ: checks
tabby20: checks
*** RIVER *** [As 8d Tc Kh] [2d]
RanveerAJ: checks
tabby20: bets $650
RanveerAJ: folds
Uncalled bet ($650) returned to tabby20
tabby20: doesn't show hand
tabby20 collected $1680.85 from pot
*** SUMMARY ***
Total pot $1758.20 | Rake $77.35
Board [As 8d Tc Kh 2d]
Seat 1: Lucifer999 (small blind) folded before Flop
Seat 2: RanveerAJ (big blind) folded on the River
Seat 3: vinuth folded before Flop (didn't bet)
Seat 4: toreto folded before Flop (didn't bet)
Seat 5: tabby20 collected ($1680.85)
Seat 6: manny007 (button) folded on the Flop



PokerStars Game #00327564902: Hold'em No Limit ($50/$100 USD) - 2022/04/30 13:01:41 ET
Table 'Hold'em (Min 25KMax 10K)    69' 6-max Seat #1 is the button
Seat 1: Lucifer999 ($30258.4 in chips) 
Seat 2: RanveerAJ ($1220.64 in chips) 
Seat 3: vinuth ($22936.07 in chips) 
Seat 4: toreto ($8184.51 in chips) 
Seat 5: tabby20 ($35560.32 in chips) 
Seat 6: manny007 ($2765.09 in chips) 
RanveerAJ: posts small blind $50
toreto: posts big blind $100
*** HOLE CARDS ***
Dealt to Lucifer999 [6s 6d]
tabby20: folds
manny007: folds
Lucifer999: folds
RanveerAJ: calls $50
toreto: checks
*** FLOP *** [8d 2s Qs]
RanveerAJ: bets $191.2
toreto: calls $191.2
*** TURN *** [8d 2s Qs] [Ks]
RanveerAJ: bets $278.4
toreto: calls $278.4
*** RIVER *** [8d 2s Qs Ks] [Qh]
RanveerAJ: checks
toreto: checks
*** SHOW DOWN ***
RanveerAJ: shows [Jh Jd] (Two pairs, QQJJ)
toreto: doesn't show hand
RanveerAJ collected $1089.09 from pot
*** SUMMARY ***
Total pot $1139.20 | Rake $50.11
Board [8d 2s Qs Ks Qh]
Seat 1: Lucifer999 (button) folded before Flop (didn't bet)
Seat 2: RanveerAJ  (small blind) showed [Jh Jd] and won ($1089.09) with Two pairs, QQJJ
Seat 4: toreto (big blind) mucked
Seat 5: tabby20 folded before Flop (didn't bet)
Seat 6: manny007 folded before Flop (didn't bet)



PokerStars Game #00327564866: Hold'em No Limit ($10/$25 USD) - 2022/04/30 13:01:32 ET
Table 'Hold'em (Min 500Max 2500) 1001' 6-max Seat #3 is the button
Seat 1: HSV ($2059.89 in chips) 
Seat 2: Katya_Joule ($2582.73 in chips) 
Seat 3: movetome ($2500 in chips) 
Seat 4: devi7 ($2860.82 in chips) 
Seat 5: Lucifer999 ($2708.23 in chips) 
Seat 6: spidy02 ($6397.26 in chips) 
devi7: posts small blind $10
Lucifer999: posts big blind $25
*** HOLE CARDS ***
Dealt to Lucifer999 [Qh 3s]
spidy02: calls $25
HSV: folds
Katya_Joule: raises $85.00 to $110
movetome: folds
devi7: folds
Lucifer999: folds
spidy02: calls $85
*** FLOP *** [6d 7s 4s]
spidy02: checks
Katya_Joule: bets $159.75
spidy02: folds
Uncalled bet ($159.75) returned to Katya_Joule
Katya_Joule: doesn't show hand
Katya_Joule collected $239.62 from pot
*** SUMMARY ***
Total pot $255.00 | Rake $15.38
Board [6d 7s 4s]
Seat 1: HSV folded before Flop (didn't bet)
Seat 2: Katya_Joule collected ($239.62)
Seat 3: movetome (button) folded before Flop (didn't bet)
Seat 4: devi7 (small blind) folded before Flop
Seat 5: Lucifer999 (big blind) folded before Flop
Seat 6: spidy02 folded on the Flop



PokerStars Game #00327564848: Hold'em No Limit ($25/$50 USD) - 2022/04/30 13:01:25 ET
Table 'Hold'em (Min 1K Max 5K)   216' 6-max Seat #6 is the button
Seat 1: Lucifer999 ($12684.59 in chips) 
Seat 2: Pablit0 ($719.01 in chips) 
Seat 6: DM0507 ($490.13 in chips) 
DM0507: posts small blind $25
Lucifer999: posts big blind $50
*** HOLE CARDS ***
Dealt to Lucifer999 [Qs 3h]
DM0507: calls $25
Lucifer999: raises $100.00 to $150
DM0507: calls $100
*** FLOP *** [3c As 5s]
Lucifer999: bets $400
DM0507: folds
Uncalled bet ($400) returned to Lucifer999
Lucifer999: doesn't show hand
Lucifer999 collected $286.5 from pot
*** SUMMARY ***
Total pot $300.00 | Rake $13.5
Board [3c As 5s]
Seat 1: Lucifer999 (big blind) collected ($286.5)
Seat 6: DM0507 (button) (small blind) folded on the Flop



PokerStars Game #00327565039: Hold'em No Limit ($50/$100 USD) - 2022/04/30 13:02:23 ET
Table 'Hold'em (Min 25KMax 10K)    69' 6-max Seat #2 is the button
Seat 1: Lucifer999 ($30258.4 in chips) 
Seat 2: RanveerAJ ($1740.13 in chips) 
Seat 3: vinuth ($22936.07 in chips) 
Seat 4: toreto ($7614.91 in chips) 
Seat 5: tabby20 ($35560.32 in chips) 
Seat 6: manny007 ($2765.09 in chips) 
toreto: posts small blind $50
tabby20: posts big blind $100
*** HOLE CARDS ***
Dealt to Lucifer999 [Jd 9c]
manny007: calls $100
Lucifer999: folds
RanveerAJ: raises $100.00 to $200
toreto: folds
tabby20: folds
manny007: raises $550.00 to $750
RanveerAJ: calls $550
*** FLOP *** [8d 9d 7d]
manny007: bets $788.7
RanveerAJ: raises $201.43 to $990.13
manny007: calls $201.43
*** TURN *** [8d 9d 7d] [5s]
*** TURN *** [8d 9d 7d] [Ks]
*** RIVER *** [8d 9d 7d 5s] [8c]
*** RIVER *** [8d 9d 7d 5s] [7c]
*** SHOW DOWN ***
RanveerAJ: shows [3c Ad] (Pair, 77)
manny007: shows [Qh Ah] (Pair, 77)
manny007 collected $1735.27 from pot
manny007 collected $1735.27 from pot
*** SUMMARY ***
Total pot $3630.26 | Rake $159.72
Board [8d 9d 7d 5s 8c]
Seat 1: Lucifer999 folded before Flop (didn't bet)
Seat 2: RanveerAJ (button) showed [3c Ad] and lost with Pair, 77
Seat 4: toreto (small blind) folded before Flop
Seat 5: tabby20 (big blind) folded before Flop
Seat 6: manny007  showed [Qh Ah] and won ($1735.27) with Pair, 77



PokerStars Game #00327565133: Hold'em No Limit ($25/$50 USD) - 2022/04/30 13:02:57 ET
Table 'Hold'em (Min 1K Max 5K)   216' 6-max Seat #1 is the button
Seat 1: Lucifer999 ($12821.09 in chips) 
Seat 2: Pablit0 ($719.01 in chips) 
Seat 6: DM0507 ($340.13 in chips) 
Lucifer999: posts small blind $25
DM0507: posts big blind $50
*** HOLE CARDS ***
Dealt to Lucifer999 [3c 6s]
Lucifer999: folds
Uncalled bet ($25) returned to DM0507
DM0507: doesn't show hand
DM0507 collected $50 from pot
*** SUMMARY ***
Total pot $50.00 | Rake $0
Board []
Seat 1: Lucifer999 (button) (small blind) folded before Flop
Seat 6: DM0507 (big blind) collected ($50)



PokerStars Game #00327564885: Hold'em No Limit ($10/$25 USD) - 2022/04/30 13:01:38 ET
Table 'Hold'em (Min 500Max 2500)  1282' 6-max Seat #4 is the button
Seat 1: Katya_Joule ($3533.48 in chips) 
Seat 2: Miss_Jammer ($3387.83 in chips) 
Seat 3: smoker player  ($849.88 in chips) 
Seat 4: Millie ($2926.42 in chips) 
Seat 5: Lucifer999 ($7676.23 in chips) 
Seat 6: jas8k ($2318.29 in chips) 
Lucifer999: posts small blind $10
jas8k: posts big blind $25
*** HOLE CARDS ***
Dealt to Lucifer999 [3d 9d]
Katya_Joule: folds
Miss_Jammer: folds
smoker player : calls $25
Millie: raises $85.00 to $110
Lucifer999: folds
jas8k: folds
smoker player : folds
Uncalled bet ($85) returned to Millie
Millie: doesn't show hand
Millie collected $85 from pot
*** SUMMARY ***
Total pot $85.00 | Rake $0
Board []
Seat 1: Katya_Joule folded before Flop (didn't bet)
Seat 2: Miss_Jammer folded before Flop (didn't bet)
Seat 3: smoker player  folded before Flop
Seat 4: Millie (button) collected ($85)
Seat 5: Lucifer999 (small blind) folded before Flop
Seat 6: jas8k (big blind) folded before Flop



PokerStars Game #00327565092: Hold'em No Limit ($10/$25 USD) - 2022/04/30 13:02:43 ET
Table 'Hold'em (Min 500Max 2500) 1001' 6-max Seat #4 is the button
Seat 1: HSV ($2059.89 in chips) 
Seat 2: Katya_Joule ($2712.35 in chips) 
Seat 3: movetome ($2500 in chips) 
Seat 4: devi7 ($2850.82 in chips) 
Seat 5: Lucifer999 ($2683.23 in chips) 
Seat 6: spidy02 ($6287.26 in chips) 
Lucifer999: posts small blind $10
spidy02: posts big blind $25
*** HOLE CARDS ***
Dealt to Lucifer999 [Th 7d]
HSV: calls $25
Katya_Joule: folds
movetome: folds
devi7: folds
Lucifer999: folds
spidy02: checks
*** FLOP *** [4c Jh 4d]
spidy02: checks
HSV: checks
*** TURN *** [4c Jh 4d] [Kc]
spidy02: checks
HSV: bets $56.85
spidy02: calls $56.85
*** RIVER *** [4c Jh 4d Kc] [9s]
spidy02: checks
HSV: bets $163.62
spidy02: folds
Uncalled bet ($163.62) returned to HSV
HSV: doesn't show hand
HSV collected $163.62 from pot
*** SUMMARY ***
Total pot $173.70 | Rake $10.08
Board [4c Jh 4d Kc 9s]
Seat 1: HSV collected ($163.62)
Seat 2: Katya_Joule folded before Flop (didn't bet)
Seat 3: movetome folded before Flop (didn't bet)
Seat 4: devi7 (button) folded before Flop (didn't bet)
Seat 5: Lucifer999 (small blind) folded before Flop
Seat 6: spidy02 (big blind) folded on the River



PokerStars Game #00327565182: Hold'em No Limit ($25/$50 USD) - 2022/04/30 13:03:11 ET
Table 'Hold'em (Min 1K Max 5K)   216' 6-max Seat #6 is the button
Seat 1: Lucifer999 ($12796.09 in chips) 
Seat 2: Pablit0 ($719.01 in chips) 
Seat 6: DM0507 ($365.13 in chips) 
DM0507: posts small blind $25
Lucifer999: posts big blind $50
*** HOLE CARDS ***
Dealt to Lucifer999 [8s 5c]
DM0507: raises $315.13 to $365.13
Lucifer999: folds
Uncalled bet ($315.13) returned to DM0507
DM0507: doesn't show hand
DM0507 collected $100 from pot
*** SUMMARY ***
Total pot $100.00 | Rake $0
Board []
Seat 1: Lucifer999 (big blind) folded before Flop
Seat 6: DM0507 (button) (small blind) collected ($100)



PokerStars Game #00327565275: Hold'em No Limit ($25/$50 USD) - 2022/04/30 13:03:41 ET
Table 'Hold'em (Min 1K Max 5K)   216' 6-max Seat #1 is the button
Seat 1: Lucifer999 ($12746.09 in chips) 
Seat 2: Pablit0 ($719.01 in chips) 
Seat 6: DM0507 ($415.13 in chips) 
Lucifer999: posts small blind $25
DM0507: posts big blind $50
*** HOLE CARDS ***
Dealt to Lucifer999 [6c 2s]
Lucifer999: folds
Uncalled bet ($25) returned to DM0507
DM0507: doesn't show hand
DM0507 collected $50 from pot
*** SUMMARY ***
Total pot $50.00 | Rake $0
Board []
Seat 1: Lucifer999 (button) (small blind) folded before Flop
Seat 6: DM0507 (big blind) collected ($50)



PokerStars Game #00327565175: Hold'em No Limit ($50/$100 USD) - 2022/04/30 13:03:09 ET
Table 'Hold'em (Min 25KMax 10K)    69' 6-max Seat #4 is the button
Seat 1: Lucifer999 ($30258.4 in chips) 
Seat 3: vinuth ($22936.07 in chips) 
Seat 4: toreto ($7564.91 in chips) 
Seat 5: tabby20 ($35460.32 in chips) 
Seat 6: manny007 ($4495.5 in chips) 
tabby20: posts small blind $50
manny007: posts big blind $100
*** HOLE CARDS ***
Dealt to Lucifer999 [4d 8d]
Lucifer999: folds
toreto: raises $100.00 to $200
tabby20: calls $150
manny007: calls $100
*** FLOP *** [9s Qc 2d]
tabby20: checks
manny007: bets $329.73
toreto: calls $329.73
tabby20: folds
*** TURN *** [9s Qc 2d] [2h]
manny007: checks
toreto: bets $602.04
manny007: folds
Uncalled bet ($602.04) returned to toreto
toreto: doesn't show hand
toreto collected $1204.07 from pot
*** SUMMARY ***
Total pot $1259.46 | Rake $55.39
Board [9s Qc 2d 2h]
Seat 1: Lucifer999 folded before Flop (didn't bet)
Seat 4: toreto (button) collected ($1204.07)
Seat 5: tabby20 (small blind) folded on the Flop
Seat 6: manny007 (big blind) folded on the Turn



PokerStars Game #00327565244: Hold'em No Limit ($10/$25 USD) - 2022/04/30 13:03:32 ET
Table 'Hold'em (Min 500Max 2500)  1282' 6-max Seat #5 is the button
Seat 1: Katya_Joule ($3533.48 in chips) 
Seat 2: Miss_Jammer ($3387.83 in chips) 
Seat 3: smoker player  ($824.88 in chips) 
Seat 4: Millie ($2986.42 in chips) 
Seat 5: Lucifer999 ($7666.23 in chips) 
Seat 6: jas8k ($2293.29 in chips) 
jas8k: posts small blind $10
Katya_Joule: posts big blind $25
*** HOLE CARDS ***
Dealt to Lucifer999 [4s Jd]
Miss_Jammer: folds
smoker player : folds
Millie: folds
Lucifer999: folds
jas8k: folds
Uncalled bet ($15) returned to Katya_Joule
Katya_Joule: doesn't show hand
Katya_Joule collected $20 from pot
*** SUMMARY ***
Total pot $20.00 | Rake $0
Board []
Seat 1: Katya_Joule (big blind) collected ($20)
Seat 2: Miss_Jammer folded before Flop (didn't bet)
Seat 3: smoker player  folded before Flop (didn't bet)
Seat 4: Millie folded before Flop (didn't bet)
Seat 5: Lucifer999 (button) folded before Flop (didn't bet)
Seat 6: jas8k (small blind) folded before Flop



PokerStars Game #00327565276: Hold'em No Limit ($10/$25 USD) - 2022/04/30 13:03:41 ET
Table 'Hold'em (Min 500Max 2500) 1001' 6-max Seat #5 is the button
Seat 1: HSV ($2141.66 in chips) 
Seat 2: Katya_Joule ($2712.35 in chips) 
Seat 3: movetome ($2500 in chips) 
Seat 4: devi7 ($2850.82 in chips) 
Seat 5: Lucifer999 ($2673.23 in chips) 
Seat 6: spidy02 ($6205.41 in chips) 
spidy02: posts small blind $10
HSV: posts big blind $25
*** HOLE CARDS ***
Dealt to Lucifer999 [8h 4s]
Katya_Joule: folds
movetome: folds
devi7: raises $50.00 to $75
Lucifer999: folds
spidy02: folds
HSV: calls $50
*** FLOP *** [Ah 2d Js]
HSV: checks
devi7: checks
*** TURN *** [Ah 2d Js] [4c]
HSV: checks
devi7: checks
*** RIVER *** [Ah 2d Js 4c] [8c]
HSV: bets $150.6
devi7: folds
Uncalled bet ($150.6) returned to HSV
HSV: doesn't show hand
HSV collected $150.6 from pot
*** SUMMARY ***
Total pot $160.00 | Rake $9.4
Board [Ah 2d Js 4c 8c]
Seat 1: HSV (big blind) collected ($150.6)
Seat 2: Katya_Joule folded before Flop (didn't bet)
Seat 3: movetome folded before Flop (didn't bet)
Seat 4: devi7 folded on the River
Seat 5: Lucifer999 (button) folded before Flop (didn't bet)
Seat 6: spidy02 (small blind) folded before Flop



PokerStars Game #00327565315: Hold'em No Limit ($25/$50 USD) - 2022/04/30 13:03:54 ET
Table 'Hold'em (Min 1K Max 5K)   216' 6-max Seat #6 is the button
Seat 1: Lucifer999 ($12721.09 in chips) 
Seat 2: Pablit0 ($719.01 in chips) 
Seat 6: DM0507 ($440.13 in chips) 
DM0507: posts small blind $25
Lucifer999: posts big blind $50
*** HOLE CARDS ***
Dealt to Lucifer999 [3c Qh]
DM0507: calls $25
Lucifer999: raises $450.00 to $500
DM0507: calls $390.13
Uncalled bet ($59.87) returned to Lucifer999
*** FLOP *** [5s 3d 2h]
*** FLOP *** [4h 6h 5h]
*** TURN *** [5s 3d 2h] [4s]
*** TURN *** [5s 3d 2h] [5d]
*** RIVER *** [5s 3d 2h 4s] [Jd]
*** RIVER *** [5s 3d 2h 4s] [7c]
*** SHOW DOWN ***
Lucifer999: shows [3c Qh] (Straight, 7-3)
DM0507: shows [Qs 6c] (Two pairs, 6655)
DM0507 collected $420.33 from pot
Lucifer999 collected $420.33 from pot
*** SUMMARY ***
Total pot $880.26 | Rake $39.6
Board [5s 3d 2h 4s Jd]
Seat 1: Lucifer999  (big blind) showed [3c Qh] and won ($420.33) with Straight, 7-3
Seat 6: DM0507  (button) (small blind) showed [Qs 6c] and won ($420.33) with Two pairs, 6655



PokerStars Game #00327565337: Hold'em No Limit ($50/$100 USD) - 2022/04/30 13:04:03 ET
Table 'Hold'em (Min 25KMax 10K)    69' 6-max Seat #5 is the button
Seat 1: Lucifer999 ($30258.4 in chips) 
Seat 3: vinuth ($22936.07 in chips) 
Seat 4: toreto ($8239.25 in chips) 
Seat 5: tabby20 ($35260.32 in chips) 
Seat 6: manny007 ($3965.77 in chips) 
manny007: posts small blind $50
Lucifer999: posts big blind $100
*** HOLE CARDS ***
Dealt to Lucifer999 [7h 3c]
toreto: folds
tabby20: raises $200.00 to $300
manny007: folds
Lucifer999: folds
Uncalled bet ($200) returned to tabby20
tabby20: doesn't show hand
tabby20 collected $250 from pot
*** SUMMARY ***
Total pot $250.00 | Rake $0
Board []
Seat 1: Lucifer999 (big blind) folded before Flop
Seat 4: toreto folded before Flop (didn't bet)
Seat 5: tabby20 (button) collected ($250)
Seat 6: manny007 (small blind) folded before Flop



PokerStars Game #00327565473: Hold'em No Limit ($25/$50 USD) - 2022/04/30 13:04:47 ET
Table 'Hold'em (Min 1K Max 5K)   216' 6-max Seat #1 is the button
Seat 1: Lucifer999 ($12701.29 in chips) 
Seat 2: Pablit0 ($719.01 in chips) 
Seat 6: DM0507 ($420.33 in chips) 
Lucifer999: posts small blind $25
DM0507: posts big blind $50
*** HOLE CARDS ***
Dealt to Lucifer999 [9s As]
Lucifer999: raises $450.00 to $500
DM0507: calls $370.33
Uncalled bet ($79.67) returned to Lucifer999
*** FLOP *** [Ad Th 3d]
*** FLOP *** [6c 5h 7h]
*** TURN *** [Ad Th 3d] [9d]
*** TURN *** [Ad Th 3d] [Jc]
*** RIVER *** [Ad Th 3d 9d] [Kd]
*** RIVER *** [Ad Th 3d 9d] [4s]
*** SHOW DOWN ***
Lucifer999: shows [9s As] (High card, A)
DM0507: shows [5c Tc] (Pair, 55)
Lucifer999 collected $401.43 from pot
DM0507 collected $401.43 from pot
*** SUMMARY ***
Total pot $840.66 | Rake $37.8
Board [Ad Th 3d 9d Kd]
Seat 1: Lucifer999  (button) (small blind) showed [9s As] and won ($401.43) with High card, A
Seat 6: DM0507  (big blind) showed [5c Tc] and won ($401.43) with Pair, 55



PokerStars Game #00327565437: Hold'em No Limit ($10/$25 USD) - 2022/04/30 13:04:36 ET
Table 'Hold'em (Min 500Max 2500) 1001' 6-max Seat #6 is the button
Seat 1: HSV ($2217.26 in chips) 
Seat 2: Katya_Joule ($2712.35 in chips) 
Seat 3: movetome ($2500 in chips) 
Seat 4: devi7 ($2775.82 in chips) 
Seat 5: Lucifer999 ($2673.23 in chips) 
Seat 6: spidy02 ($6195.41 in chips) 
HSV: posts small blind $10
Katya_Joule: posts big blind $25
*** HOLE CARDS ***
Dealt to Lucifer999 [Kd 8c]
movetome: raises $50.00 to $75
devi7: calls $75
Lucifer999: folds
spidy02: calls $75
HSV: folds
Katya_Joule: folds
*** FLOP *** [5s 6h 7d]
movetome: bets $175
devi7: folds
spidy02: raises $209.68 to $384.68
movetome: calls $209.68
*** TURN *** [5s 6h 7d] [9d]
movetome: checks
spidy02: checks
*** RIVER *** [5s 6h 7d 9d] [2c]
movetome: checks
spidy02: checks
*** SHOW DOWN ***
spidy02: shows [6s 7s] (Two pairs, 7766)
movetome: doesn't show hand
spidy02 collected $970.34 from pot
*** SUMMARY ***
Total pot $1029.36 | Rake $59.02
Board [5s 6h 7d 9d 2c]
Seat 1: HSV (small blind) folded before Flop
Seat 2: Katya_Joule (big blind) folded before Flop
Seat 3: movetome mucked
Seat 4: devi7 folded on the Flop
Seat 5: Lucifer999 folded before Flop (didn't bet)
Seat 6: spidy02  (button) showed [6s 7s] and won ($970.34) with Two pairs, 7766



PokerStars Game #00327565342: Hold'em No Limit ($10/$25 USD) - 2022/04/30 13:04:04 ET
Table 'Hold'em (Min 500Max 2500)  1282' 6-max Seat #6 is the button
Seat 1: Katya_Joule ($3543.48 in chips) 
Seat 2: Miss_Jammer ($3387.83 in chips) 
Seat 3: smoker player  ($824.88 in chips) 
Seat 4: Millie ($2986.42 in chips) 
Seat 5: Lucifer999 ($7666.23 in chips) 
Seat 6: jas8k ($2283.29 in chips) 
Katya_Joule: posts small blind $10
Miss_Jammer: posts big blind $25
*** HOLE CARDS ***
Dealt to Lucifer999 [9h 8s]
smoker player : folds
Millie: raises $60.00 to $85
Lucifer999: folds
jas8k: folds
Katya_Joule: calls $75
Miss_Jammer: raises $265.00 to $350
Millie: calls $265
Katya_Joule: calls $265
*** FLOP *** [Jd 8h 3d]
Katya_Joule: checks
Miss_Jammer: checks
Millie: checks
*** TURN *** [Jd 8h 3d] [8c]
Katya_Joule: checks
Miss_Jammer: checks
Millie: bets $380
Katya_Joule: folds
Miss_Jammer: raises $1195.00 to $1575
Millie: calls $1195
*** RIVER *** [Jd 8h 3d 8c] [2s]
Miss_Jammer: checks
Millie: bets $1061.42
Miss_Jammer: calls $1061.42
*** SHOW DOWN ***
Miss_Jammer: shows [3h Ac] (Two pairs, 8833)
Millie: shows [Jc Jh] (Full house, JJJ88)
Millie collected $6118.84 from pot
*** SUMMARY ***
Total pot $6322.84 | Rake $204
Board [Jd 8h 3d 8c 2s]
Seat 1: Katya_Joule (small blind) folded on the Turn
Seat 2: Miss_Jammer (big blind) showed [3h Ac] and lost with Two pairs, 8833
Seat 3: smoker player  folded before Flop (didn't bet)
Seat 4: Millie  showed [Jc Jh] and won ($6118.84) with Full house, JJJ88
Seat 5: Lucifer999 folded before Flop (didn't bet)
Seat 6: jas8k (button) folded before Flop (didn't bet)



PokerStars Game #00327565641: Hold'em No Limit ($25/$50 USD) - 2022/04/30 13:05:48 ET
Table 'Hold'em (Min 1K Max 5K)   216' 6-max Seat #6 is the button
Seat 1: Lucifer999 ($12682.39 in chips) 
Seat 2: Pablit0 ($719.01 in chips) 
Seat 6: DM0507 ($401.43 in chips) 
Lucifer999: posts small blind $25
Pablit0: posts big blind $50
*** HOLE CARDS ***
Dealt to Lucifer999 [6s 4d]
DM0507: calls $50
Lucifer999: folds
Pablit0: checks
*** FLOP *** [Jh 7c Ad]
Pablit0: checks
DM0507: checks
*** TURN *** [Jh 7c Ad] [2s]
Pablit0: checks
DM0507: checks
*** RIVER *** [Jh 7c Ad 2s] [8h]
Pablit0: checks
DM0507: bets $118.75
Pablit0: folds
Uncalled bet ($118.75) returned to DM0507
DM0507: doesn't show hand
DM0507 collected $118.75 from pot
*** SUMMARY ***
Total pot $125.00 | Rake $6.25
Board [Jh 7c Ad 2s 8h]
Seat 1: Lucifer999 (small blind) folded before Flop
Seat 2: Pablit0 (big blind) folded on the River
Seat 6: DM0507 (button) collected ($118.75)



PokerStars Game #00327565645: Hold'em No Limit ($10/$25 USD) - 2022/04/30 13:05:50 ET
Table 'Hold'em (Min 500Max 2500) 1001' 6-max Seat #1 is the button
Seat 1: HSV ($2207.26 in chips) 
Seat 2: Katya_Joule ($2687.35 in chips) 
Seat 3: movetome ($2040.32 in chips) 
Seat 4: devi7 ($2700.82 in chips) 
Seat 5: Lucifer999 ($2673.23 in chips) 
Seat 6: spidy02 ($6706.07 in chips) 
Katya_Joule: posts small blind $10
movetome: posts big blind $25
*** HOLE CARDS ***
Dealt to Lucifer999 [Qs 2s]
devi7: folds
Lucifer999: folds
spidy02: folds
HSV: folds
Katya_Joule: raises $25.00 to $50
movetome: raises $150.00 to $200
Katya_Joule: calls $150
*** FLOP *** [4s Jh Tc]
Katya_Joule: checks
movetome: bets $300
Katya_Joule: folds
Uncalled bet ($300) returned to movetome
movetome: doesn't show hand
movetome collected $375 from pot
*** SUMMARY ***
Total pot $400.00 | Rake $25
Board [4s Jh Tc]
Seat 1: HSV (button) folded before Flop (didn't bet)
Seat 2: Katya_Joule (small blind) folded on the Flop
Seat 3: movetome (big blind) collected ($375)
Seat 4: devi7 folded before Flop (didn't bet)
Seat 5: Lucifer999 folded before Flop (didn't bet)
Seat 6: spidy02 folded before Flop (didn't bet)



PokerStars Game #00327565681: Hold'em No Limit ($10/$25 USD) - 2022/04/30 13:06:03 ET
Table 'Hold'em (Min 500Max 2500)  1282' 6-max Seat #1 is the button
Seat 1: Katya_Joule ($3193.48 in chips) 
Seat 2: Miss_Jammer ($2500 in chips) 
Seat 3: smoker player  ($824.88 in chips) 
Seat 4: Millie ($6118.84 in chips) 
Seat 5: Lucifer999 ($7666.23 in chips) 
Seat 6: jas8k ($2283.29 in chips) 
Miss_Jammer: posts small blind $10
smoker player : posts big blind $25
*** HOLE CARDS ***
Dealt to Lucifer999 [Ah 8h]
Millie: folds
Lucifer999: folds
jas8k: folds
Katya_Joule: folds
Miss_Jammer: folds
Uncalled bet ($15) returned to smoker player 
*** SUMMARY ***
Total pot $20.00 | Rake $0
Board []
Seat 1: Katya_Joule (button) folded before Flop (didn't bet)
Seat 2: Miss_Jammer (small blind) folded before Flop
Seat 4: Millie folded before Flop (didn't bet)
Seat 5: Lucifer999 folded before Flop (didn't bet)
Seat 6: jas8k folded before Flop (didn't bet)



PokerStars Game #00327565478: Hold'em No Limit ($50/$100 USD) - 2022/04/30 13:04:49 ET
Table 'Hold'em (Min 25KMax 10K)    69' 6-max Seat #6 is the button
Seat 1: Lucifer999 ($30158.4 in chips) 
Seat 3: vinuth ($22936.07 in chips) 
Seat 5: tabby20 ($35410.32 in chips) 
Seat 6: manny007 ($3915.77 in chips) 
Lucifer999: posts small blind $50
tabby20: posts big blind $100
*** HOLE CARDS ***
Dealt to Lucifer999 [9c Qd]
manny007: calls $100
Lucifer999: calls $50
tabby20: checks
*** FLOP *** [8d 7c 6h]
Lucifer999: bets $300
tabby20: folds
manny007: calls $300
*** TURN *** [8d 7c 6h] [6s]
Lucifer999: checks
manny007: checks
*** RIVER *** [8d 7c 6h 6s] [3d]
Lucifer999: checks
manny007: bets $700.81
Lucifer999: folds
Uncalled bet ($700.81) returned to manny007
manny007: doesn't show hand
manny007 collected $860.4 from pot
*** SUMMARY ***
Total pot $900.00 | Rake $39.6
Board [8d 7c 6h 6s 3d]
Seat 1: Lucifer999 (small blind) folded on the River
Seat 5: tabby20 (big blind) folded on the Flop
Seat 6: manny007 (button) collected ($860.4)



PokerStars Game #00327565770: Hold'em No Limit ($25/$50 USD) - 2022/04/30 13:06:33 ET
Table 'Hold'em (Min 1K Max 5K)   216' 6-max Seat #1 is the button
Seat 1: Lucifer999 ($12657.39 in chips) 
Seat 2: Pablit0 ($669.01 in chips) 
Seat 6: DM0507 ($470.18 in chips) 
Pablit0: posts small blind $25
DM0507: posts big blind $50
*** HOLE CARDS ***
Dealt to Lucifer999 [7s 5h]
Lucifer999: folds
Pablit0: raises $75.00 to $125
DM0507: raises $345.18 to $470.18
Pablit0: calls $345.18
*** FLOP *** [2h 3h Ts]
*** FLOP *** [7d Qh 8h]
*** TURN *** [2h 3h Ts] [9d]
*** TURN *** [2h 3h Ts] [As]
*** RIVER *** [2h 3h Ts 9d] [Kc]
*** RIVER *** [2h 3h Ts 9d] [7c]
*** SHOW DOWN ***
Pablit0: shows [Qd 9c] (Two pairs, QQ77)
DM0507: shows [9s Qs] (Two pairs, QQ77)
Pablit0 collected $223.34 from pot
DM0507 collected $223.34 from pot
Pablit0 collected $223.34 from pot
DM0507 collected $223.34 from pot
*** SUMMARY ***
Total pot $940.36 | Rake $47
Board [2h 3h Ts 9d Kc]
Seat 1: Lucifer999 (button) folded before Flop (didn't bet)
Seat 2: Pablit0  (small blind) showed [Qd 9c] and won ($223.34) with Two pairs, QQ77
Seat 6: DM0507  (big blind) showed [9s Qs] and won ($223.34) with Two pairs, QQ77



PokerStars Game #00327565784: Hold'em No Limit ($10/$25 USD) - 2022/04/30 13:06:38 ET
Table 'Hold'em (Min 500Max 2500) 1001' 6-max Seat #2 is the button
Seat 1: HSV ($2207.26 in chips) 
Seat 2: Katya_Joule ($2487.35 in chips) 
Seat 3: movetome ($2400 in chips) 
Seat 4: devi7 ($2700.82 in chips) 
Seat 5: Lucifer999 ($2673.23 in chips) 
Seat 6: spidy02 ($6706.07 in chips) 
movetome: posts small blind $10
devi7: posts big blind $25
*** HOLE CARDS ***
Dealt to Lucifer999 [Jc Ac]
Lucifer999: folds
spidy02: folds
HSV: folds
Katya_Joule: raises $60.00 to $85
movetome: folds
devi7: folds
Uncalled bet ($60) returned to Katya_Joule
Katya_Joule: doesn't show hand
Katya_Joule collected $60 from pot
*** SUMMARY ***
Total pot $60.00 | Rake $0
Board []
Seat 1: HSV folded before Flop (didn't bet)
Seat 2: Katya_Joule (button) collected ($60)
Seat 3: movetome (small blind) folded before Flop
Seat 4: devi7 (big blind) folded before Flop
Seat 5: Lucifer999 folded before Flop (didn't bet)
Seat 6: spidy02 folded before Flop (didn't bet)



PokerStars Game #00327565872: Hold'em No Limit ($25/$50 USD) - 2022/04/30 13:07:07 ET
Table 'Hold'em (Min 1K Max 5K)   216' 6-max Seat #2 is the button
Seat 1: Lucifer999 ($12657.39 in chips) 
Seat 2: Pablit0 ($645.51 in chips) 
Seat 6: DM0507 ($446.68 in chips) 
DM0507: posts small blind $25
Lucifer999: posts big blind $50
*** HOLE CARDS ***
Dealt to Lucifer999 [7h 3d]
Pablit0: raises $75.00 to $125
DM0507: calls $100
Lucifer999: folds
*** FLOP *** [Td Kd 7s]
*** SUMMARY ***
Total pot $300.00 | Rake $15
Board [Td Kd 7s]
Seat 1: Lucifer999 (big blind) folded before Flop



PokerStars Game #00327565910: Hold'em No Limit ($10/$25 USD) - 2022/04/30 13:07:16 ET
Table 'Hold'em (Min 500Max 2500) 1001' 6-max Seat #3 is the button
Seat 1: HSV ($2207.26 in chips) 
Seat 2: Katya_Joule ($2522.35 in chips) 
Seat 3: movetome ($2390 in chips) 
Seat 4: devi7 ($2675.82 in chips) 
Seat 5: Lucifer999 ($2673.23 in chips) 
Seat 6: spidy02 ($6706.07 in chips) 
devi7: posts small blind $10
Lucifer999: posts big blind $25
*** HOLE CARDS ***
Dealt to Lucifer999 [6c 8h]
spidy02: folds
HSV: calls $25
Katya_Joule: folds
movetome: folds
devi7: folds
Lucifer999: checks
*** FLOP *** [3d Qd 6d]
Lucifer999: checks
HSV: checks
*** TURN *** [3d Qd 6d] [Ts]
Lucifer999: checks
HSV: bets $56.85
Lucifer999: folds
Uncalled bet ($56.85) returned to HSV
HSV: doesn't show hand
HSV collected $56.85 from pot
*** SUMMARY ***
Total pot $60.00 | Rake $3.15
Board [3d Qd 6d Ts]
Seat 1: HSV collected ($56.85)
Seat 2: Katya_Joule folded before Flop (didn't bet)
Seat 3: movetome (button) folded before Flop (didn't bet)
Seat 4: devi7 (small blind) folded before Flop
Seat 5: Lucifer999 (big blind) folded on the Turn
Seat 6: spidy02 folded before Flop (didn't bet)



PokerStars Game #00327566049: Hold'em No Limit ($10/$25 USD) - 2022/04/30 13:08:04 ET
Table 'Hold'em (Min 500Max 2500) 1001' 6-max Seat #4 is the button
Seat 1: HSV ($2239.11 in chips) 
Seat 2: Katya_Joule ($2522.35 in chips) 
Seat 3: movetome ($2390 in chips) 
Seat 4: devi7 ($2665.82 in chips) 
Seat 5: Lucifer999 ($2648.23 in chips) 
Seat 6: spidy02 ($6706.07 in chips) 
Lucifer999: posts small blind $10
spidy02: posts big blind $25
*** HOLE CARDS ***
Dealt to Lucifer999 [Js Ts]
HSV: folds
Katya_Joule: raises $25.00 to $50
movetome: folds
devi7: raises $150.00 to $200
Lucifer999: calls $190
spidy02: folds
Katya_Joule: calls $150
*** FLOP *** [9c Qs 5d]
Lucifer999: checks
Katya_Joule: checks
devi7: checks
*** TURN *** [9c Qs 5d] [4s]
Lucifer999: checks
Katya_Joule: bets $391.46
devi7: raises $391.46 to $782.92
Lucifer999: folds
Katya_Joule: calls $391.46
*** RIVER *** [9c Qs 5d 4s] [4c]
Katya_Joule: checks
devi7: bets $1682.9
Katya_Joule: folds
Uncalled bet ($1682.9) returned to devi7
devi7: doesn't show hand
devi7 collected $2070.87 from pot
*** SUMMARY ***
Total pot $2190.84 | Rake $119.97
Board [9c Qs 5d 4s 4c]
Seat 1: HSV folded before Flop (didn't bet)
Seat 2: Katya_Joule folded on the River
Seat 3: movetome folded before Flop (didn't bet)
Seat 4: devi7 (button) collected ($2070.87)
Seat 5: Lucifer999 (small blind) folded on the Turn
Seat 6: spidy02 (big blind) folded before Flop



PokerStars Game #00327566278: Hold'em No Limit ($10/$25 USD) - 2022/04/30 13:09:31 ET
Table 'Hold'em (Min 500Max 2500) 1001' 6-max Seat #5 is the button
Seat 1: HSV ($3779.11 in chips) 
Seat 2: Katya_Joule ($1539.43 in chips) 
Seat 3: movetome ($2390 in chips) 
Seat 4: devi7 ($3753.77 in chips) 
Seat 5: Lucifer999 ($2500 in chips) 
Seat 6: spidy02 ($6681.07 in chips) 
spidy02: posts small blind $10
Katya_Joule: posts big blind $25
*** HOLE CARDS ***
Dealt to Lucifer999 [Ac 9s]
movetome: folds
devi7: raises $50.00 to $75
Lucifer999: calls $75
spidy02: folds
Katya_Joule: folds
*** FLOP *** [Ah 3s 6s]
devi7: checks
Lucifer999: checks
*** TURN *** [Ah 3s 6s] [9h]
devi7: bets $174.29
Lucifer999: raises $175.71 to $350
devi7: calls $175.71
*** RIVER *** [Ah 3s 6s 9h] [Ks]
devi7: checks
Lucifer999: bets $450
devi7: folds
Uncalled bet ($450) returned to Lucifer999
Lucifer999: doesn't show hand
Lucifer999 collected $833.54 from pot
*** SUMMARY ***
Total pot $885.00 | Rake $51.46
Board [Ah 3s 6s 9h Ks]
Seat 2: Katya_Joule (big blind) folded before Flop
Seat 3: movetome folded before Flop (didn't bet)
Seat 4: devi7 folded on the River
Seat 5: Lucifer999 (button) collected ($833.54)
Seat 6: spidy02 (small blind) folded before Flop



PokerStars Game #00327566463: Hold'em No Limit ($10/$25 USD) - 2022/04/30 13:10:34 ET
Table 'Hold'em (Min 500Max 2500) 1001' 6-max Seat #6 is the button
Seat 1: shykko60 ($1540 in chips) 
Seat 2: Katya_Joule ($1514.43 in chips) 
Seat 3: movetome ($2390 in chips) 
Seat 4: devi7 ($3328.77 in chips) 
Seat 5: Lucifer999 ($2908.54 in chips) 
Seat 6: spidy02 ($6671.07 in chips) 
Katya_Joule: posts small blind $10
movetome: posts big blind $25
*** HOLE CARDS ***
Dealt to Lucifer999 [Ac Ah]
devi7: folds
Lucifer999: raises $55.00 to $80
spidy02: folds
Katya_Joule: calls $70
movetome: calls $55
*** FLOP *** [8d Ks Qd]
Katya_Joule: checks
movetome: bets $150
Lucifer999: calls $150
Katya_Joule: calls $150
*** TURN *** [8d Ks Qd] [9s]
Katya_Joule: checks
movetome: checks
Lucifer999: checks
*** RIVER *** [8d Ks Qd 9s] [Tc]
Katya_Joule: checks
movetome: checks
Lucifer999: checks
*** SHOW DOWN ***
movetome: shows [Td Kh] (Two pairs, KKTT)
Lucifer999: doesn't show hand
Katya_Joule: doesn't show hand
movetome collected $648.78 from pot
*** SUMMARY ***
Total pot $690.00 | Rake $41.22
Board [8d Ks Qd 9s Tc]
Seat 2: Katya_Joule (small blind) mucked
Seat 3: movetome  (big blind) showed [Td Kh] and won ($648.78) with Two pairs, KKTT
Seat 4: devi7 folded before Flop (didn't bet)
Seat 5: Lucifer999 mucked
Seat 6: spidy02 (button) folded before Flop (didn't bet)
